--------------------------------------------------------------------------------------------------------------------------------------------
---------------------------------------------------------------------------------------------------------------------------S----------------
----------------------------------------------------------------------------------------------------------------SSSSSSSSSSSSSSSSSSSS--------
--------------------------------------------------------------------------------------------------------------------------S-----------------
--------------------------------------------------------------------------------------------------------------------------------------------
----------------------------------------------------SSSS--------------------------SS----------------------------------------ES------------XX
--------------------------------------------------------------------------------XSX--------------------------------------------S----------X-
--XXXX-------------------------------------X-X--------------------------------------------------------------------------------SS--------XXX-
-------------SX----------------------------------------S-------------------------------------------------------------------------------XXXXX
---------X-------------------------------------------XXX------------------------------------------------------------E--------SXS----X-XXXXXX
--------------------E--------------------XX?----------------------XXXXXX---E------------------------------XX-------<>-----E--S------XXXXXXXX
----S----XX--------<>--------------------XX---------------------------EX--SX----------------------------------------]----<>--------XXXXXXXXX
--SS-----XX-E------[]-------------------------------------------------------------E-----------------------E--------[]----[]S----XXXXXXXXXXXX
XXXXXXXXXXXXXXXXXXXXXXXXXXXX----------------------------X-----XXXX--------XXXXXXXXXXXXXXXX---XXXXXXXXXXXXXXXXXXXXXXXXXXXXXXXXXXXXXXXXXXXXXXX