--------------------------------------------------------------------------------------------------------------------------------------------
--------------------------------------------------------------------------------------------------------------------------------------------
----------------------------SSSSSSSSSSSSSSSSSS----------------------------------------------------------------------------------------------
----------------------------X-----X----------------XXXXX------------------------------------------------------------------------------------
--------------------------------------------------------------------------------------------------------------------------------------------
---------------------------------XXS-----X-----E---XX--X------------------------------------------------------------------------------------
-------------------------------------------S---XXX-X----------------------------------------------------------------------------------------
-----------------------------------------SSSS-------XX--------------------------------------------------------------------------------------
---------------E--------------------------SSS------XXX-------------------------------------------SXSXXX-------------E-------E---------------
----------E------------------SSSSS------XSXS------XXXX----------------------------XX-------------------------------<>---------------S-------
---------<>--------------------------------------XXXXX---------------------------XXX------------------------E---E--[]-----E------------X-XX-
---------XX--XX---------------------------------XXXXXX---------------------------XXX-------------------------------[]----<>--------------E--
--------------------EE-----------------S-----XXXX-XXX----------------E----------EXXX-------------------------X-X---[]----[]------E--EEE-----
---X-----XX-XX---XXXXXXXXXXXXXXXXXXXXXXXXXXXXXXXXX------XXXXXXXXXX--XXXXXXXXXXXXXXXXXXXXXXXXXXX----XXXXXXX--XXXXXXXXXXXXXXXXXXXXXXXXXXXX-X--