--------------------------------------------------------------------------------------------------------------------------------------------
----------------------------------------------------------------------------------------------SS--------------------------------------------
------------------------------------------------------------------------------------SSSSSSSSSSSSSSSSSSSS------<>----------------------------
------------------------------------------------------S------------------------------------SSSSSSSSSSSSSS---XX[X----------------------------
-----------------------------------------------------E--------------------------------------SSSSSSSSSSSS------------------------------------
---------SSSSSSSSSS----------SSS-------------X------SSSS-----------------------XX----------SSSSSSSSS--SS---X---X----------------------------
---------------------------------------------X-----------------------------------------------------S----------------------------------------
-------------------------------------------X-X----------------------------------------------------S---------XXX--------------------------XX-
--------------------------S----------------------------S---------------SS----------------------X--SSS------XXXXX----------------------------
X--------S?S-SSSSSS-------X-------------------------XXX---------------------------------------SSSSSSSS----XXXX--------------------------X---
-------------------------XX--------------X-----------------------------------------------------SSS--------XXXX--------------------------X---
-------------------------XX---------------------------------------------------------------------S---------XXXXXX------------------------XX-X
EE------------EE---------X-----------------------------S---------------------------------------S------XXX-X-XX------------------------------
X--XXXXXXXXXXXXXXXXXXXXXXXXX----------------------------XXXXXX---XXXXXXXXXX-----------XXXXXXXXXXXXXXXXXXXXXXXXXX--XXXXXXX-XX---X------------