--------------------------------------------------------------------------------------------------------------------------------------------
--------------------------------------------------------------------------------------------------------------------------------------------
-----------------------------------------------------------------------------------------------------------------SXSXSXSX-------------------
------------------------------------------------------S-----------------------------------------------------------------------------------X-
----------------------------S-------------------------EE---------------SXSXS----------------------------------------------------------------
-----------------------------SSSSXS-----------------S-S-SSS-------XXX--SX--XXXX--SS----------------------------------------------------XXXXX
----------------------------SSSS-------------------------------XX---------------------------------------------------------------------------
------------------------------SS--------------------------------------------------------------------------------------------------------XX--
----------------------------SSS--------SXXXXXXX---------------------------------------------------------------------------SXSSSS------------
-----------------------------XXX-------------------X----------E--------------------------------------------------QQQ-------------------XX---
--------------------------------------------------------------------------------------------------------------------------------------------
-------------------------------X--------------------------------------------------------------------------------------------------------X-XX
-EEEE--------EE-EE-E--E-------SX-E---------------------S-----------------------------------------------------------------------E------------
XXXXXXXXXXXXXXXXXXXXXXXXXXXX-----------------XX--------X--------------------XX-----XXXXXXXXX-XXXXXXXXXXXXXXXXXXXXXXXXXXXXXXXXXXXXXXX--------