--------------------------------------------------------------------------------------------------------------------------------------------
--------------------------------------------------------------------------------------------------------------------Q-----------------------
------------------------------------------------------------------------------------SSSSSSSSSSSSSSSS----------------------------------------
-------------------------------------------------------------------------------------------------------------------------E------------------
XXXXXXX-----XXXXX---------------------------------------------------------X-------------------------------------S-------<>-<----------------
-E---------------------------------------------------------------------------------------------------------X---------SSS?----------Q--------
-----XXX----------------------------------------------------------------------------------------------------------S-------------------------
--------------------------------------------------------------------------------------------------SS--------X----SSXSX----------------------
--------------------------------------------------------------------------------------------------SSS------XXX--SX---------S---SXSX---------
--------------------------X----QQQ-------S------------------QQSSS--------------------SQSSS----------------X-----SX---XXXX----------------S-S
------------------------XXX-------------------------------------------------------------------------------XXX---XX----------E-----E---------
X-------XS-------------XX---------------------------XXX------------------------S--------------------------XXX---XX--S---S-S-----------------
-----------E-E---------XX----------------E-E-------XX------------------EE-EE-----------------------E-E-E--XX----XX-XS--SS---E------------E--
XXXXXXXXXXX-XXXXXXXXXXXXXXXXXX-XXXXXX-XXX-XXXXXX---XX---XXXXXXXXXXXXXXXXXXXX---XXX--XXXXX---XXXXXXXXXXXX-------XXXXXXXXXXXXXXXXXXXXXXXXXXXXX