--------------------------------------------------------------------------------------------------------------------------------------------
--------------------------------------------------------------------------------------------------------------------------------------------
--------------------------------------------------------------------------------------------------------------------------------------------
--------------------------------------------------------------------------------------------------------------------------------------------
--------------------------------------------------------------------------------------------------------------------------------------------
---------------------------------SS---------------------------------------Q---------------------------------------------------Q---------SSSS
--------------------------------------------------------------------------------------------------------------------------------------------
--------------------------------------------------------------------------------------------------------------------------------------------
----------------------------SE-------------SSSX------------------------------E---------------------------E----------------------------------
----SQS---------------------X----XXXX-----------------------E-----------Q---<---------------------------X------X----------------------------
--------------------------------------------------------E--<>-----E--------------------E------E--E-----XXXXXXXXX----------XXXXXX---E-E------
------------------------XSX--------------------------------[]----<>---------<>---------------<>---------XXXXXXXX------------------SX--------
-------------E-E-------XX--------E-------------------E-----[]-E--[]------E--[]---------[E-E--[]---------XXX-XXXX--------------------------E-
XXXXXXXXXXXXXXXXXXXXXXXXXXX-XXXXXXXXXXXXXXXXXXXXXXXXXXXXXXXXXXXXXXXXXXXXXXXXXXXXXXXXXXXXXXXXXXXXXXXXXXXXXXXXXXXX------------------XXXXXXXXXX