--------------------------------------------------------------------------------------------------------------------------------------------
--------------------------------------------------------------------------------------------------------------------------------------------
SSSSSSSSSSSSSSSSSSSS------S-------------------------------------------------------------------------------------SSSSSSSSSSSSSSSSSSSSSSSSSSSS
-----------------------XXX-X----------------------------------------------------------------------------------------------------------------
--------------------------------------------------------------------------------------------------------------------------------------------
-------------------E-----------------------------------------------------------------------------------XSX----------------------------------
--------------------SXSX-----------------------------------XXE------------------------------------------------------------------------SX----
------------------------X-----------------------------------------------------------------------------------------XXX-----------------------
X-X-----------E--------XX-------------------------------------------------------------------------------------------------E---E-------------
----------EXXXX------XXXXXX----------------------Q-----E------------XXXX--------XXXX-------------------------------------<>--<>-----XX---QQQ
---------------------XX-----------------------------E-<>-----------------------XX----------------------------------------[]--[-----XXX------
-------------------XXX-------S------------------------[]---------------------------------------------------X-------------[]--[]----XXX------
----------------X-XXXXXXXX--X-X---E--EEXE-------------[]---------------------X-X---------------------------X----------E--[]-[]--XX-XXXX-----
XXXXXXXXXXXXXXXXXXXXXX-----XXXXXXXXXXXXXXXXXXXXXXXXXXXXX----------------------------X----XXXXX-------XXXX-------XXXXXXXXXXXXXXXXXXXXXXXXXXXX