--------------------------------------------------------------------------------------------------------------------------------------------
--------------------------------------------------------------------------------------------------------------------------------------------
---SXSXSXSS-SSSSSS--------------------------------------------------------------------------------------------------------------------------
--------------------------------------------------------------------------------------------------------------------------------------------
--------------------------------------------------------------------------------------------------------------------------------------------
-----------------------------E------------------------------SSSS----------------------------------------------------------------------------
----------------------------XXXXXXX------------------X--------------------------------------------------------------------------------------
--X-----------------------------------------------------------------------------------------------------------------------------------------
---------S--XSXSX-------------------------------------------------------SXSX------------E---------------------E-----------------------------
----------------------XXX-------------------------------->------------------------<E---<>--------------QQ----<>----X-----XX----------------E
--------------------------------------------------------[]------------------------[>>--[]--------------------[]-XX-------XXXXX----------E-<>
----------------------------------------XXX-------------[]------------------------[]]--[]-------E------------[]-XX-------XXXXX------------[]
--------------------------------------------------------[]------------------------[]EE-[]---------E-EE-E-----[]--X-------XXXXX------------[]
--------XX-----------------X---X-X---X---X---XXXXXXXXXXXXXXXXXXXXXXXXXXXXXXXXXXXXXXXXXXXXXXXXXXXXXXXXXXXXXXXXXXXXXXXXXXXXXXXXXXXXXXXXXXXXXXX