--------------------------------------------------------------------------------------------------------------------------------------------
--------------------------------------------------------------------------------------------------------------------------------------------
-------------------------------------------------SS-----------------------------------------------------------------------------------------
----------------E---------------------------------------------------------------------------------------------------------------------------
------------XXXSXSXS-----------------------------------------------------------E------------------------------------------------------------
--------------------XXS--------------------------------------S--------SSSS-------------------------------------S-S--------------------------
-------------------------------S---------------------------------------------------------------------------S------------------------SXSX----
--------E--------------------XX-----------------------------------------------------------------------------S------------------X------------
--------------------------------------------------------SE--------------S---------------------------------------XXX----------XXX------------
S---SSSSS-------------------X--------------QS----------Q------XXXX----S---------------------S------------SSS--E----X-----------------XXXX---
---------------------------------------------SS-E------------------------------------------------------------<>-----------------------------
-----------------------<>---------SS-------------------------------------------------------------------------[]---SX-----XX-----------------
-------------E--EE-E---[]---X-X--SXS----EX------------------------------------------EE--------------E-EE-----[]---S-----------------XX-----X
XXXXXXXXXXXXXXXXXXXXXXXXXX-XXXXXXXXXXXXXXXXXXXXXXXXXXXXXXXXXXXXXXXXXXXXXXXX-----X---XXXXXXXXXXXXXXXXXXXXXXXXXXXX-X----------------XX-X----XX