--------------------------------------------------------------------------------------------------------------------------------------------
--------------------------------------------------------------------------------------X-----------------------------------------------------
------------------------------------------------------------------------------------SSSSSSSSSSSSSSSSSSSSSSSSSSSS----------------------------
----------------------------------------------------------------------------------S---------------------------------------------------------
---------------------------------------------------------------------------------EEE--------------------------------------------------------
--------------------------------------------------------SSS?S--------SXS--------SXSS---S----------SSSS--------------------------------------
---------------------------------------------------------------------------------------SX-----------------SX--------------------------------
-------------------------------------------------------------------------------------XXXX---------------------------------------------------
--------------------------------------------------------------------X--------------S----------E---E-----------------------SXSX--------------
----E---------------S-----------------------------------XXXX---------------------------------[>--<>S----XXX---SS-QQQ-Q----------------------
---<>------------------XXXX-----------------------------------------XX??---------------------[]--[]----XXXX----E----------------------------
---[]--------------------X------------X-XX---------------------------------------------------[]--[]----XXXX------------------------------XXX
---[]----EE-----------E-------------------------EE------------------------------------X---E--[]-[]X-XX-XXXX-X------------------E--------X---
XXXXXXXXXXXXXXXXXXXXXXX--XXXXXXX-----XXXXX---X-XXXXXXXXX----------------------------XXXXXXXXXXXXXXXXXXXXXXXXXXXXXXXXXXXXXXXXXXXXXXXXXX------