-------------E------------------------------------------------------------------------------------------------------------------------------
-----------SSS------------------------------------------------------------------------------------------------------------------------------
SSSSSSSSSSSSSSSSSSSSSSSSSSSS----------------------------------------------------------------------------------------------------------------
------SSSSSSSSSSSSSSS-----------------------------------------------------------------------------------------------------------------------
-------SSSSSSSSSSSSS------------------------------------------------------------------------------------------------------------------------
X--S----SSSSSSSSSSSS-------X-------------------------------SSSSS---------S---------S--------------------------------------------------------
--S------------------------------------------------------------------------------------X----------------------------------------------------
--------------------------------------------------------------------------------------------------------------------------------------------
---------------------?-E-XSX-------------XXX----------------------------SXSX----------------------------------------------------------------
----E------SSSSSSSS-S--X-XS-----------------------------<>----XXX--------------S---E-----------------------------------XXXX-----------------
---<>------SSSS-SS--------------------------------------[]X-----------------------<>--------------------------------------------------------
---[]------SSSS-----X-XXXXXX---------XX-----------------[]------------------------[]---------XXXXXX-----------------------------------------
--[]--[]---S-SS----[]-X--XXX----------------------------[]---------X--------------[]--------------------EE------------------------E---------
--XXXXXXXXXXXXXXXXXXXXXXXXXX--XXXX---XXXXXXXXXXXXXXXXXXXXXXXXXXXXXXX---XXXXXXXXXXXXX-----------------XXXX-XX--XXXXXXXXXXXXXXXXXXXXXXXXXXX---