--------------------------------------------------------------------------------------------------------------------------------------------
----Q---------------------------------------------------------------------------------------------------------------------------------------
--------------------------------------------------------------------------------------------------------------------------------------------
--------------------------<>----------------------------------------------------------------------------------------------------------------
S-------E-----------------[]----------------------------------------------------------------------------------------------------------------
-SSSSSS---------------------------------S?--------------------------------------------------------------------------------------------------
SSSS-------------------------------------------------------SX-------------------------------------------------------------------------------
XSSSS---------------------------------------------------------------------------------------------------------------------------------------
SSS--------SXSXSXSX-------------E---------------------X-----------E----------E--------------------------------------E---------------------XX
XX-X-XXX-----------------------<>--------------------XX---X------<>--<>E----<>---Q-----------------------XXXX------<>--------------------XX-
------------E------------------[]-------------------XXX-X-<------[]--[---X--[]------------------------------X------[]------------------XXXX-
---X----SXS--------------------[]-------------------XXX---[]-----[]--[------[]-------------------------------------[]-------------------XXX-
---XSE-SS----------------E---E-[]---------EE-----E--XXX---X---E--[]-[]------[]---------------------------------X---[]---------------E-E--XX-
XXXXXXXXXXXXXXXXXXXXXXX-XXXXXXXXXXXXXXXXXXXXXXXXXXXXXXXXXXXXXXXXXXXXXXXXXX-XXXXXXXXX---------------------------XXXXXXXXXXXXX--XXXXXXXXXXXXXX