--------------------------------------------------------------------------------------------------------------------------------------------
--------------------------------------------------------------------------------------------------------------------------------------------
--------------------------------------------------------------------------------------------------------------------------------------------
--------------------------------------------------------------------------------------E-------------E---------------------------------------
------------------------------------------------------------------------------------XSXXXXX---SXXXXXXXXX------------------------------------
--------------SSS-------------------------------------------------------------------S?S-----S-----------------------------------------------
--------------------------------------------------------------------------------------------------------------------------------------------
--------------------------------------------------------------------------------------------E-----------------------------------------------
----------------------------SX-------------SXSX---------------------------------------------------------------------------------------------
-----Q-XXXX---S-------------------XXX------------------S----------------------------SSSSXS-SS-----------------X-----S?SS--------------------
----------------------------------------------------------------------------------X--------------------------XX-----------------------------
---------------------------------------------------------------------------------XXX[]------XS-------------XXXX-----------------------------
---------------EEEE-------------------------------------------------------------XXXX-----------E-E-------E-XXXX----------------E--------E---
XXXXXXX--XXXXXXXXXXXXXXXX---XXXXXXXXXXXXXXXXXXXXXXXXXXXXX---XXXX------------XXXXXXXXXXXXXXXXX-XXXXXXXXXXXXXXXXXXXXXXXXXX--XXXXXXXXXXXXXXX--X