--------------------------------------------------------------------------------------------------------------------------------------------
--------------------------------------------------------------------------------------------------------------------------------------------
--------S----------------------------------------------------------------------------------------------SSSSSSSS-SSSSSSSSSSSSSSSSSSSSSSSSSSSS
----------SSSSSSS---------------------------------------------------------------------------------------------------------S-----------------
----------SSSS-S---S------------------------------------------------------------------------------------------------------------S-----------
---------SSSSSSSSSS-------------------------------------------------------------------------------------------------------SSXSSSSS----------
--------------------------------------------------------------------------------------------------------------------------------------SX----
------------------------------------------------------------------------------------------------------------------X-------------------------
-----------------------E-XXX-------------------------------------SSSSS------------------------E----------E----------------E-----------------
----E------SSS-SSSS------X----------SX-------------S-----------------------------------------<>--<>E----<>---Q-----------<>--SSSS---X-X---SS
---<>-------SS--------XXXX-------------------------------------------------------------------[]--------X[]---------------[]--[S----XXXX-----
---[]------SSS--------XXXXXX-----------------------------------------------------XXX---------[]---------[]---------------[]--SS----XXXX-----
---[]---------------E-X-XXXXEE--------------E-EE-----------------------------------X--E---E--[]-----X---[]------------E--[]-[SS-X--XX-X-----
--XXXXXXXXXXXXXXXXXXXXXXXXXXXXXXXXXXXXXXXXXXXXXXXXXXXXXXXXXXXXXX-XXXXXXXXXXXX-----X-XXXXXXXXXXXXXXXXXXXXXXXXXXXX--XXXXXXXXXXXXXXXXXXXXXXXXXX