--------------------------------------------------------------------------------------------------------------------------------------------
--------------------------------------------------------------------------------------------------------------------------------------------
-SSSSSSSSSSSSSSSSSSSSSSSSS---------S--------------------------------------------------------------------------------------------------------
--------------------------------X-XX--------------------------------------------------------------------------------------------------------
--------------------------------------------------------------------------------------------------------------------------------------------
---------------------------------------------------------------------------------------------SSSSSSSSS--------------------------------------
------------------------------------------------SX------------------------------------------------------------------------------------------
-----------------------------------------------------XX------------------------------------------------------XX-----------------------------
-------------------------------------------------------------------------------------------------------------XX----------------E------------
----------E---------X-X----------------XXXXX-----XXXXXXX--X------------------E------X---QQ---SXS-SSS----------------------E----------XXXXX--
--------------------XXX-------------------------XXXXXX-XXXX-----------------<>----E---------------------------X----------->----------XX-----
-------------------XXXX-------------------------XXX-XX-XXSX---S>------------[]------------------------------XXXX---------------------X------
---------E]-------XXX-XX----------------------XXXXXXXXXXXXX---X---E-E-------[]-----E-------------EEE--E----XXXX--------------------XXX-X----
XXXX--XXXXXX---XXXXX----XXXXXXXXXX------------XXXX-XXXXXXXXXXXXXXXXXXXXXXXXXXXXXX-XXXXXXXXXX---XXXXXXXXXXXXXXXX-XXXXXXXXXXXXXXXXXXXXXX----XX