--------------------------------------------------------------------------------------------------------------------------------------------
---------------------------------------------------------------------------------------------------------------E----------------------------
SSSSSSSSSSSSSSSSSSSSSSSSSSSS--------------------------------------------------------SSSSSSSSSSSSSSSSSSSS------<>----------------------------
------------------------------------------------------------------------------------------SSSSSSSSSSSSSSS--XXX[]----------------------------
-----------------------------------------------------------------------SXSX----E------------SSSSSSSSSSSS------------------------------------
---------------------------------------------SSS--------SSS-------XX----X---XXX-------------SSSSSSSSS-SS---X---X-----------SSSSSSS----------
-------------------------------------------------------X------------------------------------------------------------------------------------
-------------------------------------------------------------------------------------------------S----------XX------------------------------
-----------------------------------------------------------------------------------------------XS-SSS------XXXSX----------------------------
---------<>--<>-----XXX-----XX-------------QES---SQ-----SQ--QQQS-----------------------------SSSSSXSSS----XXX------------SX--SSS------------
---------[]--E-----XXXX-----XX----------------S------------------------------------------------S----------XXXX------------------------------
---------[]--------XXXX-----[X----SS------------------------------------------------------------S---------XXXXXX-------------------------XXX
------E--[]-----XX-XXXX-----XX---SXS----E------------------------------E--E-----E--------------S------XXX-X-X------------------E--------E-X-
XXXXXXXXXXXXXXXXXXXXXXXXXXXXXXXXXXXXXXXXXXXXXXXXXXXXXXXXXXXXXXXX---XXXXX------------XXXXXX-XXXXXXXXXXXXXXX------XXXXXXXXXXXXXXXXXXXXX--XXXXX