--------------------------------------------------------------------------------------------------------------------------------------------
--------------------------------------------------------------------------------------------------------------------------------------------
--------------------------------------------------------------------------------------------------------------------------------------------
----------------E---------------------------------------------------------------------------------------------------------------------------
-XX-XX------XXXSXSXS--------XXXXXX---------SX-----------------------------------------------------------------------------------------------
-?S--------------------------------------------------S-S---------------------XXX--------------------------------SS------------------------X-
-----------------------------------XX--------------SX-----------------------------------------------------------------------------XXXX------
--------E-----------------------------------------------------------------------------------------------------------------------------------
--------------------------------------------------------------------------------------------------------------------------SXSX--------------
S-S-SSSSS-----------------X-------S-S-----------S-----E---------------------------------------E----------E-------XX-------------------XXX---
-------------------------XX--------------------E-----<>-----------------------------------E--<>---------X>----------------------------------
--------X--------------XXXX-------------------<>-----[]--------------------------------------[]--XXX----[]----------------------------------
-----------E-E---------XXXX-------------------[]----E[]--------------------------------------[]---------[]----------------------------------
XXXXXXXXX-XXXXXXXXXXXXXXXXXXXXXX--XXXX--XXXXXXXXXXXXXXXXXXXXXX---XXXXXXXX--XXXXX---XXXXXXXXXXXXXXXXXXXXXXXXXXXXX----------------------------