--------------------------------------------------------------------------------------------------------------------------------------------
--------------------------------------------------------------------------------------------------------------------------------------------
--------------------------------------------------------------------------------------------SSS--SSSS--------------------------------SSSS---
--------------------------------------------------------------------------------------------------------------------------------------------
-------------------------E------------------------------------------------------------------------------------------------------------------
------------------------SSS----------------------------S-----------------X------SSSS------------ES------------------------------------------
-------------------------------------------------------------------E--XX--------------------------------------------------------------------
----------------------------------------------------S------------------X-X------------------------------------------------------------------
---------------------------S-------------------------------------------------------S-----------------------XXXXX---------------------E------
------------------------XXXXX-----------------QQQSSS--E-----------X---------------------E-----------SX-----XXX------E---------------X-------
-----------------------------------------------------<>-----------XXXXXX---------------<>-------SS--------XXXX--E--<>-----E--E-----XXX------
-----------------------------------------------------[]-----------X---XX---------------[]-------S-------XXXXXXXX---[]----<>---------XXX-----
----------------------------EE-E------------E--E-----[]--------------------------------[]--------------XX-XXXXX----[]-E--[]-----XX--XXX-----
----------------------------XXXXXXXXXXXXXXXXXXXXXXXXXXXXXXXX--------------XXXXXXXXXX-XXXXXXXXXXXXXXXXXXXXXXXXXXX-XXXXXXXXXXXXXXXXXXXXXXXXXXX