--------------------------------------------------------------------------------------------------------------------------------------------
--------------------------------------------------------------------------------------------------------------------------------------------
--------------------------------------------------------------------------------------------------------------------------------------------
-----------------------------------------------------------------------------------------------------------------XEX-E----------------------
--------------------------------------------------------------------SXSXSXSX--------------------------------EEE-XXXXXXX---------------------
--------------------------------------------------------SQQ----SSSSSSX--------------SSS?-------SXSXSX----XXXXXXX-E--------------------------
----------------------------XX---------------------SXX-----------------------------------------------XX---------XXX--XX---------------------
--------------------------------------------------------------------------------------------------------------------------------------------
------------------------------------------------------------E---------------------XX-----------XXX------------------------------------------
-----------------------------------------------SSS----E-?--<>--------------------XX-XXX--------------------XXXXX----------------------------
-------------------------<-----------------E---------<>----[]--------------------XX--------------------------------------E-------------XXXX-
-----------------------------------------------------------[]-------------------XXX-----------------------------X-------<>------------XXX---
----------------E-------------EE-------------------------E-[]---------EE-E--EE-XXXX-------------------------------------[]-----------XXX----
XXXXXXXXXXXXXXXXXXXXXXXXXXXXXXXXXXXXXXXXXXXXXXXXXXXXXXXXXX-XXX-XX-XXXXXXXXXXXXXXXXXX----------------------------XXXXXXXXXXX-XX-XXXXXXXXXXXXX