--------------------------------------------------------------------------------------------------------------------------------------------
--------------------------------------------------------------------------------------------------------------------------------------------
--------------------------------------------------------------------------------------------------------------------------------------------
------------------------------------------------------------------------------------XXXXXXXX------------------------------------------------
-XXXXX-----------------------------------------------------------------SXSXS------------XXX-------------------------------------------------
-------------------------SSS-E-----------------------------------------------XS------E-----------------------------------------SX---XXX--XS-
-------XX--------------SXS--XXXXXXX-------------------------------------------------XXXXXXX-------------------------------------------------
----------------------------------------------------------------E---------------------------------------------------------------------------
--------------------------------------------------------------------------------------------------------------------------------------------
------------------------------------------------------XX----S?SSS--------------------------------XXX----------X-----------------------------
---------------E---E-----------------E-------------XXXXX-------------------------------------E------------XX--------------------------------
------------------<>----------------<>------------XXXXXX-----------------------<>---X-------<>-----------XXX--------------------------------
------------------[]----------------[]-----------XXXXXXX-------------E--E-EE---[]-----------[]----------XXXX--------------------------------
XXX---XXXXX-XXXXXXXXXXXXXXXXXXXXXXXXXX-------XXXXXXXXXXXXXXXXXXXXXXXXXXXXXXXXXXXXX-XXXXXXXXXXXX------XXXX-XX-X--XXXXXXX--------------------X