---------------------------------------------------------------------E----------------------------------------------------------------------
--------------------------------------------------------------------S-----------------------------------------------------------------------
--------------------------------------------------------SSSSSSSSSSSSSSSSSSSSSSSSSSSS-----------------------------------------SSSSSSSSSSSSSSS
----------------------------------------------------------------SSSSSSSSSSSSS---------------------------------------------------------------
----------------------------------------------------------------SSSSSSSSSSSS----------------------------------------------------------------
----------S-S?---------------------------------------------------SSSSSSSS------X---X--------------------------------------------------------
--------------------------------------------------------------------------------------------------------------------------------------------
------------------------------------------------------------------------------------------------------------------XXX-----------------------
----E---------------------X-----------E----------------------------------------XXXSX--------------------------------------E---E-------------
?--Q>--------------------XXX---------<>---SE-----E----------E-------SSSSSXS---XX--SS-E-------X-----------------E---------<>---SE----X-------
----]--------------------XXX---------[]---------<>---------<>------SSSS-------XX----<>------------------------<>---------[]--------XXX------
------------------------XXXX---------[]---------[]---------[]------SSSS-----X-XXXXX---------------------------[]---------[]--------XXX------
XE-[]--------EEE-----E-XXXXX---------[]---------[]---------[]------S-SS--XXXX-XX----EE----------------E-------[]---------[]-[]-----XX-------
XX-XXXXXX-XX-XXXXXXXXXXXXXXXXXXXXXXXXXXXXXXXXXXXXXXXXXXX--XXXXXXXXXXXXXXXXXXXXXXXXXXXXXXXXXXXX----XX-XXXXXXXXXXXXXXXXXXXXXXXXXXXXXXXXXXXXXXX