--------------------------------------------------------------------------------------------------------------------------------------------
--------------------------------------------------------------------------------------------------------------------------------------------
--------------------------------------------------------------------------------------------------------------------------------------------
------------------------------X--E----------------------------------------------------------------------------------------------------------
----------------------------------X---SXSXSXSXSX--------------------------------------------------------------------------------------------
----------------------------------------------------------SSSSS----------X------------------------------------------------------------------
----------------------------------------------------------S-----------XXXX------------------------------------------------------E---------SX
------------------------------------------XS--------------SSS-----------------------------------------------------XXSX----------------------
--------------------------------E----?--E-----------------------------XXXXX-----------------------------------------------------------------
-E--------X----------------E---S?--------------------XX----X-X-X------------------------------E------------------XXX-----X-----Q------------
<>--------X----E----------<>---[-S-----------------XXXX----------X-XX---------------------E--<>-----------------XXX------X-XX-----E-E-------
-]------------------------[]]--<>----S--E---------XXXXX--X-X----SXSXX------------------------[]-----------------XXX-------SXXX------X-------
[]------------------------[]-[][]---SS----E--E---XXXXXX---SX---SSX---------------E-----------[]---------EE------XXXX-----XXXXX------E-------
XXXXXXXXXX----XXXXXXXXXXXXXXXXXXXXXXXXXXXXXXXXXXXXXXXXX-XXXXXXXXXX--X--XXXXXXXXXXXXXXXXXXXX-XXXXXXXXXXXXXXXXXXXXXXXXXXXXXXXXXXXXXXXXXXXXXXXX