--------------------------------------------------------------------------------------------------------------------------------------------
--------------------------------------------------------------------------------------------------------------------------------------------
--------------------------------------------------------------------------------------------------------------------------------------------
--------------------------------------------------------------------------------------------------------------------------------------------
-----------------------------------------------------------------------------------------------------X--------------------------------------
-------------------------------SSSS----------X--------------------------------------SSS-----------------SXS----------------------------XXXX-
------------------------------------------X---------------------------------------------------------------------------------------XXXX------
--------------------------------------------------------------------------------------------------------------------------------------------
----E-------E--------E----XX----------------SXSX--------------------X--------------------------------------------------------X--------------
---<>---------------S--X-XXX-----X-X-------------------E----------------------------SSSSSSSS--------------------------------XXX-------XXXXX-
?--[]-----E--E------X--XXXXX----------XXXXXX----------<>------------------------------------------------------------------------------------
---[]----<>---------XXXXXXXX----------X---------------[]--------------------------XX------------------------X-------------------------------
---[]----[]---------XXX-XXXX--------------------------[]------------------------EXXX---------------E-E--------------------------------------
XXXXXXXXXXXXXXXXXXXXXXXXXX--XXXXXXXXXX--XXXXXXXXXXXXXXXXXXX-XXXX---------XXXXXXXXXXXXXXXXXXX--XXXXXXXXXXX-----------------------------------