--------------------------------------------------------------------------------------------------------------------------------------------
--------------------------------------------------------------------------------------------------------------------------------------------
SSXSXSX--------------------E----------------------------------------------------------------------------------------------------------------
--------------------------<>----------------------------------------------------------------------------------------------------------------
--------------------------[]---------------------------------------------------------------------------------E-E----------------------------
S-----------XS----------XXXXS-----------XSX--------------------------S?S--------------SSS------------X------SSSS----------S-SSSSSS----------
-----------------------------------------------------------------------------------------------E--XX-X--------------------------------------
------------------------XX-------------------------------------------------------------------------X-X--------------------------------------
---------SSXSSSS-----------------------XXX-----------------------------------------------------------X---------S----------------------------
XQXQ------------------XXX---------------------------X------------------------------E--------------------------------------X---S-------------
-----------------------------------------------------------------------X---E------<>----------XXXXXX----------------------------------------
------------------------XXXX----------------------------------------------<>------[]----------X---------------------------------------------
-------------------------------------------------------X------------------[]----E-[]-------------------------------------------EE-E---------
XXXXXXXXXXXXXXXXXXXX--------XXXX-----XXX--------X------XXXXXXXXXX---XXXX--XXXXXXXXXX----------------------------XXXXXXXX---X--XXXXXXX--XXXXX