--------------------------------------------------------------------------------------------------------------------------------------------
--------------------------------------------------------------------------------------------------------------------------------------------
-----------------------------------------------------------------------------------------------------------------------------------SSSSSSSSS
--------------------------------------------------------------------------------------------------------------------------------------------
-------------------------------------------------------------------------------E--E---------------------------------------------------------
--------------------------------------------------XXXXXXS------------SXSX-------SSSS--------------------------------------------------------
-----------------------SXSXS----------------------------------------------------------------------------------------------------------------
------------------------------------------------------------------------------------------------------------------XXX-----------------------
-------------------------------------SSSSS-SS----------------------XX-----------------X----------XXX----------------------E-----------------
----------X---------------------------------------------XXXX----------------------------------E----------XXXX-----X------<>--SSE-----E---Q--
<>--------XXXXXX------------------------------------------------------------------------------------------------------E--[]---------<>------
-X--------XXX-XX--------------------------------------------------------------------------------------------------X------[]--[]-----[]------
-]--------XXXX-------------------E-----------------------------------------------SS---------------------E---X--X--X------[]-[]------[]------
XXXX--XXXXXXXXXXXXXXXXXXXXXXXXXXXX---XXXXXXXXX----------XXXXXXXX---XXXXXXXXXXX------XXXXXX---XXXXXXXXXXXXXXXXXXXXXXXXXXXXXXXXXXXXX-XXXXXXXXX