--------------------------------------------------------------------------------------------------------------------------------------------
--------------------------------------------------------------------------------------------------------------------------------------------
-----------------------------------------------------------XS-SSSSSSS-----------------------------------------------------------------------
------------------------------------------------------------XXX-----------------------------------------------------------------------------
------------SX------------------------------------------------------------------------------------------------------------------------------
------------SX--------------------------------------------------------------------------------------------------SSS-----------------XXXXXXX-
-------------------------------------------------------------E--------------SX--------------------------------------------------------------
--------------------------------------------------------------------------------X-----------------------------------------------------------
----E--------------------XXX---------------------------S------------------------X-------E---------------------X-----------SXSX--------------
---<>------------------XXXXX----------------------------------------XXXX-----XXXXXX-X--S?---------------S----XXXXQQQQQQ---------------------
---[]--------E---------XXXXX-------------------------------------------------XXXXX---------------------------XXX----------------------------
---[]------SS---------XXXXXX------------------------------------------------XXXXX------<>-------E------------X[X----------------------------
---[]---------------EXXXXXXX----------------------------------------------XXXXXXXX--XE-[]--------EE-E----E--EXXX---------------E-E----------
XXXXXXXXXXXX--XXXXXXXXXXXXXX----------------------------XXXXXX---XXX-----------X----XXXXXXXXXXXXXXXXXXXXXXXXXXXXXXXXXXXX-XXXXXXXXX----------