--------------------------------------------------------------------------------------------------------------------------------------------
--------------------------------------------------------------------------------------------------------------------------------------------
-------------------SSSSS-S-S-------------------------------------------SSSSSSSSSSSSS--------------------------------------------------------
-----------------------------------------------------------------E--------------------------------------------------------------------------
--------------------------------------------------------------------------------------------------------------------------------------------
----------------S----------------------------------------------S?S----SSS--Q--------SS-------------------------------------------X----------
---SX-----------------------------------------------------------------------------------------------------------------------------------SSSS
-XXXX----------------------------------------------------XXXX-----------------------------------------------XX-----------------X-X----------
?---------E----------------------------------------------X-----------S--E---------------------SXSX------------------------------------------
XXX----------SSQS----E----------------------------------X-----------S--QS--------SSSXQQQQQQ-------S----------------X-----XX-----------------
--X-------->-----SX-E---E--E---------------------------------------------------------------------------------------------XXXXXXX------------
XX---SSS-----SX----->---------------------------------------------------------------------------------------XXXX---X-----XXXXXXX------------
XXXSSSXS----SX-----[]------E----------------------------X-----------E------------------------------E-EE------------X-----XXXXX-------------E
XXXXXXXXXXXXXXXXXXXXXXXXXXXXXXXXXX---XXXX--XXXXXXXXXXXXX-----XXXXXXXXXXXX----XXXXXXXXXXXXXXXXXXXXXXXXXXXXX------XXXXXXX-----XX--XXXXXXXXXXXX