--------------------------------------------------------------------------------------------------------------------------------------------
--X-Q------------------------------------------------------------------------------------------SSS------------------------------------------
---------------------------E--------------------------------------------------------SSSSSXSXSSSS-SS-----------------------------------------
---------E----------------<>------------------------------------------------------------------SSSSSS----------------------------------------
SS------<>---S------------[]------------------------------------------------------------------SSSSSSSXSX------------------------------------
-SSS-E----------------EXXX-XSS---------SX---X---------S----S-------------X------SXS-SQQ----SSSSSSX------------XX-------SSSSSSSSS------------
SSSS-----------------------------------------------------------------------------------------------S----------X-----------------------------
-SSSSX-----------------------------------------------------------------X--------------------------SSS-------XX------------------------------
SXS--------SXSXSXSX-------------------------------------X-------------XXXX---------S----E---------SSS------XXXXX--------------------------S-
X-----------S------------SSS-------------------------------X---------------------XX-S--<?S-------SXSSS------XX--S--QQQ---SSS-SSSS-----------
----------------------------------------------------------------------------------------]-------------------XX------------------------------
---------------------------------------------------------------------------------------[]-------S---------XXXXXX------------------------XXXX
-------------------------------------------------------------------------------------E-[]---------EE-E-EE-XXXX---E------------EE-E------X---
------XXXX-XXXXXX----------X----------------------------------------------------------XXXXXXXXXXXXXXXXXXXXXXXXX----XXXXXXXXXXXXXXXXXXXXXXXXX