--------------------------------------------------------------------------------------------------------------------------------------------
--------------------------------------------------------------------------------------------------------------------------------------------
--------------------------------------------------------SSSXSXSXSXS-----------------------------------------------SSSSSSSSSSS---------------
--------------------------------------------------------------------------------------------------------------------X-----------------------
-------------------------------------------------------------------XSXSXSXS-----------------------------------------------------------------
------------------SS-------S----------------------------XQ-----SSS-------------------------------Q------------------------------------------
--------------------------------------------------------------------------------------------------------------------------------------------
----------------------------------------------------------------------SS--------XX----------------------------------------------------------
------------------SX---------------------XXX--------------------------S--------XXX-----------------------E----XX-------------------------XX-
<E------XXX----------SSS--------------------------------SSSSXS--------------------------E-----------S---S----XXX--------------------X--XXXXX
<>-----------------------------------X----------------------------------------XXX------<>--------E---------XXXXX----------E--------XXXXXXXXX
[]----------------------------SX-----XX---------------------------------------XXXX-----[]-----------------X-XXXX---------<>--------XXXXXXXXX
[]----S------------------------------X----------EE-----------------E---E-E-E--XX------[]--[]------------E-E--XXX---EE----[]-------XXXXXXXXXX
XXXXXXX-XXXXXXXXXXXXXXXXXXXXXXXX-----X------XXXXXXXXXXXXXXXXXXXXXXXXXXXXXXXXXX--------XXXXXXXXXXXXXXXX-XXXX-XXXX-XXXXXXXXXXX-XXXXXXXXXXXXXXX