--------------------------------------------------------------------------------------------------------------------------------------------
--------------------------------------------------------------------------------------------------------------------------------------------
--------------------------------------------------------SS-S-SS--SSSSSSSSS------------------------------------------------------------------
--------------------------------------------------------------------------------------------------------------------------------------------
--------------------------------------------------------------------------------------------------------------------------------------------
--------------------------------------------------------X--S--------EQ-----------------------------------------------SS---------------------
-----------------------------------------------------------------------------------------------------------SXXXX----------------------------
------------------------XX-------------------------------------------------------------------------------------X----------------------------
----------SXSXS--------------------------------------------------------------E----XX--------------------------------------------SXSX--------
-QQQQQ------------------X---------------------------X-------E-----------SX--X--X-XXX----------X--------S-S-------E--------------------------
------------------------X-------------------------------E--<>-----E-SSS----XXX-XXXXX----------XX---E------------<>--------------------------
-----------------------XXXXX--------------------------XX---[]----<>S-SS-----XXXXXXXX----------XXXXX-------------[]--------------------------
---------------E-E----------------------------------E-XX---[]-[]-[]--------XXXX-XXXX----------XXXX--------------[]--------------------------
XXXXXXX-XXXXXXXXXXXXX--------------XXX----------------X---XXXXXXXXXXXXXXXXXXXXX-XXXXXXXXXXXXXXXXXXXXXXXXXXXXXXXXXXXXXXXXXXXXX--XXXXXXXXXXXXX