--------------------------------------------------------------------------------------------------------------------------------------------
--------------------------------------------------------------------------------------------------------------------------------------------
----------------------------------------------------------SXS-------------------------------------------------------------------------------
--------------------------------------------------------------------------------------------------------------------------------------------
------------------------------------------------------------------SXSXSXSXSX------------------------------------------------SXSXSXSX--------
--------------------------------------------------------SQS----SSSS---------------------------------------------XQQ----S-SSSSX----Q---------
--------------------------------------------------------------------------------------------------------------------------------------------
----------------------------------------------------------------------SS---------X------XX--------------------------------------------------
---------------------E----------------------SX---------------------------------------------------XXX----------------E---------------------XX
------<>--------Q---<>----------------------------------SSSSXS------------------------XX------E----------X------?--<>-----------QQQ------XX-
--------------------[]----------------XXX---------------------------------------X---------E--<>---------X------->--[]--------------------XX-
--[---[]------------[]----------------XX--------------------------------------XXXXX---XX-----[]---------XX------]--[]------SS----------XXXX-
--X]--[]-EE-E-------[]---------------------------------------------E--EE-E-E--XXX-----X------[]---------XX-----X>E-[]---------EE-E--EEXXXXX-
XXXXXXXXXXXXXXXXXXXXXXXX----XXXXXXXXXXXXXX--XXX---XXXXXXXXXXXXXXXXXXXXXXXXXXXXXXX-----XX-XXXXXX--XXXXXXXXXXXXXXXXX-XXXXXXXXXX-XXXXXXXXXXXXX-