--------------------------------------------------------------------------------------------------------------------------------------------
--------------------------------------------------------------------------------------------------------------------------------------------
SSXSXSXSXSSSSSSSSSSSSS---SSS----------------------------------------------------------------------------------------------------------------
----------------------------------------------------------------------------------------------------------------XXX-XX----------------------
---------------------------------------------------E--E-------------------------------------------------------------------------------------
-------------------E--E-----S------X-----SXS--------SXXS-------------------------S----------------------------------------------------------
--------------------XXXX--------------------------------------------------------------------------------------X-----------------------------
--XSX--------------------------------------------------------------------------------------------------------SX-----------------------------
XXS----------SXS-----------------------XX--------------------------------------------------------------------XX-----------------------------
----------E----------XXXX---XXXX------------------------------S-S-----------------E----------------------X--XXXX-----------------------X----
---------------------------------------------------------------------------------<>----------------------XXXXXXX---------E-----------XXXXX--
---------X---------XX-------------------------------------------------------------]---------------------XXXXXXXX--------<>----------XXXXXX--
---------X---------XX------------E-------------------SS-----------------E-EE----E[]------------S-------XXXXXXXXX---EE---[]----------XXXXX---
-XXX--XXXXX-XXXXX-XX-X----XXXXXXX-------XX--------------XXXX-XXXXX-XXXXXXXXXXXXXXXXXXXXXXXXXXXXX--XXXXXXXXXXXXXXXXXXXXXXXXXX---XXXXXXXXX----