--------------------------------------------------------------------------------------------------------------------------------------------
-----------------------------------------------------------------------------------------------SS-------------------------------------------
-----------------------------------------------------------------------------------------SSSSSSSSSSSSSSS-S----SS----------------------------
--------------------------------------------------------------------------------------------SSSSSSSSSSSSS-----------------------------------
--------------------------------------------------------------------------------------------SSSSSSSSSSSS------------------------------------
-------------------Q----------------------------------------------------------------X--S----SSSSSSSSSSSS----------SSSSS----------X----------
------------------------------------------------------------------------------------------------------------------S------------XXX----------
--------------------------------------------------------------------------------------------------------------------------------------------
------------------------------------------------------------------E----------E----------------?----------?-E-XSX---------------XXXX---------
XXX------------Q--------------------------------------E---X------<>----E----<>----------E-----??S--SSSS------SS----X-XXX--------------------
XXX---------------E----------------------------------<>-X-X------[]---------[]---------<>-------SSS----------X--------------E---------------
XX---------------------------------------------------[]---X------[]---------[]---------[]------SSSS---------XX]---------S-S-----------------
XX---SS-----E---------------E---------------E--------[]---X---E--[]-E-------[]---------[]-[]---------E--E-E--XX----XSE--S----------------E--
XXXXXXXXXXXXXXXXXXXXXXXXXXXXXXXXXXX-XXXXXXXXXXXXXXXXXXXXXXXXXXXXXXXXXXXXXXXXXXXXXXXX---XX---X-XXX-XXXXXXXXXXXXXXXXXXXXXXXXXXXXXXXXXXXXXXXXXX