--------------------------------------------------------------------------------------------------------------------------------------------
--------------------------------------------------------------------------------------------------------------------------------------------
------------------------------------------------------------------------------------------------SSSSSSSSSSSSSSSS----------------------------
--------------------------------------------------------------------------------------------------------------------------------------------
--------------------------------------------------------------------------------------------------------------------------------------------
---------------------------------E?SS----------Q--------------------------------------------SSSSSSSSSSSS------------------------------------
--------------------------------------------E----------X-------------------------------SX---------------------------------------------------
-----------------------------XSXSX--------E------------------------------------------E------------------------------------------------------
----------E----------E----------------------XSX---------------------------------------------------------------------------------------------
--X------<>---------<>---E--XXX--XXX-------Q---------------------------------------XX-----<>---SSSSSSSS------SQS----------------------X-----
E-<------[]---------[]--XXXXXXX---------E-----E-E---------------------------------XX------[]---SS-S-SSS------------------E------------X-----
--[]-----[]---------[]------XX--S---S---X-----------------------------------------XX------[]-----SS-----------------------------------X-----
--[]--E--[]---------[]------XX-XS--SS---X------------E--------------------------EXXXX----S[]----SS----------------------------------X-XX----
XXXXXXXXXXXXXXXXXX--XXXX--X-XXXXXXXXXXXXXXXXXXXXXXXXXXXXXXXXXXX--------X-XXXXXXXXXXXXXXXXX--XXXXXXXXX-XXXXXXXXXXXXXXXX---XXXXX--XXXXXXXX-XXX