--------------------------------------------------------------------------------------------------------------------------------------------
--------------------------------------------------------------------------------------------------------------------------------------------
--------------------------------------------------------------------------------------------------------------------------------------------
--------------------------------------------------------------------------------------------------------------------------------------------
-----------------SX-----------------------------------E------------------------------XXXXX--------------------------------------------------
-S-----------------XXXX-----S------X----------------XXXX-S-SS------------------------E------------------------------------------SSSS-------S
--------------------------------------------------------------------------------------XXXXXXX-----------------------------------------------
-----------------------------------------------------------------------X--------------------------------------------------------------------
--------------------------------------SSXX--------------X-X-----------XX----------------------------------------------------------S---------
------SS--------------------XXXX-------------------X-------------------------------------------XXX------------XX<>-------SX-----Q-Q--SSS----
-----------------------------------------------------------------------------------------------------------XX-XX[]------------------------E-
----------------------------------------------------------SX-----------------------------------------------XXXXX[S----SS--------------------
---------------E--------X------------------------------X--S-----------------------XX---------------------X-XXXXX[]----S------------------[E-
XXXXXXX----XXXXXX---X--XX--X----XXXX-X-------------------------------------------XXXX------------------XXXXXXXXXXX--XXXXXX---XXXXXXXXXXXXXXX