--------------------------------------------------------------------------------------------------------------------------------------------
--------------------------------------------------------------------------------------------------------------------------------------------
SSSSSSSSSSSSS------SSSSSS-------------------------------------------------------------------------------------------------------------------
--------------------------------------------------------------------------------------------------------------------------------------------
----------------------------X-XXXXX---------------------------------XXXXXXXX----------------------------------------------------------------
--------------------------------------------------------SQS-----------------XX----------------------------------SS----------X-----E---------
---------------------------------------------------------------------------------------------------------------------------------XXXX-------
----------------------------------------------------------------E---------------------------------------------------------------------------
---------------------E------------------------------------------------------------------------------------------------------SX--------------
--------------------X--------------------------SSS----E-SSSSSSSS-----------------------------------Q------------------------X---------XXXX--
---E------E--E-----XXX-------------------------------<>---------------------------------------------------------------------------------X---
---[-----<>---------XXX------------------------------[]--]---------------------XX-----------------------------------------------------------
---[]-E--[]-----XX--XXX------EEEE---SS---EE-E--E-----[]------------E-E-E-------XX---------------E-------------------------------------------
XXXXXXXXXXXXXXXXXXX-XXXXXXXXXXXXXXXXXXXXXXXXXXXXXXXXXXXXXXXXXXXXXXXXXXXXXXXXXXXXX---XXXXXXXXXXXXXXXXXXXXXXXXXXXX----------------------------