--------------------------------------------------------------------------------------------------------------------------------------------
--------------------------------------------------------------------------------------------------------------------------------------------
-------------------------------X-----------------------------------SSSSSSSSSSSSSSSSS--------------------------------------------------------
--------------------------------------------------------------------------------------------------------------S-----------------------------
------------------------------------------SXSX-----------------------------------------------------------------E----------------------------
---------------------------------XXX-----------------------S------------S------------SS?S--------SQ---------SSSS----------------------------
---------------------------------X-------------------------SX----------------------------------E--------------------------------------------
---------------------------------------------------------------------------------------------------X-X--------------------------------------
------------------------------------------------------------------E----------E---------------------------------S----------------X-----------
----------------------------SSSSSS-----XXXX---------XX--------[]-[]--SSSS---<>---QQQ----------------------------X--------------Q-----------S
---------->-------------E------------------------XXXXX----<---[]-[]--[]--X--[]----------------XXXXXX----------------------------------------
---------[]---------<>---------------------------XXXX-----[]--[]-[]--SS-----[]--------------------------------------------------------------
---------[]---------[]-----------------S---------XXXX-----X--S[]-[]-[SS-X---[]----------------------------------------------E---------------
XXXXXXXXXXXXXXXXXXXXXXXX----XXXXXXXXXXXX---XXXXXXXXXX---XXXXXXXXXXXXXXXXX--XXXXXXXXX------------------------XXXXXXXXXXXXXXXXXXXXXXX-XXXXXXXX