--------------------------------------------------------------------------------------------------------------------------------------------
--------------------------------------------------------------------------------------------------------------------Q-----------------------
------------------------------SXSXSXSXSX----------------------------------------------------------------------------------------------------
----------------------------XXXXXXX---------------------------------------------------------------------------------------------------------
-----------------------E---------XX---SXSX---X------------------------------------------------------------------S------------S--------------
-------------S--------XX-E----------------------------------------------------------------------------------------SS-SSSS-------------------
-------------------------------------------S---------------------------------------X----------------------------SSS-------------------------
---------------------------------------E--XS---------------------------------------X-----------------------------SSS------------------------
---------------------------------------------------XXX------------E---------------------------------------------SXS--------SXSXSXSX---------
-QQQQQQ------SS----------------SX---------X--------XXX----X------<X----E-----E----------------------------------X-----XXX-------------------
-------------------------------------E-----------XXXXX--X-X---E--[X---------<>----------------------------X---------------------------------
-------------------------SXXX--<>---<>----------XXXXXX---XX------XX---------[]--------------------------------------------------------------
---------------E-EE----------[][]---[]-------XXXXXXXXX---XX---E--XX-E-------[]-----------------------E----X---------SE---------------------X
XXXXXXXXXXXXXXXXXXXXX-------XXXXXXXXXXXXX-XXXXXXXXXXXXXXXXXXXXXXXXXXXXXXXXXXXXXXXXXXXXXXX----XXXXXXXXXXXXXXXXXXXXXXXXXXXXXXXXXXXXXXXXX--XXXX