--------------------------------------------------------------------------------------------------------------------------------------------
--------------------------------------------------------------------------------------------------------------------------------------------
------------------------------------------------------------------------------------------SS------------------------------------------------
--------------------------------------------------------------------------------------------------------------------------------------------
--------------------------------------------------------------------------------------------------------------------------------------------
------?SS---------?Q---------------------------------------------------------------X--------------------------------------SSSQ--------------
----------------E----------X-------------------------XS-------------------------------------------------------------------------------------
-X-----------------------------------------X-X----------------------------------------------------------------------------------------------
------------------X-------------------------------------SE---------SX--SSSX-----------------------SX-------X-------->--------------------XXX
XXX------------Q-----S?---------------X-----------------X-----XXXX----------------------------------------X--------[]------S----S-------XXXX
XXX---------------E-------------------XX------------------------------------------------------------------X--------[]-------SE----------XXXX
XX----SS----X-------------------------XXXXX------------------------------------------------------------------------[]------SS---------XXXXXX
XX---SXS----XX-----------E-E---------------------------------E-----------------------------------------------------[]---------------EXX-XXXX
XXXXXXXXXXXXXXXXXXXXXXXXXXXX----------------------XXXXXXXXXXXXXXXXXXXXXXXXXXX-------XXXXX----XXXXXXXXX--------XX-XXXXXXXX-XX--XXXXXXXXXXXXXX