--------------------------------------------------------------------------------------------------------------------------------------------
--------------------------------------------------------------------------------------------------------------------------------------------
----------------------------------------------------------------------------------------------------------------SSSSSSSSSSSSSSSSSSSSSSSSSSSS
------------------------------------------------------------------------E-------------------------------------------------------------------
---------------------------------------------------------S--XXX---SXSXSXSXSX----------------------------------------------------------------
--------------------------------------------------------SQQ---XSSS----------S---------------------------------------------------------------
--------------------------------------------------------------------------------------------------------------------------------------------
--------------------------------------------------------------------------------------------------------------------------------------------
--------------------------------------SXSX--------------------------------------------------------------------------------------------------
XXX------------Q--------------Q-------------------------SSSSXS-----------------------SSSSS-----------------------------------<>-----X-XX----
XXX---------------E-E---E-->---------------------------------------------------XX-------------------------XXX------E-----[E--[-----XXXXX--XX
XX----------X-------------->-------------------------XXX[]--------------------XXX-------------------------XXX------------<>--SS----XXXXXXXX-
XX----------X-------E-----[]----------------------------X-E-----SS-E-E---E-E--XXX------------------E------XX-------EE-E--[]-----XX-XXXXXX-X-
XXXXXXXXXXXXXXXXXXXXXXXXXXXX----XXXX--------------------XXXXXXXXXXXXXXXXXXXXXXXXX---XXXXXX--XXXXX-XXXXXXX------X-XXXXXXXXXXXXXXXXXXXXXXXXXXX