--------------------------------------------------------------------------------------------------------------------------------------------
--------------------------------------------------------------------------------------------------------------------------------------------
--------------------------------------------------------------------------------------------------------------------------------------------
--------------------------------------------------------------------------------------------------------------------------------------------
-----------------------------------------------------E---------------------------E---------------------------E---------------------------E--
----------------------------SS-S-------SX-----------SXS-SS---------SX-----------SSS-SSS--------SX---X--XSX--SXSSXS---------SX-------------S-
---------------------------------------------XX--------------------------XX--------------------------XX--------------------------XX---------
--------------------------------------------------------------------------------------------------------------------------------------------
---------------------E---------------------------------S---------------------------S-------------------------------------------------------S
--------------------X------------------------------XXXXX------------------------XXXX-------------------------XXX-----------------------XXXXX
----------E---------XX--XXXX----------------------------------------------------------------------------------------------------------------
---------<>---------<>----------------------------------------------------------------------------------------------------------------------
---EE-E--[]---------[]----------------------------------------------------------------------------------------------------------------------
XXXXXXXXXXXXXXXXX---XXX---------------------------------------------------------------------------------------------------------------------