--------------------------------------------------------------------------------------------------------------------------------------------
--------------------------------------------------------------------------------------------------------------------------------------------
--------------------------------------------------------SSXSSSXSXS-SSS----------------------------------------------------------------------
--------------------------------------------------------------------------------------------------------------------------------------------
--------------------------------------------------------------------------------------------------------------------------------------------
----------XX---SX--------S-----SS------------X------SSSS------------------------------------------------------------------------------------
---------------------------------------E--XX-X------------------------------SX---------------------------------X----------------------------
---------------------------------------------X-----------------------------------------------------------------X----------------------------
--------------------------------------------SX-X----------X----------XSX--------------------------------------------------------------------
------E-------------------->---X---------------------------------------------XXXXX----------------------QQ----------------------------------
-------------------E------<>----------XXXX?-------------------------------------X-------------------------------------------------------E---
------------------<>------[]---------------------------------------------------------S-------------------E----------------------------------
------------------[]----X-[]-----E-------------------------------------------X-----XESX---E---E-E-------------------------------------------
XXXXXXXX----XXXXXXXXXXXXXXXXXXXXX-------X---XXXXXXXXXX-X---XXXXXXX-----X-XXXXX-----XXXXXXXXXXXXXXXXXXXXXXXXXXXXX--------------------X-XXXXXX