--------------------------------------------------------------------------------------------------------------------------------------------
--------------------------------------------------------------------------------------------------------------------------------------------
--------------------------------------------------------------------------------------------------------------------------------------------
--------------------------------------------------------------------------------------------------------------------------------------------
--------------------------------------------------------------------------------------------------------------------------------------------
---S------------S-------------------------Q-------------------------------------------------------------------------------------------------
---SX----------------------------------------------------------------------------------SX---------------------------------------------------
-------------------------------------------------------------------------------------------E------------------------------------------------
?---------E----------E--------------------------------------------------------------------<>--E----------E----------------------------------
--X---<>-----SSEE---<>---E-E---------------------------E------------------------------X---[]-[]-----E---<>---E-E---------------------SSS----
--<---[]-----SS--X--[]--XXXX----------XXXXXX----------<>----------------------------E-<]--[]-[]------X--[]--XXX?---------------E------------
--X---[]-----SS-----[]----XX--------------------------[]----------------------------X-[]--[]-[]---------[]----------------------------------
X-X--S[]--S-SS------[]----XX--------------------------[]----------------------------X-X]--[]-[]-E-------[]-------------------------E--------
XXXXXXXXXXXXXXXXX--XXXXXXXXXXXXXXXXX-------XXXXXXXXXXXXX--------------XXXXXXXX----XXXXXXXXXXXXXXXXXXXXXXXXXX--X-XXXXXXXXXXXXXXXXXXXXXXXXXXXX