--------------------------------------------------------------------------------------------------------------------------------------------
--------------------------------------------------------------------------------------------------------------------------------------------
------------------------------SXSXSXSXSSSS------------------------------------------SSSSSSSSSSSSSSSSSSSSSS---SSS----------------------------
----------------------------XXXXXXX---------------------------------------------------------------------------------------------------------
--------------------------------------------------------------------------------------------------------------------------------------------
------------------------SSS-----------------------------------------SSSSSSS------------------------------------------S----------------------
-------XX----------------------------------S------------------------------------------------------------SXSX--------------------------------
---------------------------------------E--XS--------X-------------------------------------------------------XX------------------------------
---------------------------S-----------------------XXXX-SE---------SX--SSS------------------------E--------XXX------------------------------
--------------------------XX---SX---------X--------XXXXXX-----XXXXS--SSSSS--------------------E---------XXXXXX------------------------------
------------------------------------------------XXXXXX---------------------------------------<>---------XXXX----------------------------E-XX
-------------------------------<>---<>---------XXXXXXXX--------------------------------------[]--------XXXXX------------------------------XX
-------------------------------[]---[]-------XXXXXXXXXX--------------------------------------[]-----XXXXX-XXXX----------------------------XX
-------------------------XXXXXXXXXXXXXXXX-XXXXXXXXXXXXXXXXXXXXXXXXXXXXXXXXXXXX--XXXX--XXXXXXXXXXXXXX----------XXXXXXXXXXXX-----XXXXXXXXXXXXX