--------------------------------------------------------------------------------------------------------------------------------------------
--------------------------------------------------------------------------------------------------------------------------------------------
----------------------------SSXSXSXSSSSSSSSSSSSS-S----SS------------------------------------------------------------------------------------
--------------------------------------------------------------------------------------------------------------------------------------------
X----------------S-S------------------------------------------------------------------------------------------------------------------------
----------X--------------SS----------------------------------------------------------------------------------------------------SSS----------
-------XX---------------------------------------SXXX----------------------------------------------------------------------------------------
--------------------------------------------------------------------------------------------------------------------------------------------
----------------------------X-X----------XXX------------------------------------------------------------------------------------------------
------E-------------------------------E----------XXXXXXX------------------------------------------------------------------------------------
---------------E---E-----------------<>-----------------------------------------------------------------------X-----------------------------
------------------<>-----------------[]---------------------------------------------------------------------XXXX----------------------------
------------------[]----E-E----------[--------XXX----------EE------------E----E------------------E-E--------XXXX----------------------------
XX---XXXXX--XXXXXXXXXXXXXXXX-------XXXX----------------XXXXXXXXXXXXXXXXXXXXXXXXXXXXXXXXXXXXXXXXX-----X-XXX-XXXXXXXXXXXXXXXXX---XXXXXX-XXXXXX