--------------------------------------------------------------------------------------------------------------------------------------------
--------------------------------------------------------------------------------------------------------------------------------------------
-----------------------------------------------------------------------------------------------------SSSSSSSSSSS----------------------------
--------------------------------------------------------------------------------------------------------------------------------------------
-----------------------E-EE-----------------------------------------------------------------------------------------------------------------
S-S?------XSXSXSX-------SSSS------------------SS-------S--------------------------------------------------------SSS-------XXX--SX--XSX------
--------------------------------------------------------XXXXX-------------------------------------------------------------------------------
--------------------------------------------------------------------------------------XXX---------------------------------------------------
-----------XX---------------------------------SX----------------------------------------------E---------------------------------------------
XXX-------------------------<>----------------Q--SSS----------------------------------X------<>--<SE-----E---QQQXQ----E---------------------
----------------------------[]------------------------------------------------------------E--[]---------<>----------------------------------
----------------------------[]----SS-------------------------------XXXX---------------X------[]--[]-----[]----------------------------------
-------------------------SS-[]----S---------------------------------------------------X---E--[]-[]--X---[]----------------------------------
----------------------------XXXXXXXXXXXXXXXXXXXXXXXXXXXX--------XX-------XXXXXXXXXXXXXXXXXXXXXXXXXXXXXXXXXXXXXXXX-----X-------------X-------