--------------------------------------------------------------------------------------------------------------------------------------------
--------------------------------------------------------------------------------------------------------------------------------------------
--------------------------------------------------------------------------------------------------------------------------------------------
--------------------------------------------------------------------------------------------------------------------------------------------
------------------------------------------------------------E-------------------------------------------------------------------------------
--------------------------------------SSSS----SQ----------SSSSSS--------SS------------------------------------------------------------------
--------------------------------------------------------------------------------------------------------------------------------------------
--------------------------------------------------------------------------------------------------------------------------------------------
--------------------------------------------------------------------------------------------------------------------------------------------
---------------------SSQS--S----S--SSS---------SS----SS------------------------------------------------X---------SS----<>--------XX--X------
-----------------------------------------------------------------------------------------------X--XX---XX--------------[]-------XXX--XX-----
--------<>-------<>---------------------------------------------------------------<>-------<>-X---XXXXXXX-------X------[]------XXXX-----XXX-
--------[]-------[]-------------------------E------E------------------------EX----[]-------[]XX---XXXXXXXX------<>----E[]-----XXXXX---XXXXX-
XXXXXXXXXXXXXXXXXXXXXXXXXXXXXXXXXXXXXXXXXXXXXXXXXXXXXXXX---------------------------XXXXXXXXXXXXXXXXXXXXXXXXXXXXXXXXXXXXXXXXXXXXXXXXXXXXXXXXX