--------------------------------------------------------------------------------------------------------------------------------------------
--------------------------------------------------------------------------------------------------------------------------------------------
--------------------------------------------------------------------------------------------------------------------------------------------
--------------------------------------------------------------------------------------------------------------------------------------------
--------------------------------------------------------------------------------------------------------------------------------------------
---------------------------------------------------SSSQ----------------------------X------------------------Q---------------SQS---------Q---
----------------------------------------------------------------------------------XX--------------------------------------------------------
--------------------------------------------------------------------------------XXXX---------------------------------------E----------------
---------------------------------------------------------------------------------XXX--------------------------------------------------------
---------------------SS-----S--Q-----S----SS----S--------------<>-Q-----X---XXXX-XXX--<>-------SQ--------SSQS--Q--<>-----S?S------S--Q--QSSQ
X--------------------------------------------------------------[]------XXX--XXXX-XXX--[]--------------------------[]------------------------
--<>-----------------------------------------------------------[]-----XXXX--XXXX-XXX--[]----------------------------------------------------
--[]-------------------------------------------------E-E---E-E-[]-E--XXXXX-XXXXXXXXX--[]--------------E-----------------------E-E-E--E------
XXX--------------XX---XXXXXXXXXXXXXXXXXXXXXXXXXXXXXXXXXXXXXXXXXXXXXXXXXXXXXXXXXXXXXXXXXXXXXXXXXXXXXXXXXXXXXXXXXXXXXXXXXXXXXXXXXXXXXXXXXXXXXX