--------------------------------------------------------------------------------------------------------------------------------------------
--------------------------------------------------------------------------------------------------------------------------------------------
--------------------------------------------------------------------------------------------------------------------------------------------
--------------------------------------------------------------------------------------------------------------------------------------------
------------------------------------------------------------E-------------------------------------------------------------------------------
--------------------------------------------------------SSSSSSSS--------SSQSS---------------------------------------------SSSS-----Q-------X
------------------------------------------------------------------------------------------------------------------------------------------XX
--------------------------------------------------------------------------------------------------------------------------------------------
----------------------------------------------------------------------------------------------------------------------------------------XXX-
-Q-----Q--Q---------------<>-SS----Q--Q-----X-----X----X--------------------------<>------------?S------------------S--SSS---------S----XXX-
---------------------XX---X?--------------XX----XXX---XX--------------------------[]--------------------------------------------------XXXX--
---------------XXX--XXX--XXX--------------XXX---XXX--XXX--------------------------[]-----------------<>-------------------------------XXXX--
-------E--E----XXX-XXXX-XXXX-------E--EE-XXXX--XXXXXXXXX--------------------E-----[]------------E----[]-------E--------------EEEEE--E-XXXX-X
XXXXXXXXXXXXXXXXXXXXXXXXXXXXXXXXXXXXXXXXXXXXXXXXXXXXXXXX----------------------XXXXXXXXXXXXXXXXXXXXXXXXXXXXXXXXXXXXXXXXXXXXXXXXXXXXXXXXXXXXX-