--------------------------------------------------------------------------------------------------------------------------------------------
--------------------------------------------------Q-----------------------------------------------------------------------------------------
--------------------------------------------------------------------------------------------------------------------------------------------
--------------------------------------------------------------------------------------------------------------------------------------------
--------------------------------------------------------------------------------------E-----------------------------------------------------
----S--------------------------------SSSQ-------------XXSSSSSSSS--------------------SSSSSSSS--------SSSQ-------X----------SSSQQ----Q--------
-----------------------------------------------------XXX-------------------------------------------------------X----------------------------
----------------------------------------------------XXXX------------------------------------------------------------------------------------
---------------------------------------------------XXXXX------------------------------------------------------------------------------------
--------------------------<>-------?S-------------XXXXXXX-------------QS-------------------Q------S-------XX--XX---SS--SSS---------SS----SS-
--------------------------[]----------------X----XXXXXXX-------------------------------------------------XXX--XX----------------------------
--------------------------[]---------------XXX--XXXXXXXX------------------------------------------------XXXX--XX----------------------------
--------------------------[]-E------------XXXX--XXXXXXXX---------------------------------------E---E----XXXX--XX-E------------EEE------E-E--
------XX------X-----XXXXXXXXXXXXXXXXXXXXXXXXXXXXXXXXXXXXXXXXX----XXXXXXXXX----XXX-XXXXXXXXXXXXXXXXXXX--XXXXXXXXXXXXXXXXXXXXXXXXXXXXXXXXXXXXX