--------------------------------------------------------------------------------------------------------------------------------------------
--------------------------------------------------------------------------------------------------------------------------------------------
--------------------------------------------------------------------------------------------------------------------------------------------
--------------------------------------------------------------------------------------------------------------------------------------------
--------------------------------------------------------------------------------------------------------------------------------------------
---------?-------------------QQ---------SSS---------QSQS----------------------------------------------------------------------SQ-------SSSQS
--------------------------------------------------------------------------------------------------------------------------------------------
--------------------------------------------------------------------------------------------------------------------------------------E-----
----------------------------------------------------------------------------------------------------------S---------------------------------
--S----B<>-------X--X-------?--Q--Q--S----------S?SQS--------------------------------SS--------------XX---------X-------------QS------S-----
--------[]-----XXX--X---X-----------------------------------------------X-XX----------------<>-------XX-------------------------------------
--------[]----XXXX---XXXX---------------------------------<>----<>-----XXXXX--------X-------[]------XXX------<>-----------------------------
-E-E-EE-[]---XXXXX--XXXXX-------------------E-------------[]---Q[]-----XXXXX--------<>------[]------XXX------[]-----------------------------
XXXXXXXXXXXXXXXXXXXXXXXXXXXXXXXXXXXXXXXXXXXXXXXXXXXXXXXXXXXXXXXXXXXXXXXXXXXXXXXXXXXXXXXXXXXXXXXXXXXXXXXXXXXXXXXXXXXXXX---XXXXXX-XXX---XXXXXX