--------------------------------------------------------------------------------------------------------------------------------------------
------------------------------------------------------------------------------Q-------------------------------------------------------------
--------------------------------------------------------------------------------------------------------------------------------------------
--------------------------------------------------------------------------------------------------------------------------------------------
--------------------------------------------------------------------------------------------------------------------------------------------
------------SSS--------------------------------------------------?--------------------------------SQ-------SSSQS----------------------------
----------------------------------------------------------------------------------XX--------------------------------------------------------
---------------------------------------------------------------------------------XXX----------------------E---------------------------------
--------------------------------------------------------------------------------XXXX--------------------------------------------------------
---------S---------SS------------------------<>----------SS-----<>-------X-S-X--XXX-Q--Q--Q--Q----?S----S?--S---------------QSQS----SSSQS---
-------------------------------B----<>-------[]-----------------[]------X----XX-XXX---------------------------------------------------------
------------------------------<>----[]-------[]-----------------[]-----XXX---XXXXXX---------------------------------------------------------
----------------E------E-E----[]----[]-------[]-------E-EE----E-[]----XXXX--XXXXXXXX---------------------E-----E---E------------------------
XXXXXXXXXXXXXXXXXXXXXXXXXXXXXXXXXXXXXXXXXXXXXXXXXXXXXXXXXXXXXXXXXXXXXXXXXXXXXXXXXXX-XXXXXXXXXXXXXXXXXXXXXXXXXXXXXXXXXXXXXXXXXXXXXXXXXXXXXXXX