--------------------------------------------------------------------------------------------------------------------------------------------
--------------------------------------------------------------------------------------------------------------------------------------------
--------------------------------------------------------------------------------------------------------------------------------------------
--------------------------------------------------------------------------------------------------------------------------------------------
--------------------------------E-----------------------------------------------------------------------------------------------------------
--SSS-----------S------SS-----SSSSSS-------SSSQSS--SS---SSSS---------SS--------------------------------------------------S----------------XX
-----------------------------------------------------------------------------------------------------------------------------------------XXX
-----------------------------------------------------------------------------------------------------X----------------------------------XXXX
-----------------------------------------------------------------------------------------------------X---------------------------------XXXX-
X-------------QS------------X-------------S-------------------------------------------------<>------XX-XX--------------QS-Q-----X-----XXXXXX
--------------------------------------------------------------------------------------------[]-----XXX-XX----------------------XX----XXXX-XX
------------------------------------------------------------------------------------X-------[]----XXXX-X----------------------XXX---XXXX-XXX
-------------------------------------------------------<>---------------------------E-EE----[]---XXXXX-XX------------E-E-----XXXX--XXXXXX-XX
XXXXX----XXXXXXXXX----XXX-XXXXXXX------XXXX--XX----X---XXXXXXXXXXXXXXXXXXXXXXXXXXXXXXXXXXXXXXXXXXXXXXXXXXXXXXXXXXXXXXXXXXXXXXXXXXXXXXXXXXXXX