--------------------------------------------------------------------------------------------------------------------------------------------
--------------------------------------------------------------------------------------------------------------------------------------------
--------------------------------------------------------------------------------------------------------------------------------------------
--------------------------------------------------------------------------------------------------------------------------------------------
--------------------------------------------------------------------------------------------------------------------------------------------
-------------------------------------SSSSSQ----------SSS----------------------------------?S----?S--SSSSS--SSSSS----------------------------
--------------------------------------------------------------------------------------------------------------------------------------------
----------------------------------------------------E---------------------------------------------------------------------------------------
--------------------------------------------------------------------------------------------------------------------------------------------
--------------------------------S--S?S---------SS-S?S------S-------------------------------Q------SS----S--------S-S-----Q---S----S---------
----------------------------------------------------------<>--------------------------------------------------------------------------------
----------------------------------------------------------[]-----S--------------------------------------------------------------------------
-----------------------------E-----------EEE-E--E--E------[]-----?---------------------------------------------E----------------E-E------EE-
-----------------------X---XXXXXXXXXXXXXXXXXXXXXXXXXXXXXXXXXXXXXXXXXXXXXXXXXXXXXXXXXXXXXXXXXXXXXXXXXXXXXXXXXXXXXXXXXXXXXXXXXXXXXXXXXXXXXXXXX