--------------------------------------------------------------------------------------------------------------------------------------------
--------------------------------------------------------------------------------------------------------------------------------------------
--------------------------------------------------------------------------------------------------------------------------------------------
--------------------------------------------------------------------------------------------------------------------------------------------
----------------------------------------------------------------------------------------E---------------------------------------------------
------------SSS--------------------------?SQ-------SQSQ---------------S---------Q---SSSSSSSS---S?SSSSSSSS---SSSS--SSSSS---------------------
--------------------------------------------------------------------------------------------------------------------------------------------
---------------------------------------E-----------------------------E----------------------------------------------------------------------
--------------------------------------------------------------------------------------------------------------------------------------------
Q---------------------------Q--Q--Q--S?---------S?--Q--QQ--Q--Q--Q-SQS----S--Q--Q--QX-------------S-----------------------------------------
--------------------------------------------------------------------------------------------------------------------------------------------
---------------------------------------------------------------------------------------------------------------<>-------------------------<>
----------------------XE---X----------------E----E----------------------E----E---------------------------------[]-------------------------[]
XXXXXXXXXXXXXXXXXXXXXXXXXXXXXXXXXXXXXXXXXXXXXXXXXXXXXXXXXXXXXXXXXXXXXXXXXXXXXXXXXXXXXXXXXX----XXXXXXXXX---XXXXXX--XX-------------------X---X