--------------------------------------------------------------------------------------------------------------------------------------------
--------------------------------------------------------------------------------------------------------------------------------------------
--------------------------------------------------------------------------------------------------------------------------------------------
--------------------------------------------------------------------------------------------------------------------------------------------
----E---------------------------------------------------------------------------------------------------------------------------------------
--SSSSS------------------------------?-----------------------SSS-----SSSSSSSS--SSSSS--------------------------------------------------------
-------------------------------------------------------X------------------------------------------------------------------------------------
-------------------------------------------------------X------------------------------------------------------------------------------------
-----------------------------------------------------XXX------------------------------------------------------------------------------------
-----------------------------QS-Q--QS-Q------X---XX--XXX--------------SS----S---------------------------------------------------------SQ----
--------------------------------------------XX---XXX-XXX---------------------------------------------<>-----------------------XX---X--------
--------------------XX----<>---------------XXX---XXXXXXX------------------------------<>---<>--------XX----------------<>-X----XX--XX-------
-------------------XXX----[]-E------------XXXX--XXXXXXXX---------------------------E--[]---[]X------XXXX----------EE---[]XX----XX--XX-------
---------------------------XXXXXXXXXXXXXXXXXXXXXXXXXXXXXXXXXXXXXXXXXXXXXXXXXXXXXXXXXXXXXXXXXXXXXXXXXXXXXXXXXXXXXXXXXXXXXXXXXXXXXXXXXXXXXXXXX