--------------------------------------------------------------------------------------------------------------------------------------------
--------------------------------------------------------------------------------------------------------------------------------------------
--------------------------------------------------------------------------------------------------------------------------------------------
--------------------------------------------------------------------------------------------------------------------------------------------
--------------------------------------------------------------------------------------------------------------------------------------------
------------SQ----------------------------S-------------------------------------------------------------------------------SSSSQ----Q--------
--------------------------------------------------------------------------------------------------------------------------------------------
--------------------------------------------------------------------------------------------------------------------------------------------
---------------------------X----------------------------------------------------------------------------------------------------------------
-SSSS---<>---------S-X---XX-Q--Q--Q--Q--Q-------SSSQS-----------<>-------<>---------------------------XXXX---------SS--S?S---------SS-------
--------[]-----------XX-XXX-------------------------------------[]-------[]----------------<>-------XXXXXXX---X-----------------------------
--------[]------------XXXXX-----------------------------X-------[]-------[]---------X------[]------XXXXXXXX--XXX----------------------------
<>----E-[]----EEE<>---XXXXX----E------------------------E-EE--E-[]-------[]------------E---[]------XXXXXXXX-XXXX-E-----------EEEE---E--E-E-E
XXXXXXXXXXXXXXXXXXXXXXXXXXX-XXXXXXXXXXXXXXXXXXXXXXXXXXXXXXXXXXXXXXXXXXXXXXXXXXXXXXXXXXXXXXXXXXXXXXXXXXXXXXXXXXXXXXXXXXXXXXXXXXXXXXXXXXXXXXXX