--------------------------------------------------------------------------------------------------------------------------------------------
--------------------------------------------------------------------------------------------------------------------------------------------
--------------------------------------------------------------------------------------------------------------------------------------------
--------------------------------------------------------------------------------------------------------------------------------------------
--------------------------------------------------------------------------------------------------------------------------------------------
-------------Q-------------------------------------------------------Q--------------------------SS--SSSS------------------------------------
---------------------------------------------XX---------------------------------------------------------------------------------------------
---------------------------------------------XXX--------------------------------------------------------------------------------------------
---------------------------------------------XXXX-------------------------------------------------------------------------------------------
--<>-------S------S--Q--Q--S-------<>-------XXXXX---------SSS----S--------S-------S---------------------------------------------------------
--[]-------------------------------[]------XXX-XXX-------------------------------------------------------------------------------<>---------
--[]------------------------X------[]-----XXXXXXXX----------------------------------------------------------------<>----<>-------XX---------
--[]--------E-E---E--E------E-EE---[]----XXXXXXXXXX------E------------E-E-E----E-E-----------------E------X----E--[]----[]-------XXX--------
XXXXXXXXXXXXXXXXXXXXXXXXXXXXXXXXXXXXXXXXXXXXXXXXXXXXXXXXXXXXXXXXXXXXXXXXXXXXXXXXXXXXXXXXXXXXXXXXXXXXXXXXXXXXXXXXXXXXXXXXXXXXXXXXXXXXXXXXXXXX