--------------------------------------------------------------------------------------------------------------------------------------------
--------------------------------------------------------------------------------------------------------------------------------------------
--------------------------------------------------------------------------------------------------------------------------------------------
--------------------------------------------------------------------------------------------------------------------------------------------
--------------------------------------------------------------------------------------------------------------------------------------------
----------------------------------------------------------------------------------------------------------------------------------------QS--
--------------------------------------------------------------------------------------------------------------------------------------------
--------------------------------------------------------------------------------------------------------------------------------------------
--------------------------------------------------------------------------------------------------------------------------------------------
------------?S-------Q-----S---------------------------------------S?S----Q--QS-Q--S--------------X---XX----------<>--------Q-------SSSQS---
----------------------------X----------------<>------------------------------------------------X--XX--XXX---------[]------------------------
-----------------<>-----------<>---<>--------[]--------------------------------------------<>-X---XXXXXXX---------[]------------------------
------------E----[]-------E---EB---[]--------[]X--------------------E-----E------------E---[]XX---XXXXXXXX--------[]------------------------
XXXXX-XXXXXXXXXXXXXXXXXXXXXXXXXXXXXXXXXX---XXXXXXXXXXXXXXXXXXXXXXXXXXXXXXXXXXXXXXXXXXXXXXXXXXXXX--XXXXXXXXXXXXXXXXXXXXXXXXXXXXXXXXXXXXXXXXXX