--------------------------------------------------------------------------------------------------------------------------------------------
--------------------------------------------------------------------------------------------------------------------------------------------
--------------------------------------------------------------------------------------------------------------------------------------------
--------------------------------------------------------------------------------------------------------------------------------------------
--------------------------------------------------------------------------------------------------------------------------------------------
-------------------------------------SS-----------------------------------------------------------------------------------------------------
------------------------------------------------------XX------------------------------------------------------------------------------------
-----------------------------------------------------XXX------------------------------------------------------------------------------------
----------------------------------------------------XXXX------------------------------------------------------------------------------------
-----------------XX--SSQ-----?--Q--SS-Q--------S----XXX------------S?S----Q--Q-----S--------------------------<>--------------X-X--X------<>
--------<>------XXX-------------------------------XXXXX-------------------------------------------------------[]-----------X--XX---XXX----[]
X-------[]------XXX------------------------------XXXXXX-------------------------------------------------------[]-------<>-XX--XXX--XXX----[]
E-EE----[]------XXX----------E-----------EEE-E--XXXXXX--------------E-----E-------E---------------------------[]-------[]-EX--XXX--XXXX---[]
XXXXXXXXXXXXXXXXXXXXXXXXXXXXXXXXXXXXXXXXXXXXXXXXXXXXXXXXXXXXXXXXXXXXXXXXXXXXXXXXXXXX---X---X-----------------X-X--XXXXXXXXXXX-XXX--XXXXXXXXX