--------------------------------------------------------------------------------------------------------------------------------------------
--------------------------------------------------------------------------------------------------------------------------------------------
--------------------------------------------------------------------------------------------------------------------------------------------
--------------------------------------------------------------------------------------------------------------------------------------------
----------------------------------------------------------------------------------------E---------------------------------------------------
--------------S--------SSSQS----------------SSSS----S---SSQ----------SS-------------SSSSSSSS-----------------------------S------------------
--------------------------------------------------------------------------------------------------------------------------------------------
----------------------E---------------------------------------------------------------------------------------------------------------------
--------------------------------------------------------------------------------------------------------------------------------------------
-S-----S-S----SS----S?-------S-----Q------S-------------X--Q--Q-------QS----S?SQS-----------------X----X---------------?S-Q-----X--X--------
--------------------------------------------------------------------------------------------------XX---XX----------------------XX---X-------
--------------------------------------------------------------------------------------------------XXX--XX---------------------XXX---XX------
---------------------------E---------------------------E--------------------------------------EX---XX--XXX-------E---E-E-----XXXX---XXXX----
XXXXXXXXXXXXXXXXXXXXXXXXXXXXXXXXXXXXXXXXXXXXXXXXXXXXXXXXXXXXXX---XXXXXXXXXXXXXXXXXXX---XXXXXXXXXX-XXX-XXXXXXXXXXXXXXXXXXXXXXXXXXXXXXXXXXXXXX