--------------------------------------------------------------------------------------------------------------------------------------------
--------------------------------------------------------------------------------------------------------------------------------------------
--------------------------------------------------------------------------------------------------------------------------------------------
--------------------------------------------------------------------------------------------------------------------------------------------
------------------------------------------------------------E-------------------------------------------------------------------------------
----------------------------------?S--SSQS----SQS-----SS-XSSSSS-----------------------------------------------------SSS---------S------SSSSS
--------------------------------------------------------------------------------------------------------------------------------------------
--------------------------------------------------------------------------------------------------------------------------------------------
--------------------------------------------------------------------------------------------------------------------------------------------
-----------------------------------QS-----S----SS------------------------------------------<>-Q-----X--X--------X-------------SS------------
-------------------------------------------------------------------------------------------[]------XXX--------------------------------------
--------<>-------XXX-----------------------------------<>----------------------------------[]-----XXXX-X------------------------------------
--E-----[]-------XXX---------------------E-E----E--E---E------------------------------EE-E-[]-E--XXXXX-X------------------------------------
XXXXXXXXXXXX----XXXXXXXXXXXXXXXXXXXXXXXXXXXXXXXXXXXXXXXX---------------------------XXXXXXXXXXXXXXXXXXXXXXXXXXXXXXXXXXX---XXXXXXXXXX---XXXXXX