--------------------------------------------------------------------------------------------------------------------------------------------
--------------------------------------------------------------------------------------------------------------------------------------------
--------------------------------------------------------------------------------------------------------------------------------------------
--------------------------------------------------------------------------------------------------------------------------------------------
--------------------------------------------------------------------------------------------------------------------------------------------
---------?-----------------------------------------------------------------------------------------------------------------------------SQ---
---------------------------------------------XX---------------------------------------------------------------------------------------------
---------------------------------------------XXX--------------------------------------------------------------------------------------------
---------------------------------------------XXX------------------------------------------------------E---S---------------------------------
--------<>------XX---------------------------XXXX--------SSS-------S?S----S--Q--Q--S------------------X---------------------QSQS-----Q--Q--Q
--------[]------XX--X--------------<>------XXXXXX----------------------------------------------------XX-------------------------------------
--------[]----XXXX----------X------[]------XXXXXX-----------------------------------X------<>--------XXX------------------------------------
E-EE--E-[]---XXXXX------------EE---[]-----XXXXXXXX------------------E-----E--E--------EE---[]-------XXXX------------------------------------
XXXXXXXXXXXXXXXXXXXXXXXXXXXXXXXXXXXXXXXXXXXXXXXXXXXXXXXXXXXXXXXXXXXXXXXXXXXXXXXXXXXXXXXXXXXXXXXX--XXXXXXXXXXXXXXXXXXXXXXXXXXXXXXXXXXXXXXXXXX