--------------------------------------------------------------------------------------------------------------------------------------------
--------------------------------------------------------------------------------------------------------------------------------------------
--------------------------------------------------------------------------------------------------------------------------------------------
--------------------------------------------------------------------------------------------------------------------------------------------
--------------------------------E-----------------------------------------------------------------------------------------------------------
-------------Q----------------SSSSSS--------SS------------------------------------------------------------------------------------------SSS-
--------------------------------------------------------------------------------------------------------------------------------------------
--------------------------------------------------------------------------------------------------------------------------------------------
--------------------------------------------------------------------------------------------------------------------------------------------
Q--S-------S?S----S--Q--Q--S--------------X----X-------------------------XX--X----XX---------------------SSQS-----------------SS------S-----
------------------------------------------XX---XX---------------<>-------XX--XX--XXX--------------------------------------------------------
------------------------------------------XXX--XXX-----<>-------[]-------XX------XXX--------------------------------------------------------
------------E-E---E--E----------------EE--XX---XXXX----[]-E-----[]------XXX---X-XXXX--------------------------------------------------------
XXXXXXXXXXXXXXXXXXXXXXXXXXXXXXXXXXXXXXXXXXXXX--XXXXXXXXXXXXXXXXXXXXXXXXXXXXXXXXXXXXXXXXXXXXXXXXXXXXXXXXXXXXXXXXXXXXXXXX---XXXXXXXXXXXXXXXXXX