--------------------------------------------------------------------------------------------------------------------------------------------
--------------------------------------------------------------------------------------------------------------------------------------------
--------------------------------------------------------------------------------------------------------------------------------------------
--------------------------------------------------------------------------------------------------------------------------------------------
--------------------------------------------------------------------------------------------------------------------------------------------
--------------------------------------------------------------------------------------------------------------------------------------------
--------------------------------------------------------------------------------------------------------------------------------------------
--------------------------------------------------------------------------------------------------------------------------------------------
--------------------------------------------------S-----------------------------------------------------------------------------------------
-----------------XX--X--------------<>-------XX----------S-----------S----S--------------------------<>--Q-----S---Q----------------SSSQS---
-------<>-------XXX--X---<>---------[]------XXX------------------------------------------------------[]-------------------------------------
X------[]-------XXX------XX-X-------[]------XXX---------------------------------------------<>-------[]-------------------------------------
E-EE---[]------XXXX-----XXXXE-EE--E-[]-----XXXX-------------------------E-E------EE-E-E-----[]--E----[]------------E------------------------
XXXXXXXXXXXXXXXXXXXXXXXXXXXXXXXXXXXXXXXXXXXXXXXXXXXXXXXXXXXXXXXXXXXXXXXXXXXXXXXXXXXXXXXXXXXXXXXXXXXXXXXXXXXXXXXXXXXXXXXXXXXXXXXXXXXXXXXXXXXX