--------------------------------------------------------------------------------------------------------------------------------------------
--------------------------------------------------------------------------------------------------------------------------------------------
--------------------------------------------------------------------------------------------------------------------------------------------
--------------------------------------------------------------------------------------------------------------------------------------------
--------------------------------E-----------------------------------------------------------------------------------------------------------
------------------------------S?S-----------------------------------------------------------------S--------SS-------------------------------
--------------------------------------------------------------------------------------------------------------------------------------------
--------------------------------------------------------------------------------------------------------------------------------------------
--------------------------------------------------------------------------------------------------------------------------------------------
-----------------<>-----------------------X----X-------------------------X--------<>---Q-----Q---S-S----S-----------------------------------
-----------------[]--------------------X--XX---XX-----------------------XXX------<>-----------------------------------------------XX--------
--------<>-------[]----------------<>-X---XXX--XX-------X-------XX------XXX------o<>-----------------------------------<>--------XXX------<>
--E-----[]--E----[]-------E---E----[]XXX---XX--XXX------S-E----o<>------XXXX----EX[]----------------E----------E-------[]-E-----XXXXX-----[]
XXXXXXXXXXXXXXXXXXXXXXXXXXXXXXXXXXXXXXXX--XXXXXXXXXXXXXXXXXXXXXXXXXXXXXXXXXXXXXXXXXXXXXXXXXXXXXXXXXXXXXXXXXXXXXX--XX-XXXXXXX---XXXXXXXXXXXXX