--------------------------------------------------------------------------------------------------------------------------------------------
--------------------------------------------------------------------------------------------------------------------------------------------
--------------------------------------------------------------------------------------------------------------------------------------------
--------------------------------------------------------------------------------------------------------------------------------------------
--------------------------------------------------------------------------------------------------------------------------------------------
--------------------------------------------------------------------SSSSS------SSSSS-----------------------------------S-SSSQ-----SQ--------
-------------------------------------------------------------------------------------------------------------------------------------------X
---------------------------------------------------------------------------------------------------------------X----------------------------
--------------------------------------------------------------------------------------------------------------EX----------------------------
-----------S?S----Q--Q----------------------------------X-------------S--------------SS-S---<>-------<>S-X---XX--Q--Q--QS-Q-----------XX--XX
---------------------------------------------<>---------------------------------------------[]-------[]---X--XX-----------------------XX-XXX
--<>------------------------X-------<>-------[]------<>-------------------------------------[]-------[]---XXXXX----------------------XXXXXXX
--[]--------E-----E---------S-E-----[]-------[]------[]-----------------------------EE----E-[]----EEE[]---XXXXXX-------------E-E----XXXXXXXX
XXXXXXXXXXXXXXXXXXXXXXXXXXXXXXXXXXXXXXXXXXXXXXXXXXXXXXXXXXXXXXXXXXXXXXXXXXXXXXXXXXXXXXXXXXXXXXXXXXXXXXXXXXXXXXXXXXXXXXXXXXXXXXXXXXXXXXXXXXXX