[
    205908306,
    14921858,
    14340164,
    14192181,
    13897948,
    13762755,
    13634064,
    13571203,
    13744525,
    13653027,
    13655993,
    13594638,
    13740631,
    13513370,
    13503787,
    13531751,
    13576976,
    13586374,
    13614271,
    13628415,
    13523939,
    13474414,
    13517501,
    13590195,
    14036186,
    13633848,
    13589957,
    13730153,
    13451012,
    13616442,
    13566583,
    13601854,
    13500069,
    13362247,
    13610173,
    13570011,
    13465622,
    13582820,
    13471568,
    13591104,
    13571290,
    13506898,
    13637057,
    13527040,
    13619459,
    13601834,
    13455656,
    13452484,
    13467556,
    13623730,
    13519302,
    13583956,
    13542545,
    13478025,
    13623768,
    13694259,
    13657658,
    13454769,
    13357342,
    13646376,
    13789095,
    13600407,
    13513708,
    13560736,
    14979846,
    13494512,
    13701680,
    13649671,
    13631805,
    13445604,
    13573338,
    13491156,
    13628318,
    13673151,
    13614617,
    13622071,
    13420406,
    13564801,
    13562811,
    13634171,
    13591013,
    13638025,
    13477200,
    13423084,
    13522990,
    13879702,
    13691290,
    13666264,
    13530506,
    13593725,
    13429344,
    13438978,
    13637603,
    16088652,
    18400312,
    13630189,
    13304615,
    13270227,
    13507533,
    13487634,
    13677060,
    13579141,
    13648294,
    13684062,
    13436556,
    13446215,
    13586890,
    13619520,
    14087053,
    13641869,
    13427601,
    13459425,
    13333508,
    13579059,
    13565335,
    13634423,
    13568091,
    13559091,
    13449911,
    13511970,
    13641201,
    13707478,
    13534563,
    13325285,
    13500632,
    13526903,
    13629444,
    13487630,
    13440975,
    13786338,
    13478182,
    13641269,
    13556929,
    13564520,
    13577067,
    13430489,
    13869891,
    13607718,
    13365574,
    13422383,
    13624379,
    13595059,
    13636359,
    13596966,
    13436690,
    13316901,
    13616453,
    13659860,
    13848870,
    13569350,
    13530449,
    13485557,
    13524031,
    13604037,
    13648201,
    13523710,
    13451090,
    13475066,
    13421953,
    13477068,
    13602081,
    13458067,
    13504718,
    13465334,
    13621234,
    13611460,
    13714926,
    13363896,
    13505299,
    13683771,
    13669645,
    13592490,
    13535078,
    13493957,
    13406126,
    13623648,
    13563880,
    13635794,
    13316494,
    13493133,
    13583853,
    13595964,
    13558031,
    13755578,
    13520872,
    13571808,
    13641825,
    13597467,
    13457572,
    13361462,
    13274928,
    13628011,
    13639152,
    13424122,
    13868680,
    13490886,
    13562737,
    13595458,
    13656857,
    13519848
]