--------------------------------------------------------------------------------------------------------------------------------------------
--------------------------------------------------------------------------------------------------------------------------------------------
--------------------------------------------------------------------------------------------------------------------------------------------
--E-----------------------------------------------------------------------------------------------------------------------------------------
-XXXXXX----------------------------------------------E----------------------------------------------------------------------SXSX------------
----------------------------------------------------SSS----------------------------------------SSQ--E?SS--------------------------Q---------
---------------------------------------------X-----------------------------------------SX---------------------------------------------------
-------------------------------------------------------------------------------------------E------------------------------------------------
-------------------------------------------------------S---------------------E------------<>-------------E----XX----E-------E---------------
-----------------------------------------------------XXX--------------------QQ------------[]---E---SS?SQQQ---XXX---<>------------Q----------
---------E-------------E--------------------------------------------------------XXX---<>--[]------S-SX------XXXXQ--[]-----------------------
--------ES------------<>----------------------------------------------------<>--------[]--[]---S-S----------<>XX---[]------SE---------------
--E-----SS------------[]----------------------------------EE--E--EE---------[]------X-[]--[]------------E-E--XXX---[]---------E-EE-EE-E-----
XXXXXXXXXXXXXXXXXXXXXXXXXXXX--------------------XXX-----XXXXXXXXXXXXXXXXXXXXXXXX----XXXXXXXXXXXXXXXXXXXXXXXXXXXXXXXXXXXXXXXXXXXXXXXXXXXXXXXX