--------------------------------------------------------------------------------------------------------------------------------------------
--------------------------------------------------------------------------------------------------------------------------------------------
--------S-----SSSSSSSSSSSSSS----------------------------S-------SSSSSSSSSSSSSSSSSSSS--------------------------------------------------------
---------E---------------------------------------------------S------------------------------------------------------------------------------
--------<>----------------------------------------------------------------------------------------------------------------------------------
--------?S-S--SSSS-Q---------------------------------------S------SSSSSSSS--------------------------------------SSS--------SX-------S-------
---SX-----------------------------------------------------SSX-------------------------------------------------------------------------------
-XXXX----------------------------------------------------XXXX-------------------------------------------------------------------------------
-X-----------S--E---------------------------------------X---------E----------E----------------------S---------------------SXSX--------------
X-----------S-SQS--------SQS----------------------------X-X---<b-SS-SSSSSS--<>---EQQ---------------------------XXQQQ------------------------
-----------S--------E--------------------XXX--------------X---[]---SSSS-SS--[]--------------------------------XX----------------------------
-------------------<>-------------------------------------X--S[]----SSS-----[]-------------------------------XXX--------------------------XX
----SS------SX-----[]---------------------------------EEX-X--S[]--SSSSS-X--<>-------------------------------EXXX----------------------------
XXXXXXXXXXXXXXXXXXXXXXXXXXXXXX---XXXX-----------X-XXXXXXXXXXXXXXXXXXXXXXX--XXXXXXXXXXXXXXXX-----XXXXXXXXXXXXXXXXXXXXXXX---XXX-X-------------