--------------------------------------------------------------------------------------------------------------------------------------------
--------------------------------------------------------------------------------------------------------------------------------------------
--------------------------------------------------------------------------------------------------------------------------------------------
------------SSSSSSSS------------------------------------------------------------------------------------------------------------------------
-------------SSSSSSS--------XXXXXX----------------------------------------------------------------------------------------------------------
-------SSSSSSSSSSSS---SX---X----------------------------------------------------------------------------------------------X----S------------
----------------------------XXX-XXXXX-----------------------------------------------XXXXXE------------------SX------------------------------
---------------------------------------------------------------------------------------------------X----------------------------------------
----------?------------E--SX-----------------------------------------------------------------------E----------------------------------------
?--QQ----S?SSSSSSSS-----------------------------------<>------------------------------------------------------------------------------------
------------------------------------------------------[]--------------XX---------------------XX------------------------------------E--------
--------------------------S---------------------------[]-------------------------------------XXXXXXX------------------------------<>--------
XE-EE---------EE-E----------------------------------E-[]------------------------------------------------EE------------------------[]--------
X--XXX-XXXXXXXXXXXXX-XXXXXXXXX----X------XX---XXXXXXXXXXXXXXXXXXXXXXXXXXXXXXXXXXXXXX-----------------X-XXXXXXXXXXX------------XXXXXXXXXXXXXX