--------------------------------------------------------------------------------------------------------------------------------------------
--------------------------------------------------------------------------------------------------------------------------------------------
SSSXSXSXSXSSSS--------------------------------------------SSSS-S--------------------SSSSSSSSSSSSSSSSSSSSSSSSSSSS----------------------------
-------------------------------------------------------------------------------------------SSSSSSSSSSSSS------------------------------------
---------------XSX-------------------------------------------------------------------------SSSSSSSSSSSSS------------------------------------
-----X-S---------------XX----S---------XX-----E-----------------------------------------------SSSSSSSS-----X---X----------------------------
--------------------------------XXX----------XXXXX--------------------------------------------------------SX--------------------------------
--------------SS--------X-------------------------------------------------------XXX-------------------------X-------------------------------
--------------SSS------XXX--------------------------------------------SS--------XX----------------E-S------XXXSX----------------------------
SSSSSS------XXXS------XXX--------------XXXXX-------XXXXX-?QQQQ------------------X---------------SSSSS-----XXX-------------------------------
----------------------XXX-------------------------------------------------------XX-------------SSS--------XX------------------XX------------
----------------------XXX------------------------------------------------------XXXXX------------SSS----XX-XXXX-X----------------------------
-----------S-----E-E--XX-----------------------------------------------E---------------------E-SSSS--XXXX-XXX-------------------------------
XXXXXXXXXXXXXXXXXXXX------------------------------------XXXXXXXXXXXXXXXXXXXX--------XXXXXXXXXXXXXXXXXXXXXXXXXXXXXXXX--XXXXXXXXXXXXXXXXXXXXXX