--------------------------------------------------------------------------------------------------------------------------------------------
----Q----------------------E----------------------------------------------------------------------------------------------------------------
--------S-----SSSSS-------<>----------------------------------------------------------------------------------------------------------------
---------ESS-SSSSSSS------[]----------------------------------------------------------------------------------------------------------------
SS------<>SSSSSSS---------[]-----------------SX----E----------------------X----E------------------------------------------------------------
--------?SSSSSSSSSSQ--E----X-----------X---SX---XXXXXX------------X----SX---XXX--E----------------------------------------------------------
-SSS----------------------------------------------------------------------------------------------------------------------------------------
-SXSX--------------------------------------------------------------------------------------------------------------------------------------X
SXS--------SXS-SXS--------S-------------------------------------------------------------------------S--------------------------------E------
X-----XXXXSSS--SSS--------SS-QQQ--Q----------------------Q----Q----------------------E------------------------<>----------------Q---<>------
------------------------------------------------------------------------------------<>------------------------[]E-<>---o------------[]------
------------------------------------------------------------------------------------[]------------------------[]--[]--<>------------[]------
X---S--------------------------------------E-EE------------------------E--E---------[]------------------------[]E-[]--[]-EE----------S------
XXXXXXXXXXXXXXXXXXXX----XXXXXXXXXXX----XXXX-------------XXXXXXX---XXXXXXXXXXXX------XXXXXXXXXXXX---XXXXXXXXXXXXXXXXXXXXXXXXXXXXXXXXXXXXXXXXX