--------------------------------------------------------------------------------------------------------------------------------------------
--------------------------------------------------------------------------------------------------------------------------------------------
----------------------------------------------------------------------------------------------------------------SSX-XSSSX-------------------
--------------------------------------------------------------------------------------------------------------------------------------------
--------------------------------------------------------------------------------------------------------------------------------------------
---------------------------S------------SQ-------------------SS-------Q---------------------------------------------------------------------
-----------------------SXSXS----------------------------------------------------------------------------------------------------------------
-----------------------------------------------------------------------------------------------------------------------------------------SX-
----------------SXSX----------------------------------XX------------------S-------------E-------------------------X----------XXX------------
----------X------------S--------E------S----SQQ--------------X-XXX-----------------E---<>--------------QSSSS--------------E----------X--X--X
----------XXXXXX---------------<>--------------------XX-<>------------------------<>Q--[]--------------------------------------------XX-X-XX
----------XX--E--------------------------------------XX---------------------------[]---[]------------------------------------------XXXXXXXXX
----------XX-------------------<>---------EE-E-------XX-------------------E-------[]---[]----E----E-EE-E--E------------------------XXXXXXXXX
XXXXXXXXXXXXXXXXXXXXXXXXXXXXXXXXXX---XXXXXXXXXXXXXXXXXXXXXXXXXXXXX-XXXXXXXXXXXXXXXXXXXXXXXXXXXXXXXXXXXXXXXXXXXXXXXXXX---XXXXXXXXXXXXXXXXXXXX