--------------------------------------------------------------------------------------------------------------------------------------------
--------------------------------------------------------------------------------------X------------------------E----------------------------
----------------------------------------------------------------------------------------XSXSXS----SSSSS-------<>----------------------------
---------------------------------------------------------------------------------------------E----SS----------[]----------------------------
------------------------------------------------------------------------------------SS-----------S------------[]----------SXSXSXSXSX--------
---------------------------S----------------------------------------------------------------------S----E--E----XX------S--S-SX----Q---------
------------------------X-----------------------------------------------------------SS------------------XXXX--------------------------------
------------------------S------------------------------------------------------------SSS--------------------------------------XS------------
------------------S----------------------X--------------X-X---------XXXXX-----------SSS------S-SXSXSXS-------------<>-------E--------E----XX
<>-------XX----------SS---<>------------------------X-----------------------------------------S-S---------XXX---?--[]-----------SQ--S--XXXXX
[]------------------------[]------------------------------------------------------------------------------------?E-[]-------SE---------XXXXX
[]------------------------[]---------------------------X--------------------------------------------------------b--[]------SS---------XXXXXX
[]------------------------[]---------------------------X-----------------------------------------------------------[]---------------XXXXXXXX
XXXXXXXXXXXXXXXXXXXXXXXXXXXX-XX---XX------------X------XXXXXX----XXXXXXXXXXXXXX---XX-------XXXX-XXXXXXX----------XXXXXXXXXXX--XXXXXXXXXXXXXX