--------------------------------------------------------------------------------------------------------------------------------------------
--------------------------------------------------------------------------------------------------------------------------------------------
--------------------------------------------------------------------------------------------------------------------------------------------
----------------------------------------------------------------------------------------------------------------XXXXXXXX--------------------
-----------------SX------------------------------------------------------------------------------------------------XXXX---------------------
-----------------------------------------------------------------------------------S-----------------------------E--------------------------
-------------------------------------------------------X-----------------------SXSX-----------------------------XXXXXXX---------------------
--------------------------------------------------------------------------------S----------------------------SX-----------------------------
--------------------------------------------------------------------------SX----------------------------------------------------------------
----S?SSS-----------------X--XX--------------------------E------XXX----------S-S--<>--S--------XX--------X--XX----------------------S-------
-------------------------XXXXXX-------------------------<>------------XE----------[]---------------------X-XXXXX---------E-------------XXXX-
------------------------XXXXXX--------------------------[]------------------------[]---------------------X-XXXXX--------<>------------------
-E-----------E-EE-E----XXXX-XXX---S-----E---------------[]----------------EE------[]---------------------X--XXXX---EE---[]----------XEX-----
XXXXXXXXXXXXXXXXXXXXXXXXXXXXXX--XXXXXXXXX--XXXX-XXXXXXXXXXXXXXXXXXXXXXXXXXXXXXXXXXXXXX-XXXXX------------XXXXXXX-XXXXXXXXXXXXXX-XXXXXXXXXXX--