--------------------------------------------------------------------------------------------------------------------------------------------
--------------------------------------------------------------------------------------------------------------------------------------------
SSSXSXSXSXSSSSS-----------------------------------------------------------------------------------------------------------------------------
XXXXXXX-------------------------------------------------------------------------------------------------------------------------------------
------------S---------------------------------------------------------------------------------SXSXSXSXS-------------------------------------
-----------------------XX-----------------------------------------------------------------------------Q-------------------------------------
------------?--S----------------------------------------------------------------------------------------------------------------------------
-----------E--XS----------------------------------------------------------------------------------------------------------------------------
----E------------------XXX--------------------------------------------------------------E----?--E-------------------------------------------
---<>------------X--X-XX-------------------------Q-------------------------------------<>---------------S--------------XXXX-----------------
-E-[]-----E--E-----XXXXX------------------------------E-----------------------------XE-[]------------------X-E------------------------------
---[]----<>---------XXXX------------------------------------------------------------?--[]----E-SE----------<>E------------------------------
---[]---?[]-----XXXXX-XX--------------E-E--------------E-----------------------------<>[]---<>----E-EE-EEE<>-------------------E--E---------
XXXXXXXXXXXXXXXXXXXXXXXXXXXXXXXXXXXXXXXXXXXXXXXXXXXXXXXXXXXXXXXXXX----XXXXXXXXXXXXXXXXXXXXXXXXXXXXXXXXXXXXXXXXX-XXXXXXXXXXXXXXXXXXXX---XXX--