--------------------------------------------------------------------------------------------------------------------------------------------
--------------------------------------------------------------------------------------------------------------------------------------------
------------------------------S-----S-------------------------------------------------------------------------------------------------------
----------------------------------------SS----------------------------------------------------------------------XXXXXXX---------------------
----------------------------------------SXSXSXSX------------------------------------XXXXXX--------------------------XXX---SXS---------------
-----------------------------------SSSSSSX---------------------------SQS---------S---E------------------------------------------------------
------------------------------------------------------------------------------------XXXX-XXXX-----------------------------------------------
--------------------------------------------------------------------------------------------------------------------------------------------
--------------------------------E------------------E----------------------------------------------------------------------------------------
--------XXX----------------ES--<>S----------SQQ------------------X-------------------------------------SS------------------------------X----
--------------------------<>---[]-------------------------------------XX---E---------------------------------------------E-------------XX---
--------------------------[]---[]------------------X----------------------<>------------------------------------X--<>---<>------------XXX---
---------------EE-E-----E-[]-E-[]---------EE-E-EE-EB----------------------[]------E-----------------------E------<>[]---[]-----------XXX----
XXXXXXXX------XXXXXXXXXXXXXXXX-XXX-XXXXXXXXXXXXXXXXXXXXXXXXXXXXX---XXXXXXXXXXXXXXXXXXXXX--XXXX--XXX--XXXXXXXXXXXXXXXXXXXXXXXXXXXXXXXXXXXXXXX