--------------------------------------------------------------------------------------------------------------------------------------------
--------------------------------------------------------------------------------------------------------------------------------------------
--XSXSXSXS----SS----------------------------------------------------------------------------------------------------------------------------
--------------SS------------XXXXXXX---------------------------------------------------------------------------------------------------------
-------------S-------------------XX---------------------------------------------------------------------------------------------------------
---------------------------------XX------------------------------------------------S--------------------------------------------------------
---------------------------------X---------------------------------------------SXS----------------------------------------------------------
-------------------------XX-----------------------------------------------------S-----XXXX--------------------------------------------------
-SX------SSSSSSSS--------------------------------------------------------------------------------SX-----------------------------------------
------------------------X----------------XX--------XXX--------S-S-----------SS----<>--XX-----X-----E-----E---------------------------------E
------------------------X------------E------------XXXX-----------------E---E-----o[]------E--X-X--------<>--------------------------------<>
------------------------XXXXX-------<>-----------XXXXX---------------------------Q[]--X-S----XX--X------[]--------------------------------[]
------------------------------E-E---[]-----------XXXXX------------------E-EE-----<>Q-XXSS----XX-XX------[]-----E--------------------------[]
XXXXXX--XXXXXXXXXXXXX-------XXXXXXXXXXXXX--XXXXXXXXXXX--XXXX-XXXXX-XXXXXXXXXXXXXXXXXXXXXXXXXXXXXXXXXXXXXXXXXXXXXXXXX-XXXXX--------XXXXXXXXXX