--------------------------------------------------------------------------------------------------------------------------------------------
--------------------------------------------------------------------------------------------------------------------------------------------
--------------------------------------------------------------------------------------------------------------------------------------------
--------------------------------------------------------------------------------------------------------------------------------------------
-----------------------------------------------------------------------------------------------------------E--------------------------------
------------------------SSSS-----SSS-----------------------------------------------X----------XX-SXSX---XXX--SS------------------SSS--------
-----------------------------------------XXXEX--------SX------------------------------------------------------------------------------------
------------------------------S-SX--------E---------------SS--------------------------------------------------------------------------------
---------------------------S----------------XXX----------XS--------SXSXSXS------------------------------------------------------------------
----------------------------XXXX-XXX-----------------------------------------------S--------------------------------------------------------
-------------XXX------------XXX--------XE-----E-E-------------------------------------------------------------------------------------------
------------------SX--------XX------S-SXXX--------------------------------------------------------------------------------------------------
----------------------------XX-X---SSX-XXX-----------E------------------------------------------------E---------E---------------------------
----------------------------XXXXXXXXXXXXXXXXXXXXXXXXXXXX------XXXXXXXX-X-----------XXXX---XX-----XX--XXXXX------XXXXXXXXXXXX-----XXXXXXXXXXX