--------------------------------------------------------------------------------------------------------------------------------------------
--------------------------------------------------------------------------------------------------------------------------------------------
--------------------------------------------------------------------------------------------------------------------------------------------
--------------------------------------------------------------------------------------------------------------------------------------------
------------SXSX---------------------------------------E------------------------------------------------------------------------------------
------------------------------S?S--------SQ---------SSSS---------------------------S-------SSS----SSSSSS----------SSSSSX---------------XSXSS
---------------------------------------E----------------------------------------------------------------------------------------------------
--------------X------------------------------X----------------------------------------------------------------------------------------------
----E-------E---------------------------X--------------S----------------------------SX--------------S-S---------------------X---SX----------
---<>---------------S---------XX--------------------------------S--------------S----X-----XXXXX---SSSS-----------XXX------------------------
BE-[]------------------X--------------XXXXXX----------------------------------------X-------------------------------------------------------
B--[]----<>-----------XX------------------------------------------------------------X-------------------------------------------------------
---[]---<>-------E--EXX------------------------------S------------------E-EE--------X--------------------------------E----------------------
XXXXXXXXXXXXXXXXXXXXXXXXXX----X------------------XX-----XXXXXXX----XXXXXXXXXXXXXXXXXXXXXXXX----XXXXXXXXXXXXXXXXXXXXXX----X-XXX-X------X-----