--------------------------------------------------------------------------------------------------------------------------------------------
--------------------------------------------------------------------------------------------------------------------------------------------
--------------------------------------------------------------------------------------------------------------------------------------------
--------------------------------------------------------------------------------------------------------------------------------------------
--------------------------------------------------------------------------------------------------------------------------------------------
--------------------------------------------------------------------------SS------------------X--SXSX----X--SSSS----------------S?SS--------
-XXXXEX----------X--------------------------------------------------------------------------------------------------------------------------
-------------------------------------------------------------------------------------------------------------------------------------------X
--------------------------------------------------------------------------------------------------------------------------------------------
------------XXXX--------XXXX------S-S-------------------------<>--------SSS---Q---------------------------------X-----<>--------S?SQQQQ-----
-----------------------------------------------E-------------------------------------------------------E--------------[]---------X----------
------------XXX-------------------------------<>--------------S?--------------------------------------<>--------X-----[]--------------------
---------------------X----------------------E-EE----E-E-X-----<>--------------------------------------[]--------XSX---[]--------------------
----------------------------XXXXXXXXXX-XXXXXXXXXXXXXXXXXXXXXXXXXXXXXXXXXXXXXXXXXXXXXXXXXX------XXXXXXXXXXXXXX--XXXXXXXXXXXXXXXXXXXXXXXXXXXXX