--------------------------------------------------------------------------------------------------------------------------------------------
--------------------------------------------------------------------------------------------------------------------------------------------
--------------------------------------------------------------------------------------------------------------------------------------------
------------------------------------------------------S-------------------------------------------------------------------------------------
------------------------------------E---------------E-EE------------------------------------------------------------------------------------
------------------------------S?SXSX-----SQ--X------SXSSSSS----------------------------------------------------------SS---------------------
---------------------------------------E----------------------------------------------------------------------------------------------------
---------------------------------------------------------------------------------SX---------------------------------------------------------
-------------XX------------------------SX----X------------------------------------------------------------------SE--------------SXSX--------
----------------------------XXXX------------------------SSQQQQ-------SS-------------X--Q?---------------------E-<>---XXXXXX-----------------
----------------------------------------X-----------------------------------------X--------------------------<>-[]--------------------------
-------------------------------X-----------------------------------------------XXXXX-------------------------[]-----------------------------
---------XE---------E----------X---------------------SSS-----------E-E-E-------XX-X-XE-EE--------EE-EE-E-----[]-X-----------------E-------E-
XXXXXXXXXXXXXXXXXXXXXXX-XXXX----------------------------XXXXXXXXXXXXXXXXXXXXXXXXX---XXXXX---XXXXXXXXXXXXXXXXXXXXXXXXXXXXXXXXXXXXXXXXXXXXXXXX