--------------------------------------------------------------------------------------------------------------------------------------------
--------------------------------------------------------------------------------------------------------------------------------------------
---------------------------------------------------------------------------------------XSX--------------------------------------------------
------------------------------------------------------------------------------------XXXXXXX-------------------------------------------------
-----------------------------------------------------------------------------------------XX---SXSXSXSX--------------------------------------
------------------------------------------------------------------------------------------XS---------------------S-S-------------X--------S-
----------------------------------------------------------------------------------------------------------------E-S-------------E-----X-----
-----------------------------------------------------------------------------------------------E--XS---------------------------X------------
--------------------------------E-----------------------X--------------E---------------------?--E---------------XSX----------XXXXXX---------
-------------------------------<>---------------------E-----------E----------XX--------SX------------------XXXX----X-------------------XXX--
------------------------E------[]--------------------<>----------<>----------------------S----------------XXXX--------------X---------------
------------XXX----------------[]--------------------[]----------X------------------o-Q<>---<>-----------XXXXX----SX------X-----------------
-------------------------------[]---------E-------E--[]---------------------EX-------<>[]---[]-S-----E-E-XXXXXX---SX-----------------------S
------XXXX-------X-XX-XXXXXXXXXXXXXXXXXXXXXXXXXXXXXXXXXX--------------------------XXXXXXXXXXXXXXXXXXXXXXXXXXXX-----------------------------X