--------------------------------------------------------------------------------------------------------------------------------------------
--------------------------------------------------------------------------------------------------------------------------------------------
--------------------------------------------------------------------------------------------------------------------------------------------
--------------------------------X-X---------------------------------------------------------------------------------------------------------
--------------------------------------------------------------------------------------------------------------------------------------------
-----S-----------------------------------------------------S-------------X------SXS-------------------SQ-----------------------------------S
---------------------------------------------------------------------------------------SX----------------------------------------------SXSXS
-------------------------------------------------------------------------------------E--------------------------------------------------S---
----------------SXSX---------------------------------------------------------------S?---------------------------------------------SX--------
-------XXX---------------------------------------XXXX----------------------------X--X-X---<>-------EE----E---E---E-------XX------------S---E
-------------------------------------<>---------XXXXX--X------------------------------X---[]---E--S-SXX-??------<>--------XX-XXX---E------<>
-------------------------------------[]--------XXXXXX-------------------------------XXX--S[]-----S------<>------[]------------EX--<>--------
-------------------------------------[]-------XXXXXXXX------------------------------X-X--S[]----SX--------------[]---------X------[]------E-
XXXXXXX--XXXXXXXXXXXXXXXXX--XXXXXXXXXXXX-----XXXX-XXXXXX----------------------------XXXXXXXXXXXXXXXXXXXXXXXXXXXXXXXXXXXXXXXXXXXXXXXXXXXXXXXX