--------------------------------------------------------------------------------------------------------------------------------------------
--------------------------------------------------------------------------------------------------------------------------------------------
SSSSSSSSSSSSSS----------------------------------------------------------------------SSSSSSSSSSSSSSSSS--------------------------------------X
-------------------------------------------------------------------------------------------------SSS--------------------------SSSSSS------<>
----------------------------------------------------------------E--------------------------------SS----S---------------------------S--------
----------------------------------------------------------SSSSS----------X-------------------S--SS---------X---X--------SSSSSSSSSSSS-------X
-------------------------------------------------------------------E--XXXX--------SS--------------------------------------------------------
------------------------XXX----------------------------------------------X-----------------------S----------X----S--------------------------
--------------SX--------XX--------------S-------------------------------SXSX-------------------X--SSS------XXX--SS-------S-SS---S-----------
-SSSSS--------X---------XX---QQQQQQ-------S----------------X-X-X-----------------------QQQ----SS-SSSS-----------X-----X?XSSSSSSSSSS---------
---------------------XXXXX---------------------------------------XXXXXXX--------------------------------------------------------------------
---------------------X-XXX---------------------------SX--X-X------XXX--------------------------------------XXXXX-------------------------XXX
-----------E------------X------------------E-EE------------X-----XXXX------------E----------------EE-E-------------------------E------------
XXXXXXXXX-XX--XXXXXX--------XXXXXXXX--XXXXXXXXXXX-------XXXX--XXXX-----XXXXXXXXXXXXX--XXX---XXXXXXXXXXXXXX------XXXXXXXXXXXXXXXXXXXX--------