--------------------------------------------------------------------------------------------------------------------------------------------
--------------------------------------------------------------------------------------------------------------------------------------------
--------------------------------------------------------------------------------------------------------------------------------------------
--------------------------------------------------------------------------------------------------------------------------------------------
--------------XSXSXS-------------------------------------------------------------------------------------------E-----------------------E--E-
-SS-----------------XXS------S------------------XXSXX--------------------X------------S?S--------SQ--X------SSSS---SSSS-----------------SXSS
----------------------------------------------------------------------------------SS-----------E--X-----------------------------------------
--------E--------------------------------------------------------------X-X---------------------------X--------------------------------------
-------------------------------------------------------------------------X----------------------X--------------S-E---------SX---S-----------
SSS-SSSSS--------------------?QQQQQ------------------------X------X-------------------XX------------------------XX---XXXX-------------------
-----------------------------------------------------------------XXXXXXX--------E-------------XXXXX?----------------------------------------
-----------------------<>---------------------------------XX-----XXXXXXX--------------------------------------------------------------------
-------------E-EE------[]------------------E-E-------------X-----XXXXX-----------EEE-------------------------SS------E-------------------SS-
XXXXXXXXXXXXXXXXXXXXX--XX---XXXXXXXXXXXXXXXXXXXX------------------------------XXXXXXXXX--------------XX-X------XXXXXXXXX-X-XXXXXXXX-----X---