--------------------------------------------------------------------------------------------------------------------------------------------
--------------------------------------------------------------------------------------------------------------------------------------------
S-SXSXSXSXSX--------------------------------------------------------------------------------------------------------------------------------
XXXXXXX-------------------------------------------------------------------------------------------------------------------------------------
----------SXS-----------------------------------------------------------------------------------------------------------------------------E-
-------------------------------------------------------S-------------------------------------------------------SS-S?S-SX-----SX---------SXX-
---------------S----------------------------------------------------------------------------------------------------------------------------
-----------E--XS---------------------------------------X------------------------------------------------------------------------------------
----E-------------------XX--------------------S----------------------------------------------------------------------------XXX--------------
---SX------------------XXX---E-------------------SSS-------------------------------E---------------------SSS-----XXX------------------------
--------------------XXXXXXX-<>--------------------------------------------------E-<>---------------E----------------------------------------
X--<>---<>----------XXXXXX--[]--------------------------------------XXX-----------[]--------------------------------------------------------
-<>[]---[]--------XXXXXXXXX-[]--------------------------------------------------E-[]EE--------------E-EE------------------------------------
XXXXXXXXXXXXXXXXXXXXXXXXXXXXXXXXXXXXXXXXXXXXXXXXXXXXXXXX-----------------XXXXXXXXXXXXXXXXXXXXXXXXXXXXXXXXXXXXXXX----------------------------