--------------------------------------------------------------------------------------------------------------------------------------------
--------------------------------------------------------------------------------------------------------------------------------------------
--------------------------------------------------------------------------------------------------------------------------------------------
--------------------------------------------------------------------------------------------------------------------------------------------
------------------------------------------------------------------------------------------------------------EEE-----------------------------
---------------------------X--------------------------------------------E?SS--------SSS?S------------X------SXXX--------------Q------------S
-----------------------------------------------------------------------------------------------------X---------------------------------SXSXS
-SSS----------------------------------------------------------------------------------------------------------------------------------------
SX---------SXSXSXSX---------X-X-----------XE----------------------------------------X-X---------X--X------------------------------SX--------
---------------------------S---------------------XX-----------<>---E----S?SQQQQ---E--XXX-------------------XXX---E--------X------------S---E
--------------------------------------------------------------[]-----------------<>-----------------------------<>--------XXXXXX---E------<>
-------------------------------------X------------------------[]-----------------[]-------------------------------------------EX--<>------[]
------------------------------------------------EX------X-E---[]-----------------[]----------------------------S------------------[]------[]
XXXXXXXXXXXXXXXXXXXX------XX--------------------------XXXXXXXXXXXXXX---XXXXXXXXX-XXX----------------------------XXXXXXXXXXX-XXXXXXXXXXXXXXXX