--------------------------------------------------------------------------------------------------------------------------------------------
--------------------------------------------------------------------------------------X-Q---------------------------------------------------
--------------------------------------------------------------------------------------------------------------------------------------------
--------------------------------------------------------------------------------------------------------------------------------------------
----------------------------------------------------------------E-------------------S-------------------------------------------------------
------------SQ----------------------------------S---------SSSSSSS---------------------SSSSSSS-----------------------------------------------
---------------------------------X-------------------------------------XXX-----------SS----------------------------XXXX---------------------
-------------------------------------------------------------------------------------SSS----------------------------------------------------
----E---------------------XX----------------------------SE-------------XXXX---------SXS--------S---SXSX-------------------------------------
---<>--------------------XX------------XX-------------XXX----XXX--------------------SX---XXXX------------------------------XXXXX--------XXXX
---[]--------------------XXX----------------------------------------E----------------------------------------------------------------XXXXX--
---[]--------------------XXX--------------------------------------S-------------------------S----------------------------------------XXXX---
EE-[]---------EE-----E--XXXX----------------------EX-------X----S----------------E-EX--XSE--S----------------E-----------------------XXXXX--
XXXXXXXXXXXXXXXXXXXXXXXXXXXXXXXXXXXXXXX------XXXX-XX-XXXXXXXXXXXXXXXX--XXXXXXXXXXXXXXXXXXXXXXX-XXXXXXXXXXXXXXXXX-----------------------XXXXX