--------------------------------------------------------------------------------------------------------------------------------------------
--------------------------------------------------------------------------------------------------------------------------------------------
--------------------------------------------------------------------------------------------------------------------------------------------
--------------------------------------------------------------------------------------------------------------------------------------------
-X------------XSXSX----------------------------------------------------------------------------------------E--EE----------------------------
-S---------X-------XXXSX-----------X------X--------------------------------------S-SS-S?SXSX-----SXSX-------SXXX----------------------------
-------------------------------------------------------------------------------SX-----------------------------------------------------------
--------E-----------------------------------------------------------------------S-----------------------------------------------------------
---------------------------------------XX------------------------------------------------------SX-------------------------------------------
SSS-SSSS----------------------X-------------------------------S-S-----------------<>XXXX------------------------------------------QQQSS---E-
-----------------------------------------------------------------------E---E------[]-----------------------------------------------------<>-
----------------------<>--------------------------------------------------<>-----X[]----------------------------------<>-----------------[]-
-----------------E----[]------------------------------XX-E--------------E-[]----EB[]-----E-------------------SS-ES----S------------------[]-
XXXX---XXX-XXXX-XX-XXX------------XX----------------XXXXXXXXXXXXXXXXXXXXXXXXXXXXXXXXXXXXXXXX-X-------X----------XXXXXXXXXXXXXXXXXXXXXXXXXXXX