--------------------------------------------------------------------------------------------------------------------------------------------
--------------------------------------------------------------------------------------------------------------------------------------------
----------------------------SSSSSSSSSSSSSSSSSSSS--------------------------------------------------------------------------------------------
------------------------------------SSSSSSSSSSSSS-------------------------------------------------------------------------------------------
------------------------------------SSSSSSSSSSSS---------------------------------E----------------------------------------------------------
-----------------?SS---------------SSSSSSSSSSSS----------S---------XX-----XXS----XX-------------------------------------------SSSS----------
------------------------------------------------------X------------------XXXX-------------------------------XXX-----------------------------
--------------------------------------------------------------------------------------------------------------------------------------------
--------------------------------------??----E------E-XXX------------------------------------------------------------------------------------
-----------S----QQQQQQQ---------E----S?SSSSSSSS-----XXXX------------------------XXXX-------------------S---------------XXXX-----------------
---EE--------------------------<>------SSS----------XXXX------------------------------------------------------------------------------------
------<>-----------------------[]------SSS--------XXXXXX------------------------------------------------------------------------------------
E-EE--[]-----------------------[]---------------E-X-XXXX--------------------------------------EXE------------------------------EE-E---------
XX--XXXXXXXXXXXXXXXXXXXXXXXX---XXX-XXXXXXXXXXXXXXXXXXXXX----------------------------XXXXXXXXXXXXXXXXXXXXXXXXXXXXXXXXXXXXXXXXXXXXXXXXXXXXX---