--------------------------------------------------------------------------------------------------------------------------------------------
--------------------------------------------------------------------------------------------------------------------------------------------
--------------------------------------------------------------------------------------------------------------------------------------------
------------S------SS-----------------------------------------------------------------------------------------------------------------------
-------------------S------------------------------------------------------------------------------------------------------SXSXSXSXS---------
--------SSSSSSSSSSSS--------------------SQ----Q--------------XX-------------------------------------------------X------S----SX--------------
--------------------------------------------------------------------------XXXX--------------------------------------------------------------
-E------------------------------------------------------------------------------X------------------------------X--------------XS------------
--------------------------XX--------------------------XX------------------------------------------------------------E-------E------------XXX
X-----<>--S?S--SSSS------XXX-----------E----QQQQ-----XX--SS--------XXXXX-----XXXXXX-------------------QQQSS---E----<>-------------------XXXX
------[]------S-SS-------XXX---EE--------------------XXX---------------------XXXXX---------------------------<>--E-[]-------------------XXXX
------[]-----S-----------XXX---<>--b-----------------XXX---------------------X------------<>-----------------[]----[]------SS--------XXXXXXX
X-----[]-----------------XXXE-<>---------------------XXX---------------------X-X----ESEE--[]--E--------------[]----[]---SS----EE----XXXXXXXX
X-X-XX--XXXX-XXXXXXXXXXXXXXXXX-XXXXXX-XX---XXXXXXXXXXXXX----------------------------XXXXXXXXXXXXXXXXXXXXXXXXXXXXXXXXXXXXXXXX--XXXXXXXXXXXXX-