--------------------------------------------------------------------------------------------------------------------------------------------
---------------------------------------------------------------------------------------------------------------------------SSS--------------
-SSSSSSSSSSSSSSSSSSS------S---------------------------------------------------------------------------------------------SSSSSSSS-S----------
-------------------------------------------------------------------------------------------------------------------------SSSSSSSSSSSS-------
-------------S----------------------------------------------------------------------------------------------------------S-SSSSSSSSSS--------
-------------SS--------------------SSSSSSSSSSSSS-------S------------------------------S?SXSX-----SXS---------SS-X------SSSSSSSS--?SS--------
----------------------------------------------------------S---------------------------------------------------------------------------------
-----------------------------E---------------------------SSSSX------------------------------------------------------------------------------
-------------SSSS------E--------------------------------SXS--------SXSXSXSX----------------------------------------<>-----?------------E-XXX
----------SSS---------X----SX--------SXS---SSSS---S--SQ-------------------------------X-------------------------?--[]-----??S--SSSS------XX-
-------------------------------------------------------------------------------------------------------------------[]-------SS----------XXX-
----------------------------<>----SS-------------------------------------------------------------------------------[]------SSS--------XXXXXX
----------------------------XS----S--------------------------------------------------------------------------SE-B--[]----------E-E--E-X-XXX-
XXXXXX-XXXXXXXXXXXXX----XXXXXX--XXX-------XXXXXXXXXXXXXX------XXXX--XXXXXXX------XXX------XX----------------XXXX---XXX-XX-XX--XXXXXXXXXXXXX-