--------------------------------------------------------------------------------------------------------------------------------------------
--------------------------------------------------------------------------------------------------------------------------------------------
--------------------------------------------------------------------------------------------------------------------------------------------
--------------------------------------------------------------------------------------------------------------------------------------------
-----------------------------------------------------------------------------------------------------------E-EE----------------SX-----------
------------------------------------------------------------------------------------SSS-------XSXSXSX---XXXXSXXSSSS-------XXX--SX--XXXSXXXX-
--------------------------------------------------------------------------------------------------------------------------------------------
---------------------------------------------------------------------------------SX---------------------------------------------------------
----E-------E-------------------------S-SXSX----------------------------------------------------X-------------------------------------------
---<>--------------QS------------------------------XX------------------------X--X--XXX--------------------------------E---------------------
E--[]-----E------------XX<>-------------------------X--X---------------------X--X-XX--------------------------------------------------------
---[]----<>--------------[]--------------------------XXX---------------------X-XXXXX--------------------------------------------------------
---[]----[]------E---EE-----------------------------XXXX---------------------X--XXXX--------------------------------------------------------
XXXXXXXXXXXXXXXXXXXXXXXX----XXXXXXXXXXXXXXXXXXXXXXXXXXXXXXXXXXXXXXXXX-XXXXXXXXXXXXXXX---------------------------X---------------------------