-------------E------------------------------------------------------------------------------------------------------------------------------
----------SSSSS-----------------------------------------------------------------------------------------------------------------------------
SSSSSSSSSSSSSSSSSSSS------------------------------------------------------------------------------------------------------------------------
--------SSSSSSSSSSSSS-----------------------------------------------------------------------------------------------------------------------
--------SSSSSSSSSSSS------------------------------------------------------------------------------------------------------------------------
X------SSSSSSSSSSSS----X---X--------------------------------------SSSQ-------------------------------------------S---------SX-----E---------
---------------------------------------------------------------------------------------------------------------------------------XXX--------
--------------------------------------------------------------------------------------------------------------------------------------------
----E-----??-----------EXXSX------------------------------------------------------E---------------------------E-----------------------------
?--<>----S??SSSSSSS------X------QQSSS----------------------------SXS--------------X-----E------S----Q-QQQSS--<>-------------------------X---
---[]-------SS-------------------------------------------------------------------XX----<>--------------------[]-----------------------------
---[]------SSS--------XXXXXX-------------------------SS--------------------------<>----[]--------------------[]-----------------------------
---[]---------EE-E-EE-XXX------------------EE-E----<>---E--E----------EE---------XX-EE-[]-----------E--------[]----------------------------X
---XXX-XXXXXXXXXXXXX-XXXXXXXXXXXXXXXX-XXXXXXXXXXXXXXXXXXX--XXX--XXXXXXXXXXXXXXXXXXXXXX-XXXXXX-XXXXXXXXXXXXXXXXXX----------------------------