--------------------------------------------------------------------------------------------------------------------------------------------
--------------------------------------------------------------------------------------------------------------------------------------------
----------------------------------------------------------------------------------------XSSSSSSSSSSSSSSSSSSSSSSS----------------------------
--------------------------------------------------------------------------------------------------------------------------------------------
------------------------------------------------------------------------------------SS-----------S------------------------------------------
---------------------------S------------------------------------------------------S---------------S--------------------SSSSSSSSSSSSS--------
-----------------------SXSXS------------------------------------------------------------------------------SX-----S-SX-----------------------
------------------------S------------------------------------------------------------XXXXX-----------------------XX-------------------------
----------------S-SX------------------E----------E---------------------------------S-X-----------SXSX-----------?X------------------------SX
-E--------X------------S------X------<>---SE----<>-----X------------------------XXX-----------S-S---------------X-----<>---SSSSSSSS------SSS
<>------------XX----------E----------[]---------[]--XXXX------------------------------------------------E-------------[]--------SS----------
[]-----------------------------------[]---------[]----XX-----------------------------------------------<>------XX-----SS--------------------
[]----------------E-------E---X---E--[]-E-------[]----XX-----------------------------------------------[]---X--XX----SXS-------------------E
XXXXXXXXXXXX--XXXXXXXXXXXXXXXXXXXXXXXXXXXXXXXXXXXXXXXXXX----------------------------XXXXXXXXXXXXXXXXXXXXXX--XXXXX---XXXXXXXXXXXXXXXXXXXXXXXX