--------------------------------------------------------------------------------------------------------------------------------------------
--------------------------------------------------------------------------------------------------------------------------------------------
SSXSXSXSXSSSSSSSSSSSSS----SS----------------------------------------------------------------------------------------------------------------
------------------------------------------------------------------------------------XXXXXXX-------------------------X-XX--------------------
SS-----------S------------------------------------------XXXXXX--------XSX-------------------------------------------------------------------
-S------------S----E--E----------------SX-------------S----------------------------------XX-------------------------------------------------
-S------------------XXXX---------------------------------------XX------------------------X--------------------------------------------------
-SSSX-----------------------------------------------------------E---------------------------------------------------------------------------
SXS---------XSXSX---------------------------------------------------------------------------------------------------------------------------
------------S--------XXXX---------------XXX---------XXXX------SSS-----------------<>------------XXXX-------XXXX-----------E---------XX------
---------------------------------------------------------------------------------X[]---------E-----------XXXX------------<>--------XXX------
-------------------<>------X------------------------------------XS----------------[]--------<>-----------XXXX------------[]---------XX------
-------------------XX---XX-X-----------------------------------------E---------<>XX---------[]--------XXXXXXX------------[]-----X---XXX-----
XXXXXXXXXXXXXXXXXXXXXX--XXXX----------------------------XXXXXXXXXXXXXXXXXXXXXXXXXXXXXXXXXXXXXXXX----XXXXXXXX-----XXX-XXXXXXX-----XXXXXXXXXXX