--------------------------------------------------------------------------------------------------------------------------------------------
--------------------------------------------------------------------------------------------------------------------------------------------
SSX-XSXSX-----SSS----------E----------------------------------------------------------------------------------------------------------------
-----------------------XXXXX----------------------------------------------------------------------------------------------------------------
S-------------------------<>----------------------------------------------------------------------------------------------------------------
-S-S---------------E--E---------------SSSSSSSSSS----------------------------------------------------------------------------------Q---------
SSS-----------------XXXX--------------------------------------------------------------------------------------------------------------------
-SSS---------------------------------------------------------------------------------------------------------------------------------------X
XSS---------XSXSX-------------------------------------S---------------------------------E-------E--------E----------------------------------
---------------------XXXXX------------SSS--SSSS------SQ--------------------------------<>---------------S-----X-----E-------------QQQQQ---E-
------------------------------------------------------------------------------------E--[]-----E------------XXXXXE--<>--------------------<>-
----------------------------------<>---------------------------------------------------[]----<>---------<>--XXX----[]--------------------[]-
---------------------------XE-----S----------------------------------------------------[]----[]---------XEE--XX-E--[]-----E-----EE-------[]-
-X-------X---XXX-----------XX--XXXXXXXXXXXXXXXXX--XXXXXXXXXX---XXXXXXXX---X------XXXXXXXXXXXXXXXXXXXXXXXXXX-----XXXXXXXXXXXXXXXXXXXXXXXXXX--