--------------------------------------------------------------------------------------------------------------------------------------------
--------------------------------Q-----------------------------------------------------------------------------------------------------------
------------------------------------S---SSSSSSSSSSSSSSSS----------------------------SSSSSXSSS---------------------------SS--SSSSSSSSSSSSSSSS
-------------------------------------ES-----------------------------------------------------------------------------------------------------
----------------------------SS------<>---S---------------------------------------E----------------------------------------------------------
------------------------------------?S----SSS--Q--------SSS?------XSXSXSX-XXSXXXXXXX------------------------------------?SSS--SSSS----------
------------------------------SS-----------------------------------------XX----------------------------XXX---------SX-----------------------
-----------------------------XXXXX--------------------------------------------------------------------------XX---XXXX-----------------------
---------------E-------------X----------XSXSX-----------------------X-----------------------------S--------XX-------------E-----------------
----------------------------X-----------S-------------SSXXX--------------------------SSSS------XXXX-------XXXX--X-X---<>----SSSSS----------S
------------------------------------------------E--------------------------------------------------------XXXXX-------------SS-S-----E-------
------------XX------------------S--------------<>-----------------------------------------------------------X--------SSS-----SS----<>-------
-------------------------------SS-------E------[]---------------------------------------------------------------X-XS-SXS--S-SS-----[]------X
--------------------XXXXXXXXXXXXXXXXXXXXXXXXXXXXXXXXXXXX----------------------------XXXXXXXXXXXX---XXXXX--------XXXXXXXXXXXXXXXXX-XXXXXXXXXX