--------------------------------------------------------------------------------------------------------------------------------------------
--------------------------------------------------------------------------------------------------------------------------------------------
-------------------------------X----------------------------------------------------------------------------------SXS-----------------------
--------------------------------------------------------------------------------------------------------------------------------------------
---------------------------------XX---SXSXSXSXSX------------------------------------------------------------------------------SXSX----------
-----------------------XX---XQQ-----S-------------------------------------------------------SS----SSSSSS--------SQS----SSSS--X------------X-
------------------------------------------------------------------------------------------------------------------------------------------X-
----------------------------------------------------------------------------------------------------------------------------------------XSX-
----------------------------------------------------------------------XE-----------------------------------------------------------------XX-
--------------------------XXS-SSXS--------------------------------------------------X--------SX----SSSS---------SSSSXS-------S-----------X--
---------E------------X-----------------------------XX----------------------------------------------------------------------------------XXX-
----------------------XX----?---------------------XXXX----X------XX-----------------X------------------------------------------------X-XXXXX
---------E------XX----XX----X-E-----SS-E-E---E----XXXX----------------------EE------XX----S--------------------------------E-EEE-----X-XXXX-
XXXXXX--XXXXXXXXXXXXXXXXXXXXXXXXXXXXXXXXXXXXXXXXXXXXXXXX------XXXXX------XXXXXXXXXXXXX--XXX------XXXXXXXXXXXXXXXXXXXXXXXX-XXXXXXXXXXXXXXX---