--------------------------------------------------------------------------------------------------------------------------------------------
--------------------------------------------------------------------------------------------------------------------------------------------
--------------------------------------------------------------------------------------------------------------------------------------------
--------------------------------------------------------------------------------------------------------------------------------------------
--------------XSXSXS----------------E---------------------------------XXX-------------------------------------------------------------------
SQS----------------------E----SSSSSS---------X-------------------------------XSX------------------------------------------------------------
---------------------------------------E--XX-X----------------------------------------XXXXX----------X--------------------------------------
--------E------------------------------------X----------------------------------------------------------------------------------------------
--------------------------------------------SXSX--------------------------------------------------------------------------------------------
SSS-SSSSS-----------------X----X---X------------------------------------------------------------XXXX--------XXXX----------------------------
--------------------------X----------XXXXXXX-----------------------------------E------------------------------------------------------------
-X---------------------XXXX-----------X---------------------------------------<>-----------------XX-----------------------------------------
-----------E-E-EE-E----XXXX--------------------------EEE----------------EE-E--[]------------------------------------------------------------
XXXXXXXXXXXXXXXXXXXXXXXXXXXXXXXX-XXX---------XX-X-XXXXXXXXXXX-----XXXXXXXXXXXXXXXXXX---------------------------XXXXXXXXXXX---------XXXXXXXXX