--------------------------------------------------------------------------------------------------------------------------------------------
--X-X----------------------E----------------------------------------------------------------------------------------------------------------
SSX-XSXSSSSSSSSSSSSSSS----<>----------------------------------------------------------------------------------------------------------------
-----SSSSSSSSSSSSSSS------[]----------------------------------------------------------------------------------------------------------------
SS-----SSSSSSSSSSSSS------[]----------------------------------------------------------------------------------------------------------------
-------S?SSSSSSSSSSS--EX---X------------------SS--------------------SSS---------XXXX----------SSSQ--E?S-------------------------------------
-SSS----------------XXXX--------------------------------E-----------------------------------------------------------------------------------
-SXXXX-------------------------------------------------------------------------------------------------------------------------X------------
SXS--------SXSXSX---------------------------------------SSS------SSSSSSSSS--------------------?---------------XXX-------------XX------------
X-------XXSSS---S-----X---SS<>-------------------SS-------------X-------------------X---E----E?S----SQS------XX----X------------------------
-----------S----------------[]---------------------------------------------------------<>--------------------XX-----------------------------
-------------------<>------X[]-----------------------------------------------------X---[]--------------------XX---SX-----XX-X---------------
------------E------[]-------[]----S-------------------------------------------------E--[]---------EE---------XX---S-------------------------
--XXXXXXXXXXXXXXXXXXXX--XXXXXXXXXXXXXXXXXXXXXXXXXXXXXXXXXXXXXX--XXXXXXXXXXXX--------X--XXXXXXXXXXXXXXXXXXXXXXXXX---------------------------X