--------------------------------------------------------------------------------------------------------------------------------------------
--------------------------------------------------------------------------------------------------------------------------------------------
--------------------------------------------------------------------------------------------------------------------------------------------
--------------------------------------------------------XXXXXX------------------------------------------------------------------------------
--------------------------------------------------------------------------------------------------------------------------SXSXSXSXSX--------
---------------------------------------------X------S-S-----------------------------SSS?---X---SXSX-------XXXXXXX-Q----S--S-SX--------------
X-------------------------------------------------------------------------------------------------------------------------------------------
-------------------------------------------X-X--------------------------------------------------------------------------------XS------------
---------------------------------------------X---------S--------------------------------------SXXX------------------E-------E---------------
--------------------S--------------------------------------S-------------------X-XXXXXXX--------------------XX--S--<>--------------------XX-
---------E----------------------------XXXXX?-----------------------------------XXXXX-------------------------------[]S-------------------XX-
---------E----------------------------X--------------------<>----<>----------XXXXXXX----------------------------S--[]------SE----------EXXX-
---EE----XE----------EE------------------------------------[]---<>----------XXXXXXXX-----------------------------<>[]---SS----E--E-E-E<>XXX-
XXXX-XXXXXXXXX-XXXXXXXXXXXXXXXX--------------XXXXXXXXX-XXXXXXXXXXXXXXXXXXXXXXXXX-----XX---------------X---------XXXXXXXXXXXXXXXXXXXXXXXXXXX-