--------------------------------------------------------------------------------------------------------------------------------------------
--------------------------------------------------------------------------------------------------------------------------------------------
--------------------------------------------------------------------------------------------------------------------------------------------
----------------------------------------------------------------------------------------------------------------XXXXXXXX--------------------
---------------XXXX------------------------------------------------------------------------------------------E------------------------------
-QS----------------------------------------------------------------------X-----------S--------XXX---X--XSXSXSXX-----------------------------
---------------------------------------------------SXSXS--------------XXXX--------SS-------XX--------XX-------------------------------------
-------------------------------------------------------------------------X------------------------------------------------------------------
------------------------------------------------------------------------SX-X-----------------------------------S----------------------------
----S?SS------------------------------X----------------------------------------------------------------------XXX-----------------------X----
--------------------------------------XXXXXX---------------------XXXXX---------------------------------------------------E----------XXXXXX-X
------------------------XSX-----------XXXXXX----------------------XXXX--------------------------------------------------<>----------XXXXXX--
-------------E-EE------<>-------------XXX------------------------XXXXX----------------------------------------------E---[]--------XXXXXXXX--
XXXXXXXXXXXXXXXXXXXXXXXXXXXXXXXXXXX-XX-----XXXXXXXXXXXXXXXXXXXXXXXXXXX-XXXXXXXXXXXXX----------------------------XXXXXXXXXXXXXXXXXXXXXXXXXX--