--------------------------------------------------------------------------------------------------------------------------------------------
--------------------------------------------------------------------------------------------------------------------------------------------
--------------------------------------------------------------------------------------------------------------------------------------------
------------------------------------------------------------------------E-------------------------------------------------------------------
--------------------------------------------------------XXXXXXX-----XXXSXXXX-----------------------SX---------------------------------------
---------------------------------------------------------?------------------XXS-----SS--------XXX------XSX---------------SSSSSSSSSSS--------
----------------------------------------------XXX------------------------------------------XX--------XXX------------------------------------
---------------------------X------------------------------------E---------------------------------------------------------------------------
--------------------------------------------------------------------------------------------------------------------------?---------------EX
----E-------------QQQSSS---------------XXXX--------XXXXXS-S-SSSSS---------------------------------------------XXX--------S??----SSSQ-----<>-
E--<>--------------------<>----------------------------------------------------E------------------------------------E--------------------[]-
---[]---------------------------------------------------X-------X-------------<>--------------------------------------<>-----------------[]-
EE-[]-----E-----EE-E--E--<>------------------------------------------E--EE-E--[]--------------------------------E--E---------------------[]-
XXXXXXXXXXXXXXXXXXXXXXXXXXXX----------------------------XXXXXXXXXXXXXXXXXXXXXXXXXX-X----------------------------XX--XXXXX-XX--XXXXXXXXXXXXXX