--------------------------------------------------------------------------------------------------------------------------------------------
--------------------------------------------------------------------------------------------------------------------------------------------
-----------------------------------------------------------------------------------------SSSSSSSSSSSSSSSSSSSSSSS----------------------------
--------------------------------------------------------------------------------------------------------------------------------------------
----------SXSXSXSXSX------------------------------------------------------------------------------------------------------------------------
XQ-------------------------------------SSSSSS---------------------------E?------------------------------------------------------------------
----------------------------------------------------------------------------------------------------------SX------------------------S-SX----
-----------------------------------------------------X----------------------------------X--------------------------------------X------------
-------------------------------------SSSSS-S---------X-----------------------E----XX-------------XX---------------------------XE------------
S--SXS--------------------------------S---SSS-----------------<>-------SES--S----XXX---------<>---------XXX---------------E----------XX-----
--------------------------------------------------------------[]------S---------XXXX------E--[]--------XXX---------------<>-----------------
-----------------------<>---------------------------XXXX------[]-----S----------XXXX---------[]--------XXX--------S------[]-XXXX------------
-EE-----SS-E-EE-EE-E---[]------------------------------X--X---[]------------E-E--XXX---------[]-----X--XXX--X----------------------XXX------
XXXXXXXXXXXXXXXXXXXXXXXXXXXXXXXXXXXXXXXXXXXXXXXXXX--XXXX--XXXXXXXXXXXXXXXX-XXXXXXXXXXXXXXXXXXXXXXXXXXXXXXXX-XXXX--------------------------XX