--------------------------------------------------------------------------------------------------------------------------------------------
--------------------------------------------------------------------------------------------------------------------------------------------
--------------------------------------------------------SSSSSSSSSSSSSSSSSSSSSSSSSSSS--------------------------------------------------------
----------------E---------------------------------------------------------------------------------------------------------------------------
-SX-XXX----XXXXXXXXX------------------------------------------------------------------------------------------------------------------------
---------------------------------------------------X------------------SSSS------------------------------------------------------------------
------------------------------------------------------------------------------SX------------------------------------------------------------
----------------------------------------------------X---------------------------------------------------------------------------------------
----------------------------------------SXS-----------------------E---E---------------------------------------------------------------------
S--SXS-SS-----------------E--QQQ---------------------------------<>--<>-----XXX---SS----QQSSS-----------------------QQQ---------------------
-------------------------<>--------------------------------------[]--[]----XXXX-------------------------------------------------------------
-----------------------<>[]--------------------------------------[]--[]----XXXX------------------------------SS-----------------------------
-EE--------E-EE-EE-E---[][]----------------E-E----------------E--[]-<>--XX-XX-X------------------E-EE-E----<>----E-------------EE-EE---<>---
XXXXXXXXXXXXXXXXXXXXXXXXXXXXXXXXX----XXXXXXXXXXX--------XXXXXXXXXXXXXXXXXXXXXXXXXXXXXXXXXXXXXXXXXXXXXXXXXXXXXXXXXXXXXX---XXXXXXXXXXXXXXXXXXX