--------------------------------------------------------------------------------------------------------------------------------------------
------------------------------------------------------------Q-------------------------------------------------------------------------------
SSSSSSSSSSSSS-----SSSSSSSSSS-------------------------------------------------------E--------------------------------------------------------
----------------------------------------------------------------------------------<>--------------------------------------------------------
--------------------------------------------------------S-------E---------------E-[]--------------------------------------------------------
----------------------------------------------------------SSSSSS--------------E-XXXX-------------------------------------------------------S
--------------------------------------------------------SSS--------------------------XXXXE---------------------------------------------SXXXX
----------------------------------------------------------SS----------------------------------------------------------------------------S--X
---------------------E-------------------SXS------------SSS--------SX--SXSX------------------------------------S----------------------------
----E------------X--X-----------------E-----------------XX---XXXX--------------------------------------------XXX----------X--------SSS------
---<>-----E--E-----XXX------------------------------E--X--------------------------------------------------------<>--------XX---E----------E-
---[]----<>---------XXX--------------------------------X---------------------------------------XXXXX-------------S--------XXX---------------
---[]-E--[]-----XX--XXX--------------EE---------E---XXXX-----E--------------------------------------------------<>--------XXXX--------------
-XXXXXXXXXXXXXXXXX--XXXXXXXXXXXXXXXXXXXXXXXXXXXXXXXXXXXXXXXXXXXXXXXXXXXXXXXXXX----------------------------------XXXXXXXXXXXXXXXXXXXXXXXXXXXX