[
    13827716,
    12775291,
    12761737,
    12625444,
    12747627,
    12770715,
    13393387,
    13681511,
    13202589,
    12434995,
    12819039,
    12500837,
    13512647,
    12641191,
    13552989,
    13131527,
    13171334,
    12905109,
    12817475,
    13598717,
    13185671,
    13078728,
    12255995,
    12619479,
    12513233,
    12746683,
    12527841,
    12459765,
    13332860,
    13318343,
    12684206,
    12796021,
    13540147,
    13019937,
    13106124,
    12064486,
    13753685,
    12953397,
    13015674,
    13507477,
    12982542,
    13524268,
    13500160,
    13429970,
    12576428,
    12818186,
    12903139,
    12621145,
    12128519,
    12700558,
    12697236,
    12750118,
    13112347,
    13096337,
    12498565,
    13112563,
    12866632,
    13054035,
    12929493,
    12709680,
    13704532,
    12788968,
    12606878,
    13218081,
    13475334,
    12881849,
    12840828,
    12961709,
    13394010,
    12893036,
    13036663,
    13276930,
    13085983,
    13535686,
    12879557,
    12621534,
    12600576,
    13228626,
    13118857,
    17926713,
    12962782,
    14187891,
    12943657,
    12962579,
    13666480,
    13897535,
    13203091,
    12490198,
    12838876,
    12952491,
    12804573,
    12558747,
    13706126,
    13004748,
    12874916,
    13225553,
    13733874,
    13019307,
    12866603,
    12842543,
    12009932,
    12677311,
    13839721,
    13186809,
    13828580,
    13483203,
    13354763,
    13325636,
    14194310,
    12819009,
    13040776,
    12957855,
    12987400,
    12495994,
    12744656,
    13383855,
    13122712,
    12859135,
    12891409,
    12879933,
    13284687,
    13854113,
    13420110,
    13264100,
    13102714,
    13156512,
    12390757,
    13111188,
    13264332,
    12820554,
    12975133,
    12955000,
    13253418,
    12871087,
    12668393,
    12953322,
    12830312,
    13003163,
    12770337,
    12798782,
    12795793,
    13143117,
    13322821,
    12733730,
    12963702,
    13312592,
    13470878,
    13184482,
    13471197,
    13331619,
    13194745,
    13452667,
    13127584,
    14122025,
    13859368,
    13164579,
    13008145,
    13250137,
    12697656,
    12624618,
    12565864,
    13093322,
    13032667,
    12989865,
    12940464,
    13037926,
    12676775,
    13258764,
    13380411,
    13119053,
    13247132,
    12755210,
    13558019,
    13380617,
    13248071,
    12850100,
    13284362,
    13507372,
    12674277,
    12704215,
    13200287,
    13638279,
    12780907,
    12637389,
    12829095,
    12697977,
    13676871,
    13953791,
    13254412,
    13591409,
    13418394,
    12516169,
    12563722,
    12577114,
    13202225,
    13334097,
    13559708,
    13212860,
    13397136,
    13319428
]