--------------------------------------------------------------------------------------------------------------------------------------------
--------------------------------------------------------------------------------------------------------------------------------------------
--------------------------------------------------------------------------------------------------------------------------------------------
--------------------------------------------------------------------------------------------------------------------------------------------
--------------------------------------------------------------------------------------------------------------------E-----------------------
---------SSSQS-----QS-----SS------------------------------------------------------------------------------------SSSSSSSS----?SQ-------------
--------------------------------------------------------------------------------------------------------------------------------------------
------------------------X-------------------------------------------------------------------------------------------------------------------
--------------------------------------------------------------------------------------------------------------------------------------------
-Q--Q--?S-Q--------S---XX-----SS--------------------------------<>-------<>-----------------------X----X----------------------S-------S?----
---------------XX------XX----------------------------------o----[]-------[]------X----------------XX---XX-----------------------------------
--------------XXX---XXXXX--<>-------<>--------------------<>----[]-------[]----XXXX---------------XXX--XXX----------------------------------
-E---E-E-----XXX-X--XXXXX--[]-------[]--------E------EE-E-[]----[]-------[]----XXXX--------<>-EE-XXXX--XXXX---------------------------------
XXXXXXXXXXXXXXXXXXXXXXXXXXXXXXXXXXXXXXXXXXXXXXXXXXXXXXXXXXXXXXXXXXXXXXXXXXXXXXXXXXXXXXXXXXXXXXXXXXXXXX-XXXXXXXXXXXXXXX---XXXXXX--XXXXXXXXXXX