--------------------------------------------------------------------------------------------------------------------------------------------
--------------------------------------------------------------------------------------------------------------------------------------------
--------------------------------------------------------------------------------------------------------------------------------------------
--------------------------------------------------------------------------------------------------------------------------------------------
----------------------------------------------------------------------------------------E---------------------------------------------------
----------------------------------------------------------------------SSS------------SSSSSS-------------------------------------------------
--------------------------------------------------------------------------------------------------------------------------------------------
--------------------------------------------------------------------------------------------------------------------------------------------
--------------------------------------------------------------------------------------------------------------------------------------------
---------------------SS----S--------<>-------XX--------S------------Q--------SS-------------------S-------------------------QS--------------
-----------------<>-----------------[]------XXX---------------------------------------------------------------------------------------------
--<>----<>-------[]---------X-------[]------XXX----------------------------------------------------------------?----------------------------
--[]----[]--E----[]---------E-EE--E-[]-----XXXX----------------------------------------------------------------b--------------------------E-
XXXXXXXXXXXXXXXXXXXXXXXXXXXXXXXXXXXXXXXXXXXXXXXXXXXXXXXXXXXXXXXXXXXXXXXXXXXXXXXXXXXXXXXXX-------XXX-------XXXXXXXXXX---XXXXXXXXXXXXXXXXXXXXX