--------------------------------------------------------------------------------------------------------------------------------------------
--------------------------------------------------------------------------------------------------------------------------------------------
--------------------------------------------------------------------------------------------------------------------------------------------
--------------------------------------------------------------------------------------------------------------------------------------------
----------------------------------------------------------------------------------------E---------------------------------------------------
---SS-------------------------------------------------------------------------------SSSSSSSS----?SS-SSQ-------SSSS----?S-S?QQ------Q--------
--------------------------------------------------------------------------------------------------------------------------------------------
--------------------------------------------------------------------------------------------------------------------------------------------
--------------------------------------------------------------------------------------------------------------------------------------------
-----------------------------------------------------------------------------SS-----X-------------S--------------Q--Q--QS-Q------------X----
----------------------------X--------------------------------------------------------------------------------------------------X----XXXXX---
------------------------------<>--------------------------<>------------------------------------------------------------------XXX---XXXX----
-------------------X----------[]--------------------------[]-----------------------------------------------------E---------E-EXX----XXXXX---
XXXX---XX------------------X-XXX-------------X-----X--XXXXXXXXXXXXXX-----XXXXXXXXXXXXXXXXX----X-XX----X-------XXXXXXXXXXXXXXXXXXXXXXXXXXXXXX