--------------------------------------------------------------------------------------------------------------------------------------------
--------------------------------------------------------------------------------------------------------------------------------------------
--------------------------------------------------------------------------------------------------------------------------------------------
--------------------------------------------------------------------------------------------------------------------------------------------
--------------------------------------------------------------------------------------------------------------------------------------------
--------------------------------------SSSSSSSSSQS---SSSSSSQ---SS----------------------------------SQ-------SS---------------SSSQ-------SQSQS
--------------------------------------------------------------------------------------------------------------------------------------------
-------------------------------------E------------------------------------------------------------------------------------------------E-----
--------------------------------------------------------------------------------------------------------------------------------------------
--------------X-------XX--XX----S----S---------SS---------------------SS---------------Q-------SQS-------Q------Q--Q--Q--Q-----S----S?SQS---
-----------X--XX---XXXX---XX----------------------------------------------------------------------------------------------------------------
-------<>-XX--XXX--XXXX---XX----------------------------------------------------------------------------------------------------------------
-------[]XXX--XXX--XXXX---XX----------------E------E-E-E--------------------------------------------E--------------E------------------------
--XXXXXXXXXXXXXXX--XXXXXXXXXXXXXXXXXXXXXXXXXXXXXXXXXXXXXXXXXXXXXXXXXXXXXXXXXXXXXXXXXXXXXXXXXXXXXXXXXXXXXXXXXXXXXXXXXXXXXXXXXXXXXXXXXXXXXXXXX