--------------------------------------------------------------------------------------------------------------------------------------------
--------------------------------------------------------------------------------------------------------------------------------------------
--------------------------------------------------------------------------------------------------------------------------------------------
--------------------------------------------------------------------------------------------------------------------------------------------
--------------------------------------------------------------------------------------------------------------------------------------------
--------------------------------------------------------SSQ--SSS-SSSQS--SSSQS-----XX-----------------------------SSSSSSS--------------------
----------------------------------------------------------------------------------XX--------------------------------------------------------
--------------------------------------------------------------------------------XXXX--------------------------------------------------------
-------------------------------------------------------------------------------XXXXX--------------------------------------------------------
------------QS-------SS----Q-------------SQS----S?SQS----------QS-Q-----------XX-XXX---------------------SS---------------Q-----X--X--------
-----------------------------------------------------------------------X-----XXX-XXX-----------------<>-----------------------XX---XX-------
----------------------------------------------------------------------XXX---XXXX-XXXX------<>--------[]-----------------------XXX--XXX------
------------E-----E------------S----------------------------------EE-EXX---XXXXXXXXX--E----[]--------[]----------------E--EE-XXXX--XXXX-----
XXXX---XXXXXXXXXXXX--XXXXXXXXXXXXXXXXXXXXXXXXXXXXXXXXXXXXXXXXXXXXXXXXXXXXXXXXXXXXXXXXXXX--XXXXXX--XXXXXXXXXXXXXXXXXXXXXXXXXXXXXXXXXXXXXXXXXX