--------------------------------------------------------------------------------------------------------------------------------------------
--------------------------------------------------------------------------------------------------------------------------------------------
--------------------------------------------------------------------------------------------------------------------------------------------
--------------------------------------------------------------------------------------------------------------------------------------------
----E---------------------------------------------------------------------------------------------------------------------------------------
-SSSSQS------------------------------------------------------------------------SSSSS--------------------------------------------------------
--------------------------------------------------------------------------------------------------------------------------------------------
------------------------------------------------------------------------------E-------------------------------------------------------------
--------------------------------------------------------------------------------------------------------------------------------------------
--------------X----X--------Q--Q-------S?S----S--Q--Q-SSX--Q----------SS----S?S--------SS----S-S-S----S--Q--QSSQ-SSSS---<>-------<>---------
--------------X----XX---------------------------------------------------------------------------------------------------[]-------[]---------
-------<>-XX-------XX-----<>------------------------------------------------------------------------------------X-------[]-------[]---------
-------[]-XX----X-XXXX----[]---E------------E-E--E------------------------------------------------E-E-E--E----E-EE----E-[]----E--[]-------E-
--XXX-XXXXXX--XXX--XXXXXXXXXXXXXXXXXXXXXXXXXXXXXXXXXXXXXXXXXXXX--XXXXXXXXXXXXXXXXXXXXXXXXXXXXXXXXXXXXXXXXXXXXXXXXXXXXXXXXXXXXXXXXXXXXXXXXXXX