--------------------------------------------------------------------------------------------------------------------------------------------
--------------------------------------------------------------------------------------------------------------------------------------------
--------------------------------------------------------------------------------------------------------------------------------------------
--------------------------------------------------------------------------------------------------------------------------------------------
--------------------------------------------------------------------------------------------------------------------------------------------
-------------SSQ-------S?---------------SSSQ-------SSSQS---------SSSSSQ----Q------SS----------SSSS--SSSQS-----SS----------------------------
--------------------------------------------------------------------------------------------------------------------------------------------
--------------------------------------------------E-----------------------------E-----------------------------------------------------------
--------------------------------------------------------------------------------------------------------------------------------------------
---Q--Q--Q-----S----S-------Q--Q--Q--Q-----S----S?S-S-------S--S?S---------SQ---XSS--------S-----------S---X-----SS--------------<>---------
--------------------------------------------------------------------------------X-------------------------XX---X-----------------[]------<>-
--------------------------------------------------------------------------------X------------------------XXX---<>----------------[]-----X[]-
----------------E--------E-E---E------------E------------E-----------EEEEE--E-EX-----------------E-E----EXXXX--[]-----------E-E--[]----XXXb-
XXXXXXXXXXXXXXXXXXXXXXXXXXXXXXXXXXXXXXXXXXXXXXXXXXXXXXXXXXXXXXXXXXXXXXXXXXXXXXXXXXXXXXXXXXXXXXXXXXXXXXXXXXXXXXXXXXXXXXXXXXXXXXXXXXXXXXXXXXXX