--------------------------------------------------------------------------------------------------------------------------------------------
--------------------------------------------------------------------------------------------------------------------------------------------
--------------------------------------------------------------------------------------------------------------------------------------------
--------------------------------------------------------------------------------------------------------------------------------------------
--------------------------------------------------------------------------------------------------------------------------------------------
S--------SSSQS-----Q------SS-------------------------------------S--------------------------------------------SS----------------------------
--------------------------------------------------------------------------------------------------------------------------------------------
--------------------------------------------------------------------------------------------------------------------------------------------
--------------------------------------------------------------------------------------------------------------------------------------------
-Q--Q--SS-Q--------S---XX-----------------X----X----------------<>-------X-------X------------------X----SSQ---------------X--X-X--X--------
-----------------------XX-----------------X----XX---------------[]------XX------XX-----------------XX----------------------X--XX---XX-------
---------------------XXXX----------<>-X--------XX---------------[]-----XXX---XXXXX----<>----------XXX--X---------------<>-XX--XXX--XXX-----E
-E-----------EEE-E--E-XXX-----E----[]XXX-------XX-------EE----E-[]----XXXX----XXXX----[]---<>----XXXX--X-----------E---[]XXX--XXX--XXXX----S
XXXXXXXXXXXXXXXXXXXXXXXXXXXX-XXXXXXXXXXX---XX-XXXXXX-XXXXXXXXXXXXXXXXXXXXXXXXXXXXXXXXXXXXXXXXXXXXXXXXXXXXXXXXXXX---XXXXXXXXX--XXXX-XXXXXXXXX