--------------------------------------------------------------------------------------------------------------------------------------------
--------------------------------------------------------------------------------------------------------------------------------------------
--------------------------------------------------------------------------------------------------------------------------------------------
--------------------------------------------------------------------------------------------------------------------------------------------
----------------------------------------------------------------------------------------E---------------------------------------------------
--------------S-------------SS----SS-------------------X------------------------------SSSSSS------------------------------------------------
--------------------------------------------------------------------------------------------------------------------------------------------
--------------------------------------------------------------------------------X-----------------------------------------------------------
-------------------------------------------------------------------------------XX-----------------------------------------------------------
---Q----------------SSS------------Q--Q-----X-----XX-----------<>-------XX----XXX-----------------------------<>-----------------<>------SS-
------------------------------------------XX----XXXX---X-------[]------XXX--XXXXXX---------------------XX-----[]---B----<>-------[]---------
------------------------------------------XXX---XXXX---<>------[]-----XXXX--XXXXXX---------------------XXX----[]--<>----[]-------XE---------
-----------------------------------EE-E--XXXX--XXXXX--X[]----E-[]----XXXXX--XXXXX--X----------EE-------XXXX---[]--[]----[]-------<>---------
XXXXXXXXXXXXXXXXXXXXXXXXXXXXXXXXXXXXXXXXXXXXXX-XXXXXXXXXXXXXXXXXXXXXXXXXXXXXXXXXXXXX---X--XX------------XXXX-XXXXXXXXXXXXXXXXXXXXXXXXXXXXXXX