--------------------------------------------------------------------------------------------------------------------------------------------
--------------------------------------------------------------------------------------------------------------------------------------------
--------------------------------------------------------------------------------------------------------------------------------------------
--------------------------------------------------------------------------------------------------------------------------------------------
--------------------------------------------------------------------------------------------------------------------------------------------
-----------------------------SSSSSSS-------------------X--------------------------------------------------------SSQ--------SSSQ-------------
-------------------------------------------------------X------------------------------------------------------------------------------------
------------------------------------------------------XX------------------------------------------------------------------------------------
--------------------------------------------------------------------------------------------------------------------------------------------
-SSS-------------<>-------------------Q---X-X-----XX--XX-SS-----<>----------SSSQS--------------------XX-----------------------S-----S---S-S-
-----------------[]------<>---------------XX----XXXX--XX--------[]---------------------Q----<>-------XX-------------------------------------
-----------------[]------[]--------<>-----XXX---XXXX--XX--------[]------------------X-<>----[]------XXX-------------------------------------
------------E-E--[]------[]--------EX-E--XXXX--XXXXXX-XX-E----E-[]---EEE-E----------E-[]----[]------XXX-----------------------------E--E----
XXXXXXXXXXXXXXXXXXXXXXXXXXXXXXXXXXXXXXXXXXXXX--XXXXXXXXXXXXXXXXXXXXXXXXXXXXXXXXXXXXXXXXXXXXXXXXXXXXXXXXXXXXXXXXXXXXXXXXXXXXXXXXXXXXXXXXXXXXX