--------------------------------------------------------------------------------------------------------------------------------------------
--------------------------------------------------------------------------------------------------------------------------------------------
--------------------------------------------------------------------------------------------------------------------------------------------
--------------------------------------------------------------------------------------------------------------------------------------------
--------------------------------------------------------------------------------------------------------------------------------------------
----------------------------------------SQS-----------------------------------------SQ-----S---------S----------SSQ---?-----SSSQSQS----SSSQS
--------------------------------------------------------------------------------------------------------------------------------------------
--------------------------------------------------------------------------------------------------------------------------------------------
--------------------------------------------------------------------------------------------------------------------------------------------
-------------S-----------------SS----S--------SSS----SS----------?-------XX----------------Q------------------<>X--Q-----Q----SS----S-------
-----------------<>----------------------------------------S----<>------XXX-----------------------------------[]----------------------------
X----------------[]-------------------------------------X-<>----[]------XXX-----------------------------------[]----------------------------
Q-E---------E----[]-------E---------------E-E----E-E-E--E-[]----[]-----XXXX--------------------E----------X-E-[]-------------------------E-E
XXXX-XXXXXXXXXXXXXXXXXXXXXXXXXXXXXXXXXXXXXXXXXXXXXXXXXXXXXXXXXXXXXXXXXXXXXXXXXXXXXXXXXXXXXXXXXXXXXXXX--XXXXXXXXXXXXXXXXXXXXXXXXXXXXXXXXXXXXX