--------------------------------------------------------------------------------------------------------------------------------------------
--------------------------------------------------------------------------------------------------------------------------------------------
--------------------------------------------------------------------------------------------------------------------------------------------
--------------------------------------------------------------------------------------------------------------------------------------------
--------------------------------------------------------------------------------------------------------------------------------------------
----------------------------SSQS-SS-------SQS------SSSS-SSSSSSSS--------SSQ-----------------------------------------------------------------
--------------------------------------------------------------------------------------------------------------------------------------------
--------------------------------------------------------------------------------------------------------------------------------------------
--------------------------------------------------------------------------------------------------------------------------------------------
-------------------X--------X------------S?S----S---------------------S-----------<>-----------------XX----------------QS-Q-----------------
-------------------X--------------------------------------------------------------[]--------<>------XXXX----------------------------X-------
-------<>----------XXX----<-------------------------------------------------------[]X-------[]-----XXXXX----------------------XXX---XXX-----
--E----[]-------X--XXXX---[]-------------------------E-E--------------------E-----[]<>------[]-----XXXXX---------------E--EE-XXX----XXXX----
XXXXXXXXXXXXX-XXXX-XXXXXXXXXXXXXXX---XXXXXXXXXX-XXXXXXXXXXXXXX------XXX-----SXXXXXXXXXXXXXXXXXXXXXXXXXXXXXXXXXXXXXXXXXXXXXXXXXXXXXXXXXXXXXXX