--------------------------------------------------------------------------------------------------------------------------------------------
--------------------------------------------------------------------------------------------------------------------------------------------
--------------------------------------------------------------------------------------------------------------------------------------------
--------------------------------------------------------------------------------------------------------------------------------------------
--------------------------------------------------------------------------------------------------------------------------------------------
-------------------------------------SSSSQQ----Q--------SSSSSSSS-----S--SSSS----------------------------------------------------------------
--------------------------------------------------------------------------------------------------------------------------------------------
--------------------------------------------------------------------------------------------------------------------------------------------
--------------------------------------------------------------------------------------------------------------------------------------------
--------<>-------XX--X-------?-SS--SSS---------SS---SSS----------------------------------------------------------------<>-Q---X-X--X--------
--------[]------XXX--XX--X---------------------------------------------------------------------------------------------[]-----XXX--XXX------
X-------[]-----XXXX--XXXXXX-------------------------------------------------------<>-----------------------------------[]-----XXX--XXX----XX
E-EE--E-[]-----XXXX---XXXXX--E-----------EEEEE--EE-E------------------------------[]-------------------------------E-E-[]-E--XXXX--XXXX---XX
XXXXXXXXXXXXXXXXXXXXXXXXXXXXXXXXXXXXXXXXXXXXXXXXXXXXXXXXXXXXXXXXXXXXXXXXXXXXXXXXXXXX-------X-------------------XXXXXXXXXXXXXXXXXXXXXXXXXXXXX