--------------------------------------------------------------------------------------------------------------------------------------------
--------------------------------------------------------------------------------------------------------------------------------------------
--------------------------------------------------------------------------------------------------------------------------------------------
--------------------------------------------------------------------------------------------------------------------------------------------
--------------------------------------------------------------------------------------------------------------------------------------------
SQQ-----------S--------SS-------------------------------------------SSS---------QS-S-------------------------------------SSSSQ--------------
--------------------------------------------------------------------------------------------------------------------------------------------
-------------------------------------------------------------------E------------------------------------------------------------------------
----------------------------------------------------------------------------------------------------------S---------------------------------
X--Q--Q--Q-----S----S--------------------------------------SS----S?S--------S?SQS--------------------<>----------?S-S---<>-------X------X---
--------------------------------------------------------------------------------------------<>-------[]-----------------[]------XX--XXXXX---
---------------------------------------------<>-------------------------------------X-------[]-------[]------<>---------[]-----XXX---XXXX---
----------------E--------E-E-----------------[]-----------------------E-E-----------o-EE----[]-------[]------[]-EE----E-[]----XXXX---XXXX---
XXXXXXXXXXXXXXXXXXXXXXXXXXXXXXXX--XXXX----XXXXXXXXXXXXXXXXXXXXXXXXXXXXXXXXXXXXXXXXXXXXXXXXXXXXXXXXXXXXXXXXXXXXXXXXXXXXXXXXXXXXXXXXXXXXXXXXXX