--------------------------------------------------------------------------------------------------------------------------------------------
--------------------------------------------------------------------------------------------------------------------------------------------
--------------------------------------------------------------------------------------------------------------------------------------------
--------------------------------------------------------------------------------------------------------------------------------------------
--------------------------------------------------------------------------------------------------------------------E-----------------------
--S---------------------------------------------------------------------------------------------------------------SSSSSS--------SS----------
-----------------------------------------------------------------------------------X-----------------X--------------------------------------
-----------------------------------------------------------------------------------------------------XXX------------------------------------
-----------------------------------------------------------------------------------------------------XXX------------------------------------
X--------------------SSQS---------------QS-------SS---------------------XX----XX--XX-------<>-------XXXX------------------------------------
---------------------------------------------------------------<>------XXX---XXX--XX-------[]------XXXXXX-----------------------------------
------------------------------<>-------------<>----------------[]-----XXXX--XXXX-XXXX------[]-----XXXXXXX-----------------------------------
------------------------------[]--------E-----------------EE---[]----XXXXX-XXXXXXXXX<>EE---[]----XXXXXXXX-----------------------------------
XXXXX---XXXXXXXXXXXXXXXXXXXXXXXXXXXXXXXXXXXXXXXXXXXXXXXXXXXXXXXXXXXXXXXXXXXXXXXXXXXXXXXXXXXXXXXXXXXXXXXXXXXXXXXX---XX------------------X--XX