--------------------------------------------------------------------------------------------------------------------------------------------
--------------------------------------------------------------------------------------------------------------------------------------------
--------------------------------------------------------------------------------------------------------------------------------------------
--------------------------------------------------------------------------------------------------------------------------------------------
--------------------------------------------------------------------------------------------------------------------------------------------
------------SSS-SSSQ-----------------SSSQ------Q-------X------------SSS-SSSQ------S---------------------------------------------------------
------------------------------------------------------XX------------------------------------------------------------------------------------
----------------------------------------------------XXXX------------------------------------------------------------------------------------
----------------------------------------------------XXXX------------------------------------------------------------------------------------
-------QS-----SS-------------SS-S--SS-------------XXXXXXX--Q--Q--Q----SS------------------------QS---------------SS-----<>-------XX-X-------
-------------------------------------------------XXX-XXX----------------------------------------------------------------[]------XX--XX------
-------------------------------------------------XXXXXXX---------------------------<>-<>------------------------X-------[]-----XXX-----XX---
---------------------------E-E-----------EXE-E--XXXXXXXX--------------------E--E---[]-[]------------------------E-----E-[]----XXXX----XXX---
XXXXXXXXXXXXXXXXXXXXXXXXXXXXXXXXXXXXXXXXXXXXXXXXXXXXXXXXXXXXXXXXXXXXXXXXXXXXXXXXXXXXXXXXXXXXX--XXXXXXXX-XXXXXXXXXXXXXXXXXXXXXXXXXXXXXXXXXXXX