--------------------------------------------------------------------------------------------------------------------------------------------
--------------------------------------------------------------------------------------------------------------------------------------------
--------------------------------------------------------------------------------------------------------------------------------------------
--------------------------------------------------------------------------------------------------------------------------------------------
--------------------------------------------------------------------------------------------------------------------------------------------
---------------------------------------------------------------------QS---------------------------------------------------------------------
---------------------------------------------X----------------------------------------------------------------------------------------------
---------------------------------------------XXX--------------------------------------------------------------------------------------------
---------------------------------------------XX---------------------------------------------------------------------------------------------
-----------------------------------<>-------X-XX----------<>-------S?S----S--Q--Q--Q-------<>-------XX-X--------------------QS----Q--SS-Q--S
-----------------------------------[]------XXX-XX---------[]-------------------------------[]------XXX-X------------------------------------
-----------------<>----------------[]-----XXXXXXX---------[]-------------------------------[]-----XXXXXX------------------------------------
-----------------[]X-----------E---[]-E--XXXXXXXXX--------[]----------E-E-E--E---------E-E-[]----XXXXXXXX-------------------E-----E---------
-XXX--XXX-------XXXXXXXXXXXXXXXXXXXXXXXXXXXXXXXXXXXXXXXXXXXXXXXXXXXXXXXXXXXXXXXXXXXXXXXXXXXXXXXXXXXXXXXXXXXXXXXXXXXXX--XXXXXXXXXXXXXXXXXXXXX