--------------------------------------------------------------------------------------------------------------------------------------------
--------------------------------------------------------------------------------------------------------------------------------------------
--------------------------------------------------------------------------------------------------------------------------------------------
--------------------------------------------------------------------------------------------------------------------------------------------
----------------------------------------------------------E---------------------------------------------------------------------------------
--------------------------------------------------------SSQS-SSS--SSSS----SQ--------SSSSSSSS-----S--S-----------------------SSSQ-------SQS--
---------------------------------------------X----------------------------------------------------------------------------------------------
---------------------------------------------XXX--------------------------------------------------------------------------------------------
---------------------------------------------XX---------------------------------------------------------------------------------------------
---S-------S?S---<>----------SS----<>-------XXXXX--------------Q------S----S-----XXXX-------------SS------------Q--Q--Q--S----------S---SS--
-----------------[]------<>--------[]------XXX-XX-------------------------------XXXX---------------------------X----------------------------
-----------------<b------[]--------[]-----XXXXXXX------------------------------XXXXX---------------------------X----------------------------
------------E----[]------[]----E-E-[]----XXXXXXXXX---------------------E----E-XXXXXX--------------------E-XX--XX----------------E----E---E-E
XXXXXXXXXXXXXXXXXXXXXXXXXXXXXXXXXXXXXXXXXXXXXXXXXXXXXXXXXXXXXXXXXXXXXXXXXXXXXXXXXXXXXXXXXX---XXXXXXXXXXXXXXXXXXXXXXXXXXXXXXXXXXXXXXXXXXXXXXX