--------------------------------------------------------------------------------------------------------------------------------------------
--------------------------------------------------------------------------------------------------------------------------------------------
--------------------------------------------------------------------------------------------------------------------------------------------
--------------------------------------------------------------------------------------------------------------------------------------------
--------------------------------------------------------------------------------------------------------------------------------------------
-------------Q------------------------SSSSS-SSSQ------XX----------------------------------------------------------SSSS----------------------
------------------------------------------------------XX------------------------------------------------------------------------------------
------------------------------------------------------XX------------------------------------------------------------------------------------
----------------------------------------------------XXXX----------------------S-------------------------------------------------------------
------------------S------SS--------S-S---------S---XXXXX--------<>-------XX---------------------QS-------SS-----X---------------------------
--------------------------------------------------XXXXXX--------[]------XXX-----------------------------------------------------------------
-------------------------------------------------XXXXXXXX-------[]------XXX-----------<>----------------------------------------------------
------------E-E-E-E--E-------------------E-E-E--EXXXXXXXE-EE--E-[]-----XXXX-------E---[]----------------------------------------------------
XXXXXXXXXXXXXXXXXXXXXXXXXXXXXXXXXXXXXXXXXXXXXXXXXXXXXXXXXXXXXXXXXXXXXXXXXXXXXXXXXXXX-XXXXXXXX---XXXXXXXXXXXXXXXX---X-------------------X---X