--------------------------------------------------------------------------------------------------------------------------------------------
--------------------------------------------------------------------------------------------------------------------------------------------
--------------------------------------------------------------------------------------------------------------------------------------------
--------------------------------------------------------------------------------------------------------------------------------------------
--------------------------------------------------------------------------------------------------------------------------------------------
SS----?S--SSSS----SS----SSSS---------------------------------------------------------------------------------------------?------------------
--------------------------------------------------------------------------------------------------------------------------------------------
--------------------------------------------------------------------------------------------------------------------------------------------
------------------------------------------------------------------------------------------------------E---S---------------------------------
-------QS------------------------------------------------SS--------------<>--------------------------XX----------SS----E<>-------X--XX------
----------------------------------------------------------------<>-------[]----------------<>B------XXX-----------------[]------XX--XXX--X--
--------------------------------------------------------X-------[]-------[]---------X------[]-------XXXX-----<>---------[]----XXXX---XXXXX--
-------------E-E-----------E----------------------------E-E---E-[]-------[]-------E-?-EE---[]------XXXXX-----[]-<>---EE-[]----XXXX--XXXXXX--
XXXXXXXXXXXXXXXXXXXXXXXXXXXXXXXXXXXXXXXXXXXXXXXXXXXXXXXXXXXXXXXXXXXXXXXXXXXXXXXXXXXXXXXXXXXXXXXXXXXXXXXXXXXXXXXXXXXXXXXXXXXXXXXXXXXXXXXXXXX-