--------------------------------------------------------------------------------------------------------------------------------------------
--------------------------------------------------------------------------------------------------------------------------------------------
--------------------------------------------------------------------------------------------------------------------------------------------
--------------------------------------------------------------------------------------------------------------------------------------------
--------------------------------------------------------------------------------------------------------------------------------------------
--SSSSSS--------SSQS--------------------SQS-------------SSS-SSS---------SQ-----SS------------?------------------------SS--------------------
--------------------------------------------------------------------------------------------------------------------------------------------
---------------------------------------E----------------------------------------------------------------------------------------------------
--------------------------------------------------------------------------------------------------------------------------------------------
--------------------------<>-SSSS----S?S-------SS----SS-X------------SQS--------------------<>-------X--X--------------Q--Q---S-------------
--------------------------[]----------------------------------------------------------------[]------XX--X-----------------------------------
--------------------------[]--------------------------------------------------------X-------[]-----XXX--------------------------------------
------------------------E-[]-E------------E-E----E-E-------------------------------EE-EE--E-[]----XXXX----XX---------------E-E-E----E-XX----
XXXXX-----XXXXXXXX--XXXXXXXXXXXXXXXXXXXXXXXXXXXXXXXXXXXXXXXXXX---XXXXXXXXXX--XXXXXXXXXXXXXXXXXXXXXXXXXXXXXXXXXXXXXXXXXXXXXXXXXXXXXXXXXXXXXXX