--------------------------------------------------------------------------------------------------------------------------------------------
--------------------------------------------------------------------------------------------------------------------------------------------
--------------------------------------------------------------------------------------------------------------------------------------------
--------------------------------------------------------------------------------------------------------------------------------------------
--------------------------------------------------------------------------------------------------------------------------------------------
SSQ---SS-----------S----------------------------------------?---------SSS------SSSQ------------------------------------------QS-------------
--------------------------------------------------------------------------------------------------------------------------------------------
------------------------------------------------------------------------------E-------------------------------------------------------------
----------------------------------------------E---S-----------------------------------------------------------------------------------------
--------------SS-----------------------------XX---------X-------------QS------S------------------------------------S-----S-S------S--SSQQ--Q
-----------------------------------<>B------XXX---------------------------------------------------------------------------------------------
----------------------------X------[]-------XXXX---------------------------------------Q-------------<>-------------------------------------
---------------E-----------E?-EE---[]------XXXXX------?----------------------------------------------[]X------------------------E-E---------
XXXXXXXXXXXXXXXXXXXXXXXXXXXXXXXXXXXXXXXXXXXXXXXXXXXXXXXXXXXXX----XXXXXXXXXX--XXXXXXX--XX-XXXX------XXXXXXXXXXXXXXXXXXXXXXXXXXXXXXXXXXXXXXXXX