--------------------------------------------------------------------------------------------------------------------------------------------
--------------------------------------------------------------------------------------------------------------------------------------------
--------------------------------------------------------------------------------------------------------------------------------------------
--------------------------------------------------------------------------------------------------------------------------------------------
----E---------------------------------------------------------------------------------------------------------------------------------------
--SSSSS------------------------------S?SQ---------------------------------------------------------------------------------------------------
--------------------------------------------------------------------------------------------------------------------------------------------
--------------------------------------------------------------------------------------------------------------------------------------------
------------------------------------------------------------------------------------------------------E---S---------------------------------
-----------------------------------?S-Q-------------------------------------------<>-----------------XX-------------------------XX----S-----
--------------------------------------------X-------------------------------------[]-------<>-------XXX------------X----<>-----XXX----------
------------------------------------------XXX----X-------------<>----------XXX----[]X------[]-------XXX-----------<>----[]-----XXX----------
--------------------XX-------E---E-E-----XXXXE--XXXX-----------[]-E----X---XXXX---[]<>-E---[]------XXXXX----------[]----[]----XXXX-X--------
----------------------------XXXXXXXXXXXXXXXXXXXXXXXXXXXXXXXXXXXXXXXXX-XXX--XXXXXXXXXXXXXXXXXXXXXXXXXXXXXXXXXXXXXXXXXXXXXXXXXXXXXXXXXXXXXXXXX