--------------------------------------------------------------------------------------------------------------------------------------------
--------------------------------------------------------------------------------------------------------------------------------------------
--------------------------------------------------------------------------------------------------------------------------------------------
--------------------------------------------------------------------------------------------------------------------------------------------
--E---------------------------------------------------------E-------------------------------------------------------------------------------
SSSSSSSS--------SSSSS-------------------SQ----------------SSSSS--------------------------------SSSQ----QS----SSS-Q--------------------------
--------------------------------------------------------------------------------------------------------------------------------------------
--------------------------------------------------------------------------------------------------------------------------------------------
--------------------------------------------------------------------------------------------------------------------------------------------
-------Q--Q---S-----------<>----S---SS---------S------------------------------------X--Q--Q--Q----SS---SS----------------Q----SS----S-------
--------------------------XX------------------------X---------------------------------------------------------------------------------------
---------------------X----XX-----------------------XX---------------------------------------------------------------------------------------
-----------E---E----XXX---XX-E-----------EEEEE--E-XXX----------------------------------------------E---------E-E-------------------------E--
XXXXXXXXXXXXXXXXX--XXXXXXXXXXXXXXXXXXXXXXXXXXXXXXXXXXXXX----------------------------XXXXXXXXXXXXXXXXXXXXXXXXXXXXXXXXXXXXXXXXXXXXXXXXXXXXXXXX