--------------------------------------------------------------------------------------------------------------------------------------------
--------------------------------------------------------------------------------------------------------------------------------------------
--------------------------------------------------------------------------------------------------------------------------------------------
--------------------------------------------------------------------------------------------------------------------------------------------
--------------------------------------------------------------------------------------------------------------------------------------------
-------------Q------------------------------------------------------------------------------------------------------SSSS--------SSQSS-------
---------------------------------------------------------------------------------------------------------------X----------------------------
---------------------------------------------------------------------------------------------------------------X----------------------------
--------------------------------------------------------------------------------------------------------------------------------------------
-SSSS---SS--------SS-----XX------------S---------------------------------XX----------SS-Q--QS-Q----------XX--XXXX-------------SS----------<>
-------------------------XX---------------------------------------------XXX------------------------------XX--XXX--------------------------[]
-----------------------XXXX------------------<>-----------------<>------XXX------------------------XXX---XXXXXXX--------------------------[]
-E------------E-E-E----XXXXX--E---------E-----------------EE----[]-----XXXX-------E--E---E-E-----E-X-X---XXXXXXX--------------------------[]
XXXXXXXXXXXXXXXXXXXXXXXXXXXXXXXXXXXXXXXXXXXXXXXXXXXXXXXXXXXXXXXXXXXXXXXXXXXXXXXXXXXXXXXXXXXXXXXXXXXXXXXXXXXXXXXXXXXXXX----XXXXXXXX----XXXXXX