--------------------------------------------------------------------------------------------------------------------------------------------
--------------------------------------------------------------------------------------------------------------------------------------------
--------------------------------------------------------------------------------------------------------------------------------------------
--------------------------------------------------------------------------------------------------------------------------------------------
--------------------------------------------------------------------------------------------------------------------------------------------
--------------------------------------------------------------------SQ----------------------------SSS------SSSSS---SS-----------------------
--------------------------------------------------------------------------------------------------------------------------------------------
--------------------------------------------------------------------------------------------------------------------------------------------
--------------------------------------------------------------------------------------------------------------------------------------------
--<>-----Q-S------S--?SQQ--Q-----------------<>--SS----S---S-----S-S------S-----SSS-Q--Q--------------------------------------------------<>
--[]-----E-----------------------------------[]-------------------------------------------------------------------------------------------X?
--[]----<X--------------------<>----<>-------[]------------------------------------------------------------------------------------------XXX
E-[]----[]------E-E--E------E-[]----[]--E----[]------------E----------E-E-E--E---------E---------------------------------------E--------EXXX
XXXXXXXXXXXXXXXXXXXXXXXXXXXXXXXXXXXXXXXXXXXXXXXXXXXXXXXXXXXXXXXXXXXXXXXXXXXXXXXXXXXXXXXXXXXXXXXXXXXXXXXXXXXXXXXXXXXXXXXXXXXXXXXXXXXXXXXXXXXX