--------------------------------------------------------------------------------------------------------------------------------------------
--------------------------------------------------------------------------------------------------------------------------------------------
--------------------------------------------------------------------------------------------------------------------------------------------
--------------------------------------------------------------------------------------------------------------------------------------------
--------------------------------------------------------------------------------------------------------------------------------------------
----------------------------S-----?S--SSSS----SQS----SSS---------S?---------------XX--------------------------------------------------------
---------------------------------------------------------------------------------XXX--------------------------------------------------------
-------------------------------------E------------------------------------------XXX--------------------X------------------------------------
-------------------------------------------------------------------------------XXXX-------------------XX------------------------------------
-----------------------------------S?S----S----S---------?S-Q--?S-Q-----XX--X--XXX----------------X---XX---------------------S--------------
----------------------------------------------------------------X------XXX--XXXXXX---------<>--X--XXXXXXX-----------------------------------
-------------------------------------------------------<>-------------XXXX--XXXXXX--X------[]-X---XXXXXXXX----<>----------------------------
-------------------------------------------E----E--E---E<>---E-E-----XXXXX--XXXXXX-X--EE---[]XX---XXXXXXXXX---[]----------------------------
XXXXX-XXXXXXXXXXXXXXXXXXXXXXXXXXXXXXXXXXXXXXXXXXXXXXXXXXXXXXXXXXXXXXXXXXXXXXXXXXXXXXXXXXXXXXXXXX--XXXXXXXXXXXXXXXXXXXXXXXXXXXXXXXXXXXXXXXXXX