--------------------------------------------------------------------------------------------------------------------------------------------
--------------------------------------------------------------------------------------------------------------------------------------------
--------------------------------------------------------------------------------------------------------------------------------------------
--------------------------------------------------------------------------------------------------------------------------------------------
--------------------------------E-----------------------------------------------------------------------------------------------------------
----------------------------SSSSSSSS--------SSQ------------SSSS---------SS--------------------------------------------?S--SSQS-----SS---SSSS
--------------------------------------------------------------------------------------------------------------------------------------------
--------------------------------------------------------------------------------------------------------------------------------------------
--------------------------------------------------------------------------------------------------------------------------------------------
------------------------------------------------------<>-------------------------------------------------Q-------------QS-----S-----S-------
------------------------------------------------------[]------------------------------------------------------------------------------------
---B---<>--------XX-----------------------------------[]--------------------------<>--<>-------------<>-------------------------------------
--E----[]-------XXXX--------------------------------E-[]--------------------------[]--[]--------E----[]------------------------E-----------E
XXXXXXXXXXXXXXXXXXXXXXXXXXXX--XX----------------XXXXXXXX--XXXXXXX--XXXXXXX--XXXXXXXXXXXXXXXXXXXXXXXXXXXXXXXXXXXXXXXXXXXXXXXXXXXXXXXXXXXXXXXX