--------------------------------------------------------------------------------------------------------------------------------------------
--------------------------------------------------------------------------------------------------------------------------------------------
--------------------------------------------------------------------------------------------------------------------------------------------
--------------------------------------------------------------------------------------------------------------------------------------------
--------------------------------------------------------------------------------------------------------------------E-----------------------
SSSSSSSS--SSSS--SSSSS-----SS--------------SQSQS----SSSQS----------------------------------------------------QS----SSSSSS--------------------
--------------------------------------------------------------------------------------------------------------------------------------------
--------------------------------------------------E-----------------------------------------------------------------------------------------
--------------------------------------------------------------------------------------------------------------------------------------------
--------------S-------------Q--Q--Q--Q----?S----S-------------------?S----------------<>--------QS------S?S-S-----------------X-------------
--------------------------------------------------------------------------------------[]--------------------------------------X----X--------
---------------------X-----<>--------------------------------------------<>-----------[]-------------------------------------------XX-------
---------------E----EXXX---[]------------------------E-E------------E----[]-------E---[]------------E---------------------EE-------XX-------
XXXXXXXXXXXXXXXXXXXXXXXXXXXXXXXXXXXXXXXXXXXXXXXXXXXXXXXXXXXX---XXXXXXXXXXXXXXXXXXXXXXXXXXXXXXXXXXXXXXXXXXXXXXXXX--XXXXXXX-XX-------X-------X