--------------------------------------------------------------------------------------------------------------------------------------------
--------------------------------------------------------------------------------------------------------------------------------------------
--------------------------------------------------------------------------------------------------------------------------------------------
--------------------------------------------------------------------------------------------------------------------------------------------
--------------------------------------------------------------------------------------------------------------------------------------------
----------------------------------------------------------------------------------------------------------------------------SQ--------------
--------------------------------------------------------------------------------------------------------------------------------------------
--------------------------------------------------------------------------------------------------------------------------------------------
--------------------------------------------------------------------------------------------------------------------------------------------
-----------------------------SS-----<>-------XX------------------------------------------------S?S----S--Q--Q--S-SS-S---<>-------XQ---------
------------------------------------[]------XXX------<>-----------------X-X---------------------------------------------[]-------<>---------
-------<>---------XX--------X-------[]------XXX------[]---<>---<>-------XXX---------------------------------------------[]-------X----------
-------[]-E-------XX--------<>----E-[]-----XXXX-----XXXX--EE---[]------XXXXX------E-----------------E-E--E------EE----E-[]----XXXX-----E----
--XXXXXXXX-XX-XXXXXXXXXXXXXXXXXXXXXXXXXXXXXXXXXXXXXXXXXXXXXXXXXXXXXXXXXXXXXXXXXXXXXXXXXXXXXXXXXXXXXXXXXXXXXXXXXXXXXXXXXXXXXXXXXXXXXXXXXXXXXX