--------------------------------------------------------------------------------------------------------------------------------------------
--------------------------------------------------------------------------------------------------------------------------------------------
--------------------------------------------------------------------------------------------------------------------------------------------
--------------------------------------------------------------------------------------------------------------------------------------------
--------------------------------------------------------------------------------------------------------------------E-----------------------
--------------------X----------SSSS--------------------------------------------SQ---------------------------------SSSSS---------------------
-----------------XX-------------------------------------------------------------------------------------------------------------------------
-----------------XXXX-----------------------------------------------------------------------------------------------------------------------
-----------------XXXX-----------------------------------------------------------------------------------------------------------------------
-----------------XXXX-------X---------------------S-----X--Q--------QS-------Q--Q--Q---------------------SSQ--------------------------------
-------<>------XXXXXX-----------------------------------------------------------------------------------------------------------------------
X------[]------XXXXXXX----------------------------------------------------------------------------------------------------------------------
X-EE---[]-----XXXXXXXXX---------------------------------------------------------------------------------------------------------------------
XXXXXXXXXXXXXXXXXXXXXXXXXXXXXXXXXX------------X----XXXXXXXXXXXXXXXXXXXXXXXXXXXXXXXXXXXXXXXXXXXXXXX--XXXXXXXXXXXX------X--------------------X