--------------------------------------------------------------------------------------------------------------------------------------------
--------------------------------------------------------------------------------------------------------------------------------------------
--------------------------------------------------------------------------------------------------------------------------------------------
--------------------------------------------------------------------------------------------------------------------------------------------
--------------------------------------------------------------------------------------------------------------------------------------------
----------SSSS--SSS-------------------S-SSS------------------------SSS----SQ------S------------------------------------------?S---------QSQS
--------------------------------------------------------------------------------------------------------------------------------------------
--------------------------------------------------------------------------------------------------------------------------------------------
------------------------------------------------------------------------------------------------------E---S---------------------------------
-------QS----------S------XX----S--SSS---------S------X--------SS-------------------------------------X---------Q--Q--Q--S?S--------S?SQS--Q
-------------------------XXX-------------------------XX-----------------------------X------<>-------XXXX------------------------------------
------------------------XXXX-----------------------XXXX----------------------------<>------[]-------XXXX------------------------------------
----------------------XXXXXX--------------E-E------XXXXX-------------E-E----E-XX---Xo-EE---[]X-----XXXXXX----------E------------E----E------
XXXXXXXXXXXXXXXXXXXXXXXXXXXXXXXXXXXXXXXXXXXXXXXXXXXXXXXXXXXXXXXXXXXXXXXXXXXXXXXXXXXXXXXXXXXXXXXX--XXXXXXXXXXXXXXXXXXXXXXXXXXXXXXXXXXXXXXXXXX