--------------------------------------------------------------------------------------------------------------------------------------------
--------------------------------------------------------------------------------------------------------------------------------------------
--------------------------------------------------------------------------------------------------------------------------------------------
--------------------------------------------------------------------------------------------------------------------------------------------
--------------------------------------------------------------------------------------------------------------------------------------------
SSQ------SSSQS------------XX-----------------------------------------------------SSS-------------------------------------SSSQ-------------SS
-------------------------XXX----------------------------------------------------------------------------------------------------------------
------------------------XXX-----------------------------------------------------------------------------------------------------------------
-----------------------XXXX-----------------------------------------------------------------------------------------------------------------
----Q--SS-Q--------S---XXXX---<>-------S?S----S-----------<>-----------------SSQS---Q--Q--Q--Q--QS-S----S?S-S--Q-------QS-Q--------X--------
----------------------XXXXXX--[]--------------------------[]-------------------------------------------------------------------XX---X-------
---------------------XXXXXXX------------------------------[]-----E------------------------------------------------------------XXX---XXX----o
-E-----------EXE-E--XXXXXXXXE-<>--------E-E-E-E------EE---[]-----o---------------------E------------E----E-------------E-----XXXX---XXXX---Q
XXXXXXXXXXXXXXXXXXXXXXXXXXXXXXXXXXXXXXXXXXXXXXXXXXXXXXXXXXXXXXXXXXXXXXXXXXXXXXXXXXXXXXXXXXXXXXXXXXXXXXXXXXXXXXXXXXXXXXXXXXXXXXXXXXXXXXXXXXXX