--------------------------------------------------------------------------------------------------------------------------------------------
--------------------------------------------------------------------------------------------------------------------------------------------
--------------------------------------------------------------------------------------------------------------------------------------------
--------------------------------------------------------------------------------------------------------------------------------------------
--------------------------------------------------------------------------------------------------------------------E-----------------------
-----------------------------SSSSSSS----------------SSSS----------------------------------------------------------SSSSSS--------------------
-----------------------------------------------------------------------------------X--------------------------------------------------------
-----------------------------------------------------------------------------------X--------------------------------------------------------
----------------------------------------------------------------------------------EX----------------------S---------------------------------
----------------------------X-------------SS-------------SS-----<>-------<>S-X---XXX------------------X-------------------------------------
----------------------------------------------------------------[]-------[]---X--XXX-------<>-------XXX-------------------------------------
-----------------<>---------------------------------------------[]-------[]---XXXXXXX------[]------XXXXX---------------------------XX-----<>
--E---------E----[]-------E-----------------------------<>----E-[]-------[]---XXXXXXE-EE---[]------XXXXX---------------------------XXX----[]
XXXXXXXXXXXXXXXXXXXXXXXXXXXXXXXXXX---XXXXXX--XXX-XXXXXXXXXXXXXXXXXXXXXXXXXXXXXXXXXXXXXXXXXXXXXXXXXXXXXXXXXXXXXXX---X--X-------------------XX