--------------------------------------------------------------------------------------------------------------------------------------------
--------------------------------------------------------------------------------------------------------------------------------------------
--------------------------------------------------------------------------------------------------------------------------------------------
--------------------------------------------------------------------------------------------------------------------------------------------
--------------------------------------------------------------------------------------------------------------------------------------------
-------------------------------------Q-----------------X---------------------------------------------------------QSS------------------------
------------------------------------------------------XX------------------------------------------------------------------------------------
-----------------------------------------------------XXX------------------------------------------------------------------------------------
----------------------------------------------------XXXX------------------------------------------------------------------------------------
-Q-----Q---------------------SS----<>--------X--XXXX-XXX-SS--------------<>--X---XX-X--------------------SS---------------------------------
----------------XX-------X---------[]------XXX---XXX-XXX-----------------[]---X--XX---------------------------------------------------------
---------------XXXX-----XXX--------[]-----XXXX--XXXXXXXX-----------------[]-----XXX---------------------------------------------------------
-------EE-E----XXXX----XXXX-<>---E-[]----XXXXX--XXXXXXXX-----------------[]---XXXXXX--------------------------------------------------------
XXXXXXXXXXXXXXXXXXXXXXXXXXXXXXXXXXXXXXXXXXXXXXXXXXXXXXXXXXXXXXXXXXXXXXXXXXXXXXXXXXXX--XX---------X---XX--XXXXXXX--XX----------------XXXXXXXX