--------------------------------------------------------------------------------------------------------------------------------------------
--------------------------------------------------------------------------------------------------------------------------------------------
--------------------------------------------------------------------------------------------------------------------------------------------
--------------------------------------------------------------------------------------------------------------------------------------------
--------------------------------------------------------------------------------------------------------------------------------------------
------------SQ-------------------------SSSS---SSS---SSSSSSQ--SSS----SSSSSSSSS--SSSSS-SSSSSSS------SSS------SS------------?------------------
--------------------------------------------------------------------------------------------------------------------------------------------
--------------------------------------------------------------------------------------------------------------------------------------------
--------------------------------------------------------------------------------------------------------------------------------------------
--<>-----E-------<>------SS----Q---S?S----SS----S-S-S-----------------SS----S-------X-------------SS-------------SS----<>-Q-----XX--X-X----X
--[]-------------[]----------------------------------------------------------------------------------------------------[]------XXX--XXXX-XXX
--[]-------------[]----------------------------------------------------------------------------------------------------[]-----XXXX--XXXX-XXX
--[]----------E-E[]----E-------------------E-----------E-------------------------E-E---------------------------E-----E-[]-E--XXXXX-XXXXXXXXX
XXXXXXXXXXXXXXXXXXXXXXXXXXXXXXXXXXXXXXXXXXXXXXXXXXXXXXXXXXXXXXX--XXXXXXXXXXXXXXXXXXXXXXXXX---XXXXXXXXXX---XXXXXXXXXXXXXXXXXXXXXXXXXXXXXXXXXX