--------------------------------------------------------------------------------------------------------------------------------------------
--------------------------------------------------------------------------------------------------------------------------------------------
--------------------------------------------------------------------------------------------------------------------------------------------
--------------------------------------------------------------------------------------------------------------------------------------------
--------------------------------------------------------------------------------------------------------------------------------------------
----------------------------------------------------------------------------------------SSSS--------SSSSS-----SS---------SSSQS-----Q------XX
-------------------------------------------------------------------------------------------------------------------------------------------X
----------------------------------------------------------------------------------------------------------------------------------------X---
---------------------------------------------------------------------------------------------------------------------------------------XXX--
-------QS-----------S-------------------QS-------SSQ---S-SS--------------<>-----------------------S---------------------S--------------XX--X
----------------------------------------------------------------<>-------[]-----------------------------------------------------------XXX-XX
------------------------------<>-------------<>---------X-------[]-------[]-----------------------------XX-----<>-------------------XXXXX--X
-----------E-E-E-----------E--[]--------E----[]---------E-E-----[]-------[]-------E------------E--------XXX----[]--E---------E-E----XXXXX--X
XXXXXXXXXXXXXXXXXXXXXXXXXXXXXXXX--XXXX--XXXXXXXXXXXXXXXXXXXXXXXXXXXXXXXXXXXXXXXXXXXX---XXXXX---XXXXX---XXXXXXXXXXXXXXXXXXXXXXXXXXXXXXXXXXXXX