--------------------------------------------------------------------------------------------------------------------------------------------
--------------------------------------------------------------------------------------------------------------------------------------------
--------------------------------------------------------------------------------------------------------------------------------------------
--------------------------------------------------------------------------------------------------------------------------------------------
--------------------------------E-----------------------------------------------------------------------------------E-----------------------
---QSQ------------------------SSSQS-----------------------------------------------------------------------------SSSSSSSS-----SSSSSQSS---SSSS
--------------------------------------------------------------------------------------------------------------------------------------------
--------------------------------------------------------------------------------------------------------------------------------------------
--------------------------------------------------------------------------------------------------------------------------------------------
-----------X--XXX--X------------------------------------------------QS------------------------------------------X-------------S-------------
-----------X--XX---XXX----------------------------------------------------------------------------------------------------------------------
-------<>-XX--XXX--XXX----E<>-------------------------<>------------------------------------------------------------------------------------
---E---[]XXX-XXXX--XXXX---o[]-------------------------[]--------------------------E---------------------------------------------------------
--XXXXXXXXXXXXXXXXXXXXXXXXXX--------------------S------XXXXX---XXXXXXXXXXXXXXXXXXXXXXXXXXXXXXXXXXXXXXXX--XXXXXXX---XXX------XXX--XX----XXXXX