--------------------------------------------------------------------------------------------------------------------------------------------
--------------------------------------------------------------------------------------------------------------------------------------------
--------------------------------------------------------------------------------------------------------------------------------------------
--------------------------------------------------------------------------------------------------------------------------------------------
--------------------------------------------------------------------------------------------------------------------------------------------
SSSSSSSS----Q-------------SS--SSSSSS------SSSQS----SSSSS---?-----------------------------------------SS-------------------------------------
--------------------------------------------------------------------------------------------------------------------------------------------
--------------------------------------------------------------------------------------------------------------------------------------------
--------------------------------------------------------------------------------------------------------------------------------------------
-------Q--Q---X----X--------X-------------SS-----------------------X--X----X---------------------------------------------------------S------
--------------X----XX----------------------------------------------X--XX---XX-----------------------------------X---------------------------
--------------X----XXX-----------------------------------------<>-XX--XXX--XXX----<>------------------------------<>-------------<>---------
----------EE---E---XXXX-----------------------------------E----[]XXX---XX--XXXX---[]-------------------------EEE--[]--------E----[]---------
XXXXXXXXXXXXXXXXXX-XXXXXXXXXXXXXXX---XXXXXXXXXX--XXXXXXX---XXXXXXXXX----X-XXXX-----XXXXXXXXXXXXXXXXXXXXXXXXXXXXXXXXX---XXX-----XXXXXXXXXXXXX