--------------------------------------------------------------------------------------------------------------------------------------------
--------------------------------------------------------------------------------------------------------------------------------------------
--------------------------------------------------------------------------------------------------------------------------------------------
--------------------------------------------------------------------------------------------------------------------------------------------
--------------------------------------------------------------------------------------------------------------------------------------------
------------------------------S-SS--------SSS------SSS------------------------------SSSSSSSS----?SS-SSSSS---SSS-----------------------------
---------------------------------------------------------------------------------------------------------------------------------XX---------
---------------------------------------------------------------------------------------------------------------------------------XXX--------
---------------------------------------------------------------------------------------------------------------------------------XXXX-------
-SS--------------<>---------X-------------QS----------------------------------------X-------------SS-----------------------------XXXX-------
-----------------[]------X---------------------------------------------------------------------------------------------<>------XXXXXXX------
--------<>-------[]-----XXX-------------------------------------------------------------------------------------X------[]-----XXXXXXXX----<>
<>------[]-------[]----XXXX-------------------------------<>---------------------------------------------------EE-EE---[]-X---XXXXXXXXX---[]
XXXXXXXXXXXXXXXXXXXXXXXXXXXXXXXXXX---XXXXXX--XX---XXXXXXXXXXXXXXXXXXXXXXXXXXXXXXXXXXXXXXXXX--XXXXXXXXXXXXXXXXXXXXXXXXXXXXXXX--XXXXXXXXXXXXXX