--------------------------------------------------------------------------------------------------------------------------------------------
--------------------------------------------------------------------------------------------------------------------------------------------
--------------------------------------------------------------------------------------------------------------------------------------------
--------------------------------------------------------------------------------------------------------------------------------------------
--------------------------------------------------------------------------------------------------------------------E-----------------------
----------SSSSSSSSSSS--SSSSS---------------------------------------------------SQS--SS----?S--SSSSQ---------------SSSSSS--------------------
---------------------------------------------XX---------------------------------------------------------------------------------------------
---------E--------------------------------------------------------------------------------------------------E-------------------------------
---------------------------------------------XX---S-----------------------------------------------------------------------------------------
-------S?S----S-----S-------------------------XX----------<>-------S--------S?S-Q--Q?-------------S-----S?SQS-------------------------------
-----------------------------------<>-------XXXX----------[]--------------------------------------------------------------------------------
----------------------------X------[]------XXXXX----------[]--------------------------------------------------------------------------------
---------------------------ES-EE---[]------XXXXXX---------[]------------E--------------------------E----------------------------------------
XXXXXXXXXXXXXXXXXXXXXXXXXXXXXXXXXXXXXXXXX-XXXXXXXXXXXXXXXXXXXXXXXXXXXXXXXXXXXXXXXXXXXXXXXXXXXXXXXXXXXXXXXXXXXXXX----------------------------