--------------------------------------------------------------------------------------------------------------------------------------------
--------------------------------------------------------------------------------------------------------------------------------------------
--------------------------------------------------------------------------------------------------------------------------------------------
--------------------------------------------------------------------------------------------------------------------------------------------
--------------------------------------------------------------------------------------------------------------------------------------------
------------------------------------------------------------SSS-----------------------------------------------------SQ----------------------
--------------------------------------------------------------------------------------------------------------------------------------------
--------------------------------------------------------------------------------------------------------------------------------------------
----------------------S---------------------------------------------------------------------------------------------------------------------
------------------X-----------------------------------------------------------S-------SS-------S------S--Q----SS----------------------------
X----------------XX-------------------------------------------------------------------------------------------------------------------------
X-------<>-------XX-----------------<>---------------------------------------------------------------------------------------------XX-----<>
X-EE----[]------XXXX----------E-----[]-------<>------------------------E--------------EE----------E-E-E--E-------------------------XXX----[]
XXXXXXXXXXXX--XXXXXXXXXXXXXXXXXXXXXXXXXXXXXXXXXXXXXXXXXXXXXXXXXXXXXXXXXXXXXXXXXXXXXXXXXXXXXXXXXXXXXXXXXXXXXXXXXX-----XX--------------------X