--------------------------------------------------------------------------------------------------------------------------------------------
--------------------------------------------------------------------------------------------------------------------------------------------
--------------------------------------------------------------------------------------------------------------------------------------------
--------------------------------------------------------------------------------------------------------------------------------------------
--------------------------------------------------------------------------------------------------------------------------------------------
---------SSSSSQ----Q-----SSS------------SSSQ-------SQS-------------------------------------------------------------?S-----------------------
--------------------------------------------------------------------------------------------------------------------------------------------
---------E-----------------------------E----------------------------------------------------------------------------------------------------
--------------------------------------------------------------------------------------------------------------------------------------------
----S--S?S---------SQ----------Q-----S?S--------SQ--Q--Q-----------S?S---<>--Q-----S------------------------------------------------------<>
------------------------X------S--------------------------XX-------------[]---------------------------------------------------------------[]
----------------------------------------------------------<>----<>-------[]----------------<>---------XX---------------<>----------X------[]
-E-----------EEEEE--E--E---E---b------------E----E--------[]----[]--E----[]----------------[]---------XX---------------[]----------X------[]
XXXXXXXXXXXXXXXXXXXXXXXXXXXXXXXXXXXXXXXXXXXXXXXXXXXXXXXXXXXXXXXXXXXXXXXXXXXXXXXXXXXX-XXXXXXXXX----XXXXXXXXXXXXXX-XXX--XXX-----------XXXXXXXX