--------------------------------------------------------------------------------------------------------------------------------------------
--------------------------------------------------------------------------------------------------------------------------------------------
--------------------------------------------------------------------------------------------------------------------------------------------
--------------------------------------------------------------------------------------------------------------------------------------------
--------------------------------------------------------------------------------------------------------------------E-----------------------
--------------??-------SSSQ--------------Q---------------------------Q-------------------------------------------SSSSSS-----?S--------------
--------------------------------------------------------------------------------------------------------------------------------------------
----------------------E---------------------------------------------------------------------------------------------------------------------
--------------------------------------------------------------------------------------------------------------------------------------------
X--Q--Q-----QSQS--------------<>-------S------S--Q---SSS--SSS----S--------SS-----X----------------------------------------------------------
------------------------------[]-------------------------------------------------X--X----------------<>----------------------------XX-------
------------------------------[]-----------------------------------------------XXX----<>---<>--------XXX-----<>--------------------XXX------
---E--------------------------[]--------E-E-E-E--E-------E----------E-E-E-E----XXXb---[]---[]X------XXXX-----[]-----------E--------XXXX-----
XXXXXX---XXXXXXXXXX---XXXXXXXXXXXXXXXXXXXXXXXXXXXXXXXXXXXXXXXXXXXXXXXXXXXXXXXXXXXXXXXXXXXXXXXXXX--XXXXXXXXXXXXXXXXXXXXXXXXXX------XXXXXXXXXX