--------------------------------------------------------------------------------------------------------------------------------------------
--------------------------------------------------------------------------------------------------------------------------------------------
--------------------------------------------------------------------------------------------------------------------------------------------
---------XXX---------------------------------------------------------------------------------------------------------------------XXXXXXXXXX-
-------XXX--X-------------------------------------------------------------------------------------------------------------------XX----------
XX----XXXS---X-----------------------------------------------------------------------------------------------------------------XXX----------
--X--XXEX-----X---------------------------------------------------------------------------------------------------------------XXXX----------
---XXXXXX------X-------------------------------------------------------------------------------------------------------------XXXXX----------
----XXXXXS------X----------X-------B--------------------------------XXXXX------------------------------------E------------X--XXXXX----------
----XXXXX--------X---------B-------b-------------------------------XXX<>-X---------------XXX----------------<>--------------XXXXXX----------
---XXXXXX---------X--------b--?-B------?QQ------------------------XX-X[]--X-------------XXX-X---------------[]---<>---<>---XXXXXXX----<>----
--XXXXXXX----------X-------B----b--------------------XXX---XXX---XX--X[]---X------XXXX-XX-X--X--------------[]---[]---[]--XXXXXXXX----[]----
XXXXXXXXX---------X-XXXXXXXXXXXXXXXXXXXXXXXXXXXXXXXXXX--XXXX--XXXX--EX[]----XXXXXXX---XX--X---XXXXXXXXXXXXXX[]---[]---[]-XXXXXXXXX----[]----
XXXXXXXXXXXXXXXXX-XXXXXXXXXXXXXXXXXXXXXXXXXXXXXXXXXXXX--XXXX--XXXXXXXXXXXXXXXXXXXXX--XXXXXX--XXXXXXXXXXXXXXX[]---[]-XXXXXXXXXXXXXXXXXXXXXXXX