--------------------------------------------------------------------------------------------------------------------------------------------
--------------------------------------------------------------------------------------------------------------------------------------------
---------------------------------------------S----------------------------------------------------------------------------------------------
---------------------------------------------------------------------------------XXXXXXXXXXX------------------------------------------------
--------------------------------------------------------------------------------XX----------------------------------------------------------
--E----------------------------------------------------------------------------XXX----------------------------------------E----E------------
-<>-------------------------------------------XX-----------------------------XXXXX---------------------------------------<>-----------------
-[]------------------------------------------XXX----------------------------XXXXXX---------------------------------------[]-----------------
-[]-----------------------------------------XXXX---------------------------XXXXXXX---------------------------------------[]----------<>-----
-[]--E--E---E-------?SS--------------------XXXXX-------------SSSS----E----XXXXXXXX------------E--SSS---E----?QQQQQQQ?----[]------E---[]----X
X[]-<>-<>--<>-------------------E---------XXXXXX-------------SSS----<>---XXXXXXXXX----<>-----<>-------<>------------------------<>---[]---XX
X[]-[]-[]--[]------------------<>--------XXXXXXX-------<>-----------[]--XXXXXXXXXX----[]-----[]-------[]----B-------------------[]---[]--XXX
X[]-[]-[]--[]-------B-----E----[]-------XXXXXXXX-------[]-----------[]-XXXXXXXXXXX----[]-----[]-E-----[]----b-E-----B-------E---[]---[]-XXXX
XXXXXXXXXXXXXXXXXXXXXXXXXXXXXX-XXXXXXXXXXXXXXXXX-------XXXXXXXXXXXXXXXXXXXXXXXXXXXXXXXXXXXXXXXXXXXXXXXXXXXXXXXXXXX-XXXXXXXXXXXXXXXXXXXXXXXXX