--------------------------------------------------------------------------------------------------------------------------------------------
---------------------------------------------------------------------------------------------------------------------XXX--------------------
---------------------?--------------------------------------------------?--------------------------------------------XX-XXX-----------------
-------------------------------------------------------------------------------------XXX----------------------------XX--XX-X----------------
--------------------------------------XXXXX---------------------------------------XXXX--X--------------------------XX---XX--X---------------
----SSSSS-------------------XXXXX----XXXX--X-------------------------------------XXXXX---X-------SSS?SSS-----------XS---XX---X--------------
-----------------------SS--XX----X--XXXXX---X-------------------------------XX--XXXXXX----X-E----------------------X----XX----X-------------
--------------------------XXX-----XXXXXXX----X------------------------SS-------XX-XXXX-----X-----------------------X----XX-----X------------
-----E-------------SS----XXXX------XXXXXX-----X--------------------B----------XX-EXXXX------X---------------------XX----XX------X-----------
----SSSSS-XXX-----------XXXXX------XXXXXX------X-----------B-------b---------XX--XXXXX-------X----SSSSSSS--------XXX----XX-------X---------Q
XX-------XXX-X--B------XXXXXX-----XXXXXXX-------X----------b--?-B-----------XX---XXXXX--------X-----------------XX-X----XX--------X---------
>-X-----XX-X--X-b----XXXXXXXX----XXXXXXXX--------XX--------B----b-------XXXXX----XXXXX---------X-------XXXXXX--XX--X----XX---------X--------
]--XXXXXX--X---XXXXXXX-XXXXXX---XXXXXXXXX--------X-XXXXXXXXXXXXXXXXXXXXXX--X-----XXXXX----------XXXXXXXX--X--XXXE--X----XX--------X-XXXXXXXX
XXXXXXXXXXXXXXXXXXXXXX-XXXXXXXXXXXXXXXXXXXXXXXXXXXXXXXXXXXXXXXXXXXXXXXXXX--X-----XXXXX---------XXXXXXXXX--X--XXXXXXXXXXXXXXXXXXXXXXXXXXXXXXX