--------------------------------------------------------------------------------------------------------------------------------------------
-----------------------------------------------------------------------------------------------------XXXXXXXXXXXXXXXXXXXXXXXXXXXXXXXXXXXXXXX
SSSSSSSSSS-------------SSS--[]SSSSSSSSSSSSSSSS---------SSSSSSSSSSSSSSSSSSSSSSSSSSSSSSSSSSSSS--------XXSSSSSSSSSSSSSSSSSSSSSSSSSSSSSSSSSSSSSS
----------------------------[]SSSSSSSSSSSSSSSS---------SSSSSSSSSSSSSSSSSSSSSSSSSSSS----------------XX---------------------------------------
----------------------------[]SSSSSSSSSSSSSSSS---------SSSSSSSSSSSSSSSSSSSSSSSSSSSS-----------XXX-XX----------------------------------------
-----------XX--XXXXX--------[]SSSSSSSSSSSSSSSS--------SSSSSSSSSSSSSSSSSSSSSSSSSSSSS--QQ------XXXX-XSSS-----------E--------------------------
----------XX-XXX----X-------[]SSSSSSSSSSSSSSSS--------S-------------------------------------XX---XX-------------<>--------------------------
---------XX--XXX-----X------[]SSSSSSSSSSSSSSSS--------------XXX-------------------XXX-XXX--XX-----XS------------[]--------------------------
-----XXXXX------------X------]SSSSSSSSSSSSSSSS--------SoXXXXX?-XXXXXXXXXXXXXXXXXXXX--XX--XXX------S-S-----------[]------S-------------------
----XX-XXX-------------XXXXX-]SSSSSSSSSSSSSSSS--------S?SSSSS??SSSSSSSSSSSSSSSSSSSS--QQ--QQQ---------S-----E--SS[]S---E----E----------------
---XX-----------SSS-S--SSSSSSSSSSSSSSSSSSSSSSS--------SSSSSS---SSSSSSSSSSSSSSSSSSSS-----------------------<>----[]---<>---<>-------------XX-
XXXX------------SSS-S--SSSSSSSSSSSSSSSSSSSSSSS--<>----SSSSSS---SSSSSSSSSSSSSSSSSSSS-----------------------[]----[]---[]---[]------------XXX-
E-XX------------SSS-S--SSSSSSSSSSSSSSSSSSSSSSS--[]----------oooSSSSSSSSSSSSSSSSSSSS-----------------------[]-E--[]---[]---[]--------E-E-XXX-
XXXX---------XXXSSS-S--XXXXXXXXXXXXXXXXXXXXXXX--XXXXXXXXXXXXXXXXXXXXXXXXXXXXXXXXXXXXXXXXXXXX------XXXXXXXXXXXXXXXXXXXXXXXXXXXXXXXXXXXXXXXX--