--------------------------------------------------------------------------------------------------------------------------------------------
--------------------------------------------------------------------------------------------------------------------------------------------
---------------------------------------------------------------------------------------------------------------------------------------oo---
--------------------------------------------------------------------------------------------------------------------------------------------
---------------------------------------------------------------------------------------------------XXXXX------------------------------------
------E--S---SSSSSSSSS------------SS---SS-------------SSS-----E---------------------------------E-XXXXX-X------------------------------XXX--
-----<>------------------------------------------------------<>----------------------------------XXXXXX--X----------------------------------
-----[]------------------------------------------------------[]------XXXXX----XXXXX-------------XXXXXXX---X---------------------------------
-----[]------------XXXX---------SS--------------XXXXX--------[]----XXX----X-XXX----X----------XXXXXXXXX----X-----------------------------XXX
----SXXS----------XX--XXX-XXX---------SSS---XXXXX-XX-XSSS----XXX--XX<>-----XX<>-----XX-------XX<>XXXXXX-----X-------------------XXXX----XXXX
XX------XXXX-----XX------XX--XXX-----------XXXX<>-XX--X----------XX-[]----E<>[]----<>-X-----XX-[]XXXXXX------X-------------------------XX---
>-X----XX<>-X---XX-------<>--<>-X-XXXXX---XXXXX[]-XXX--X--------XX--[]---<>[][]----[]--X---XX-X[]XXXXXX-------XXX---------XXX---XXX---XX----
]--XXXXX-[]--XXXX--------[]--[]--XX----XXXXXXXX[]-XXX---XXXXXXXXX---[]---[][][]----[]---XXXX-XX[]XXXXXX-------XX-XXXXXXXXXX--XXXX--XXXX-----
XXXXXXXXXXXXXXXXX------XXXXXXXXXXXX-X-XXXXXXXX-XXXXXXXXXXXXXXXXXXXXXXXXXXXXXXXXXXXXXXXXXXXXXXXXXXXXXXXXXXXXXXXXXXXXXXXXXXXX--XXXX--XXXX-----