--------------------------------------------------------------------------------------------------------------------------------------------
--------------------------------------------------------------------------------------------------------------------------------------------
--------------------------------------------------------------XXXX-------------------------------------------------------XXXX---------------
------------------------------------------------------XXXXX--XX---X-------------------------------------------------------[]---------XXXXX--
-----------------------------------------------------XX----XXX-----XXXXXX-------------------------------------------------[]-------XXX----X-
X-----------------------QQQ?QQQQQQQQQQ?QQQQ---------XXX-----X-------X----X------------------------------------------------<>------XX<>-----X
]---------------------------------------[]---------XXXX----XX------XX-----X------------------------------------------------------XXX[]------
]---------------------------------------[]--------XXXXXXX------------------X-----------------------------------------------E-----XXX[]------
]---------------------------------------[]-------XXXXXX---------------------XXXXX----------------------------------------------XXXXX[]------
>SSSSSS-------------------SSSSSSSSSSSSS-<>------XXXXXXX----------------------XXX-X------------------------XXXX-----------XXXX-XX<>XX[]------
-----------------------------------------------XXXXXXXX----------------------XXX--X----------------------XX---XX--------XX---XXX[]XX[]------
EXXX---------------------E---E----------XXX---XXXXXXXXX-E-------------------XXXX---X------------XXXXX---XX---<>-X------XX---<>XX[]XX[]------
XXE-XXXXXXXXXXXXXXXXXXXXXXXXXXXXXXXXXXXXXE-XXXXXXXXXXXX<>------------------XXXXX----XXXXXXXXXXXXXE---X-XX----[]--XXXXXXX----[]XX[]XX[]------
X<>XXXXXXXXXXXXXXXXXXXXXXXXXXXXXXXXXXXXX<>-XXXXXXXXXXXX[]------------------XXXXXXXXXXXXXXXXXXXXX<>----XX-----XXXXXXXXXXX----[]XXXXXXXXXXXXXX