-------------------------------------------------------------------------------------XXXX---------------------------------------------------
--------------------------------------------------------------------------------------X--X--------------------------------------------------
-----------------------------E------------------------------------------------------------X-----XX------------------------------------------
-------------------------------------------------------------------------------------------X-?-XX-X------XXX----XXX-------------------------
--------------------------------------------------------------------------------------------X-XX---X-XXXXX--XXXXX--X-------?----------------
------------------------------XX----------------------------------------XXX------------------XX-----XX--XX--XXXXX---X-----------------------
-----------------------------------------------------------XXXoo-------------------XXX-------XX-----XX---------------X-----E----------------
------------------------------------------------------------------X---------------------------------------------------X-XXXX-----XX---------
-----------------------X---X-------------------XXX---------------------------------------------------------------------XX---X---XX-X--------
?SS-----------------X-------------------------XX--X---------------------------XXX--------------------------------------XX----X-XX---X-------
--------------------X------------------------XX----X--------------------------------------------------------------------------XX-----XXXXXXX
B-----------?-------X-----------------X-----XX------X------------------------------------------------------------------------XXX-----XXXEXXX
b-------E-----------X--------X---------XXXXXX--------XXXXX---------------------------------------------------------------------------X------
XXXXXXXXXXXX-XXXXXXXX----XXXXX--------XXXXXXX--------XXXX---------------------------------------------------XXXXXXXX-----------------X------