--------------------------------------------------------------------------------------------------------------------------------------------
------------------------------------------------------------------------------------------------------------X-------------------------------
--------------------------------------------------------------------------XXXX--------------------------------------------------------------
------------------------------------------------------------------XXXXX--XX---X-------------------------------------------------------------
-----------------------------------------------------------------XX----XXX-----XXXXXX--------------------------------XXXXX------------------
-------------XX------------------------QQQ?QQQQQQQ?QQQQ---------XXX-----X-------X----X------------------------------XXXX--X-----------------
-------------[]-------------------------------------[]---------XXXX----XX------XX-----X----------------------------XXXXX---X----------------
-------------[]-------------------------------------[]--------XXXXXXX------------------X--------------------------XXXXXX----X---------------
--XXXX-------[]-------------------------------------[]-------XXXXXX---------------------XXXXX--------------------XXXXXXX-----X-----------E--
-XX---XX-----<>SSSSSS--------------------SSSSSSSSSS-<>------XXXXXXX----------------------XXX-X------------------XXXXXXXX---S--X------------X
XX----X-X--------------------------------------------------XXXXXXXX----------------------XXX--X----------------XXXXXXXXX-------X----------XX
X-----XX-XX---EXXX----------------------E---E-------XXX---XXXXXXXXX-E-------------------XXXX---X--------------XXXXXXXXXX--------XX-------XX-
B-----XXXX-XXXXXE-XXXXXXXXXXXXXXXXXXXXXXXXXXXXXXXXXXXE-XXXXXXXXXXXX<>------------------XXXXX----XXXXXXXXXXXXXXXXXXXXXXXX--------X-XXXXXXXX--
X-----XXXXXXXXX<>XXXXXXXXXXXXXXXXXXXXXXXXXXXXXXXXXXX<>-XXXXXXXXXXXX[]------------------XXXXXXXXXXXXEXXXXXXXXXXXXXXXXXXXXXXXXXXXXXXXXXXXXXXXX