--------------------------------------------------------------------------------------------------------------------------------------------
--------------------------------------------------------------------------------------------------------------------------------------------
SSSSSSSSSSSSSSSS-------------SSS--[]SSSSSSSSSSSSSSS-----------------------------------------------------------------------------------------
-SSS------------------------------[]SSSSSSSSSSSSSSS----------------------------------------------------------------------------------XXXXXXX
-SSS------------------------------[]SSSSSSSSSSSSSSS---------------------------------------------------------------------------------XX------
-SSS-------------XX--XXXXX--------[]SSSSSSSSSSSSSSS------------------------------------------------------------E-------------------XXX------
----------------XX-XXX----X-------[]SSSSSSSSSSSSSSS-----------------------------------------------------------<>------------------XXXX------
---------------XX--XXX-----X------[]SSSSSSSSSSSSSSS-----------------------------------------------------------[]-----------------XXXXX------
XXXXX------XXXXX------------X------]SSSSSSSSSSSSSSS-----------------------------------------------------------[]----------------XXXXXX------
?SSS-X----XX-XXX-------------XXXXX-]SSSSSSSSSSSSSSS---E--EE----------------------E----------------------E--SSS[]SS---E----E----XXXXXXX------
SSS---X--XX-----------SSS-S--SSSSSSSSSSSSSSSSSSSSSS--<>--<>---------E-----------<>---------------------<>-----[]----<>---<>---XXXXXXXX----<>
SS-----XXX------------SSS-S--SSSSSSSSSSSSSSSSSSSSSS--[]--[]------------------------------------?-------[]-----[]----[]---[]--XXXXXXXXX----[]
--E-EE--XX------------SSS-S--SSSSSSSSSSSSSSSSSSSSSS--[]--[]------------------------E-------E-----------[]-E---[]----[]---[]-XXXXXXXXXX----[]
XX-XXXXXXX---------XXXSSS-S--XXXXXXXXXXXXXXXXXXXXXX--[]--[]----------------------XXXXXXXXXXXXXX-XXXXXXXXXXXXXXXXXXXXXXXXXXXXXXXXXXXXXXXXXXXX