--------------------------------------------------------------------------------------------------------------------------------------------
--------------------------------------------------------------------------------------------------------------------------------------------
SSSSSSSSSSSSSSSSSSSSSSSSSSSSSSSSSSSSSSSSSSSSSSSSSSSSSSSSSSSSSSSSSSSSSSSSSSSSSSSSSSSSSSSSSSSSSSSSSSSSSSSSSSSSSSSSSSSSSSSSSSSSSSSSSSSSSSSSSSSS
--------------------------------------SSSSSSSSSSSSSSSSSSSSSSSSSSSSSSSSSSSSSSSSSSSSSSSSSS---------------------------------------SSSSSSSSSSSSS
-------------XXX----------------------SSSSSSSSSSSSSSSSSSSSSSSSSSSSSSSSSSSSSSSSSSSSSSSSSS---------------XXX---------------------SSSSSSSSSSSSS
E------XXXXXXX--X---------------------SSSSSSSSSSSSSSSSSSSSSSSSSSSSSSSSSSSSSSSSSSSSSSSSSS---------XXXXXXX--X--------------------SSSSSSSSSSSSS
------XXSSSSSS---XXXXX--------------------------------------------------------------------------XXSSSSSS---XXXXX----------------------------
-----XX-SSSSSS--SSSSS-X----------------------------XXXXX--------XXXXX------XXXXX------XXXX-----XX-SSSSSS--SSSSS-X------------------------XXX
XXXXXX--SSSSSS--SSSSS--XXXXXXXXXXXXXXXXXXXXXXXXXXXXX----XXXXXXXXX----XXXXXXX----XXXXXXXE--XXXXXX--SSSSSS--SSSSS--XXXXXXXXXXXXXXXXXXXXXXXXX--
SSSSSS--SSSSSS--SSSSS?SS?SSSSS????????SSSSSSSSSSSSS?----SSSSSSSS?----SSSSSS?----SSSSSSSS--SSSSSS--SSSSSS--SSSSS?SS?SSSSS???????SSSSSSSSSS?--
SSSSSS------------------SSSSSSSSSSSSSS----------------------------------------------------SSSSSS------------------SSSSSSSSSSSSS-------------
SSSSSS--------<>--------SSSSSSSSSSSSSS---------------<>-----------<>---------<>-----------SSSSSS--------<>--------SSSSSSSSSSSSS------------<
SSSSSS--------[]-------------------------------------[]-----------[]---------]]---------ooSSSSSS--------[]---------------------------------[
XXXXXXXXXXXXXXXXXXXXXXXXXX-XX-XXXXXXXXXXXXXXXXXXXXXXXXXXXXXXXXXXXXXXXXXXXXXXXXXXXXXXXXXXXXXXXXXXXXXXXXXXXXXXXXXXXXXX-XX-XXXXXXXXXXXXXXXXXXXX