-----------------------------------------------------------------------------------------------------------------------------------------XXX
-----------------------------XX---------------------------------------------------------------------------------------------------------XX--
----------------------------XX-X---------------------------------------oo------XXX----------------------------------XXXX------XXXX-----XX---
---------------------------XX---X-----XXX--------------------------------XXXXXXX--X--------------------------------XX<>-X----XX--XXX--XX----
---------------------XXXXXXX-----XXXXXX--X------------------Eooo--------XXXXXXXX---X------------------------------XX-[]--X--XX------XXX-----
------------------XXXX---XXX-----XXXXXXE--X-----------------XXXXX------XX-----------X----------------------------XXXX[]X--XXX-------XXX-----
-----------------XXXXX---------------------X--------------------------XX-----------ooX--------------------------XX---------X----------------
----------------XX--------------------------X--------------------XXXXXX---------------X------------------------XX--------XXX----------------
------------XXXXX----------------------------X-----------XXXXXXXXX---XXXXX-------------X--------------------XXXX----------------------------
-----------XX-XXX--------XXX------------------X---------XXXXXXXXXX----------------------XXXXXX----oooooooo-XXXEXXX--------------------------
X---------XX-----------------------------------XXXXXX--XX-------------------------------XXX?X-X-----------XX-----------------------------E--
-X-------XX-------------------------------------X----XXX-----------o------------------------X-XXXXXXXXXXXXX-----------------------------<>--
-XXXXXXXXX------------------------------XXXXEXXEX----XXX----------XXX-----------------------X-XXXXXXXXXXXEX-------------------XXX-------[]--
XXXXXXXXXX-------------------------------------------------------------------------XXXX-----X-X----------------------------------------X[]X-