--------------------------------------------------------------------------------------------------------------------------------------------
--------------------------------------------------------------------------------------------------------------------------------------------
SSSSSSSSSSSSS?SSSSSSSSSSSSSSSSSSSSSSSSSSSSSSSSSSSSSSSSSSS?SSSSSSSSSSSSSSSSSSSSSSSSSSSSSSSSSSSSSSSSSSSSSSSSS----SSSSSSSSS--------------------
----------------------SS--SSSSSS--SSSS------SSSS-------------------------------------SSSSSSSS-----------[]----------------------------------
----------------------SS--SSSSSS--SSSS--E---SSSS-------------------------------------SSSSSSSS-----------[]--------------XXXXX---------------
----------oooo------SS--------SS---S----SS----------oooooo---------------------------SSSSSSSS-----------[]------XXXXXXXXX----XXXXXXXXXXXXXX-
--------------------SS--------SS---S----SS--------------------------------------------------------------[]------XSSSSSSSS----SSSSSSSSSSSSX-X
--------S-SSSS------SS--------SS---S----SS----------SSSSSS--------------------------------------<>------[]------XSSSSSSS-----------------X--
--------SoSSSS------SS----ooooSS---So??-SS---E------SSSSSS------------XXXX-----------XXXXXXX----[]------[]---XXXXSSSSSS------------------X--
--------SSS---------SSSS--SSSSSS---SSS--SS--SSSS----------------------X<>-X---------XX-SSSS-X--QQQQQQ---<>--XX--?SSSS------S-------------X--
XXXXX-----------------SS-------------------EE------------------------XX[]--X-------XX--SSSS--X-------------XX--------------S------------?X-<
XSSS-X----------------SS-----------------------XXXXX----------------XX-[]---XXXXX-XX---SSSS---X-XXXXX-----XX-------------------------E---X-[
oooS--XXXXXXXXXXXXXXXXXXXXXXXXXXXXXXXXXXXXXXXXXX----XXXXXXXXXXXXXXXXX--[]----X---XX--------EE--XX----XXXXXX-------------------------<>---X-[
XXXXXXXXXXXXXXXXXXXXXXXXXXXXXXXXXXXXXXXXXXXXXXXX---XXXXXXXXXXXXXXXXXXXXXXXXXXX---XX---XXXXXXXXXXX-X-XXXXXXX----XXXXXXXXX------------[]---X-[