-----------------------------------------------------------------------------------------------------------------------------------XXXXXX---
-------------------------------------------------------------------------------------------------------------------------------XXXXX----XXXX
SSSSSSSSSSSSSSSSSSSSSSSSSSSSSSSSSSSSSSSSSSSSSSSSSSSSSSSSSSSSSSSSSSSSSSSSSSSSSSSSSSS?SSSSSSSSSSSSSSSSSSSSSSSSS-----SSSSSSSSSS--XX--X-------SS
]------------------------------------------------SSSSSSSSSSSSSSSSSSSSSSSSSSSS-------SSSSSSSSSSSSSSSS-------[]----------------XX---X---------
]-------E----------------XXX---------------------SSSSSSSSSSSSSSSSSSSSSSSSSSSS-------SSSSSSSSSSSSSSSS-------[]---------------XX--------------
]---QQQQQQ--------XXXXXXXX--X--------------------SSSSSSSSSSSSSSSSSSSSSSSSSSSS-------SSSSSSSSSSSSSSSS-------[]------XXXXXXXXXX---------------
]----------------XXSSSSSSS---XXXXXX---------------------------------------------XXXXXX---------------------[]------XSSSSSSSSS-X--------X----
]---------------XX-SSSSSSS--SSSSSS-X---------------------------XXXXX-------XXXXXX-----X--------------------[]------XSSSSSSSS----------------
]--XXXXXXXXXXXXXX--SSSSSSS--SSSSSS--XXXXXXXXXXXXXXXXXXXXXXXXXXXX----XXXXXXXXE--<>------X------XXXXXXX------[]---XXXXSSSSSSS-----------------
]-XXSSSSSSSSSSSSS--SSSSSSS--SSSSSS?SS?SSSSS??????SSSSSSSSSSSSSS?----SSSSSSSSS--[]-------X--XXXX-<><>-X-----[]--XX--?SSSSS-------------------
>XX-SSSSSSSSSSSSS--------------------SSSSSSSSSSSS------------------------------[]--------XXXXXX-[][]--X----<>-XX----------------------------
XX--SSSSSSSSSSSSS---------<>---------SSSSSSSSSSSS----------------<>------------[]--------EEXXXX-[][]---X-----XX-------------------X-------oo
X---SSSSSSSSSSSSS---------[]-------------------------------------[]------------[]-------E-XXXXX-[][]----XXXXXX----------------------------oo
XE--XXXXXXXXXXXXXXXXXXXXXXXXXXXXXXXXXXX-XX-XXXXXXXXXXXXXXXXXXXXXXXXXXXXXXXXXXXXXXXXX-XXXEXXXXXX-XXXXXXEXXXXXXX----XXXXXXXXXX--------------XX