-------------------------------------------------------------------------------------------------------------------------------------------X
---------------------------------------------------------------------------------------------------------------------------------------XXXXX
SSSSSSSSSSSSSSSSSSSSSSSSSSSSSSSSSSSSSSSSSSS?SSSSSSSSSSSSSSSSSSSSSSSS-----SSSSSSSSSSSSSSS---SS-----------------SS----SS-----SSSSSSSSS--XX--X-
---------------SSSSSSSSSSSSSSSSSSSSSSS------SSSSSSSSSSSSSSS-------[]------------------------------------------------[]---------------XX---X-
---------------SSSSSSSSSSSSSSSSSSSSSSS------SSSSSSSSSSSSSSS-------[]-------------------------XXXX-------------------[]--------------XX------
---------------SSSSSSSSSSSSSSSSSSSSSSS------SSSSSSSSSSSSSSS-------[]------XXXXXXXXXXXXXXXXXXXX---X------------------[]------XXXXXXXXX-------
-----------------------------------------XXXXX--------------------[]------XSSSSSSSSSSSSSSSSSSS----X-----------------[]------XSSSSSSSS-X-----
------------------------XXXXX-------XXXXXX----X-------------------[]------XSSSSSSSSS---------------X----------------[]------XSSSSSSS--------
XXXXXXXXXXXXXXXXXXXXXXXXX----XXXXXXXXE--<>-----X-----XXXXXXX------[]---XXXXSSSSSSSSS----------------X----XXXX-------[]---XXXXSSSSSS---------
SSSSSSS????????SSSSSSSSS?----SSSSSSSSS--[]------X-XXXX-<><>-X-----[]--XX--?SSSSSSSS???SSS-------S----X--XX---XX-----<>--XX--?SSSSS----------
SSSSSSSSSSSSSSS-------------------------[]-------XXXXX-[][]--X----<>-XX--------SSSS---SSS-------S-----XXX----X-X-------XX-------------------
SSSSSSSSSSSSSSS-----------<>------------[]-------EXXXX-[][]---X-----XX---------SSSS---SSS--------------X-----XXXXX---EXX------------------X-
--------------------------[]------------[]------E-XXXX-[][]----XXXXXX--------------oooSSS--------------B-----XXXX-XXXXX---------------------
XX-XX-XXXXXXXXXXXXXXXXXXXXXXXXXXXXXXXXXXXXXX-XXXEXXXXX-XXXXXXEXXXXXXX----XXXXXXXX-XXXXXXX--------XXXXXXX-----XXXXXXXXXX----XXXXXXXXX--------