---------------------------------------------------------------------------------------------------------------------XXX--------------------
--------------------------------------------------------------------------------------------------------------------XX--X-------------------
--------------------------XXXX------------------------------------------------------------------XXXX------XXXX-----XX----X--oo----------XXXX
---------------------------[]---------XXXXX----------------------------------------------------XX<>-X----XX--XXX--XX------X-ooXXX------XX---
---------------------------[]-------XXX----X-------------X-----------------------ooo----------XX-[]--X--XX------XXX--------XXXX--X----XX----
---------------------------<>------XX<>-----X------------------------------------ooo---------XXXX[]X--XXX-------XXX--------XXXX---X--XX-----
----------------------------------XXX[]------X----------------------------------------------XX---------X---------------------------XXX------
----------------------------E-----XXX[]-------X-----------XXXXXX-----oooo--------XXXX------XX--------XXX---------------------------XXX------
--------------------------------XXXXX[]--------X--XXX---XXX--X--X----oooo-------XX---XXXXXXX------------------------------------------------
------------XXXX----------XXXX-XX<>XX[]---------XXXS-X-XXXX--X---X------------EXX---XXXXXXEXX-----------------------------------------------
-----------XX---XX-------XX---XXX[]XX[]----------X----XXXXX--X----XXXXXXXXXXXXXX----X--------------------------------E-----E----------------
-XXXXXX---XX---<>-X-----XX---<>XX[]XX[]----------SS-SSXXXXX--X----XXXXXXXXXXXXXX----X-------------------------------<>----<>----------------
XXE----X-XX----[]--XXXXXX----[]XX[]XX[]--------X-SS-SSXXXXX--X----X------------X----X---------------------XXX-------[]----[]----------------
X<>-----XX-----XXXXXXXXXX----[]XXXXXXXXXXXXXXXXXXXXXX-XXXXX--X----X------------X----X------------------------------X[]X--X[]XXXXX-------XXEX