--------------------------------------------------------------------------------------------------------------------------------------------
--------------------------------------------------------------------------------------------------------------------------------------------
----------------------------------------------------------------------------------------------------XXX-------------------------------------
----------------------------------------------------------------------------------------------------[]---------XXXXX------------------------
---------------------------------------------------------------------------------SSS---SSSS---------[]-------XXX----X-----------------------
------------XXXX------------------XX--------------------------QQQ?QQQQQQQQX-------------------------<>------XX<]-----X----------------------
------------X<>-X-----------------[]--------------------------------------X--------------------------------XXX[]------X---------------------
------------X[]--X----------------[]--------------------------------------X------X-------------------E-----XXX[]-------X-----------XXXXXX---
------E----XX[]---X----XXXX-------[]--------------------------------------X------XEE------X--------------XXXXX[]--------X--XXX---XXX--X--X--
----------XXS[]----X--XX---XX-----<>SSSSSS----------------------SSSSSSSSSSX------XSSSSSSSSX--------XXXX-XX<>XX[]---------XXXS-X-XXXX--X---X-
--oo-----XX--[]-----XXX----X-X--------------------------------------------------------------------XX---XXX[]XX[]----------X----XXXXX--X----X
--oo----XX---[]------X-----XX-XX---EXXX------------------------E---E------E---------------XXXXX--XX---<>XX[]XX[]----------SS-SSXXXXX--X----X
XXXXXXXXX----[]------B-----XXXX-XXXXXE-XXXXXXXXXXXXXXXXXXXXXXXXXXXXXXXXXXXXXXXXXXXXXXXXXXXX----XXX----[]XX[]XX[]--------X-SS-SSXXXXX--X----X
XXXXXXXXXXXXXXXXXXXXXX-----XXXXXXXXX<>XXXXXXXXXXXXXXXXXXXXXXXXXXXXXXXXXXXXXXXXXXXXXXXXXXXXX----XXX----[]XXXXXXXXXXXXXXXXXXXXXX-XXXXX--X----X