------------------------------------------------------------------------XXX-----------------------------------------------------------------
XXX---------------------------------------------------------------------X--X-------------------------------------------------XXXXXXXXXXXXXXX
SS-X-SSSSSSSSSSSSSS---[]SSSSSSSSSSSSSSSSSS----------------------------------X---SSSSSSSSSSSSSSSSSSSSSSSSSSSSSSSSSSSS--------XXSSSSSSSSSSSSSS
----X-----------------[]SSSSSSSSSSSSSSSSSS-------------------XXXXXXXXXXX-----X--SSSSSSSSSSSSSSSSSSSSSSSSSSS----------------XX---------------
-----X----------------[]SSSSSSSSSSSSSSSSSS------------------XX----------------X-SSSSSSSSSSSSSSSSSSSSSSSSSSS-----------XXX-XX----------------
------X---------------[]SSSSSSSSSSSSSSSSSS-----------------XXX-----------------XSSSSSSSSSSSSSSSSSSSSSSSSSSS--QQ------XXXX-XSSS-----------E--
-------X--------------[]SSSSSSSSSSSSSSSSSS----------------XXXX------------------X-----------------------------------XX---XX-------------<>--
--------X-------------[]SSSSSSSSSSSSSSSSSS---------------XXXXX-------------------X----XXX-----------------XXX-XXX--XX-----XS------------[]--
---------X-------------]SSSSSSSSSSSSSSSSSS--------------XXXXXX-------------------oXXXXX?-XXXXXXXXXXXXXXXXXX--XX--XXX------S-S-----------[]--
-----E----XXXXXXXXXXXX-]SSSSSSSSSSSSSSSSSS--------E----XXXXXXX------------------S?SSSSS??SSSSSSSSSSSSSSSSSS--QQ--QQQ---------S-----E--SS[]S-
E---<>-----SSSSSSSSSSSSSSSSSSSSSSSSSSSSSSS---E---<>---XXXXXXXX----<>------------SSSSSS---SSSSSSSSSSSSSSSSSS-----------------------<>----[]--
>---[]-----SSSSS-SSSSSSSSSSSSSSSSSSSSSSSSS--<>---[]--XXXXXXXXX----[]------------SSSSSS---SSSSSSSSSSSSSSSSSS-----------------------[]----[]--
]---[]-------------------SSSSSSSSSSSSSSSSS--[]---[]-XXXXXXXXXX----[]------------------oooSSSSSSSSSSSSSSSSSS-----------------------[]-E--[]--
XXXXXXXXXXXXX-XX-XX-X-XXXXXXXXXXXXXXXXXXXX--XX---XXXXXXXXXXXXXXXXXXXXXXXX-----XXXXXXXXXXXXXXXXXXXXXXXXXXXXXXXXXXXXXX------XXXXXXXXXXXXXXXXXX