--------------------------------------------------------------------------------------------------------------------------------------------
--------------------------------------------------------------------------------------------------------------------------------------------
----------------------------SSSSSS------------SSSSSSSSSSSSSSSSSSSSSSSSSSSSSSSSSSSSSSSSSSSSSSSSSSS?SSSSSSSSSSSSSSSSSSSSSSSSSSSSSSSSSSS----[]S
--------------------------------------------------------------SS--SSSSSS--SSSS------SSSS-------------------------------------------------[]S
--------------------------------------------------------------SS--SSSSSS--SSSS--E---SSSS-------------------------------------------------[]S
-------------------------------------------------oooo-------SS--------SS---S----SS----------oooooo---------------------------------------[]S
-----------------------------E------------------------------SS--------SS---S----SS-------------------------------XX----------------------[]S
-----------------------------------------------S-SSSS-S-----SS--------SS---S----SS----------SSSSSS--------------XX-X-XXX-----------------[]S
B----------------B-----------XX-----XXX--------SoS--SoS-----SS----ooooSS---So??-SS---E------SSSSSS-------------XX---XX--X-----------------]S
XXXXXXXXXXXXXXXXXXXXX-------XX-XXXXXX--X-------SSS--SSS-----SSSS--SSSSSS---SSS--SS--SSSS---------------------XXX----<>---X------XXXXXXXXX-]S
XXXXXXXXXXXXXXXXXXXX-X-----XX--XXXXXX---X---------------------SS-------------------EE-----------------------XX<>----[]----XXX--XXSSSSSSSSSSS
XXX----------------X--XXXXXX-------------XX-------------------SS-----------------------XXXXX---------------XX-[]----[]----<>-XXX-SSSSSSSSSSS
XXX----------------X--XXXXXX------------XX-XXXXXXXXXXXXXXXXXXXXXXXXXXXXXXXXXXXXXXXXXXXXX----XXXXXXXXXXXXXXXX--[]----[]--E-[]--X--SSSSSSSSSSS
XXX----------------X--------------------XXXXXXXXXXXXXXXXXXXXXXXXXXXXXXXXXXXXXXXXXXXXXXXX---XXXXXXXXXXXXXXXXXXXXXXXXXXXXXXXXXXXX--XXXXXXXXXXX