S-------------------------------------------------------------------------------------------------------------------------------------------
S-------------------------------------------------------------------------------------------------------------------------------------------
-SSSSSSSSSSSSSS--------------SSS------]SSSSSSSSSSSSSSS--------------------------------------------------------------------------------------
--------------------------------------]SSSSSSSSSSSSSSS--------------------------------------------------------------------------------------
--------------------------------------]SSSSSSSSSSSSSSS----------------------------------------------------------------------------------X---
X---------------XX--XXXXXX------------]SSSSSSSSSSSSSSS----------------------------------------------------------------------------------XXXX
-X-------------XX-XXX-----X-----------]SSSSSSSSSSSSSSS------S-------------X---EX--------------------------------------------------------X<>-
--X-----------XX--XXX------X----------]SSSSSSSSSSSSSSS---------------X----X----X--------------------------------------------------------X[]-
---X------XXXXX-------------X-----X----SSSSSSSSSSSSSSS---------------X--X-X----X--------X-EE----X-------------ooo-----------------E----XX[]-
-S?-X----XX-XXX--------------XXXXX-XXX-SSSSSSSSSSSSSSS----------SSS--XSSX-XSSS?X--------XSSSSSSSX-------------ooo---------------------XXS[]-
-SS--X--XX-----------SSSS-S--SSSSSSSSSSSSSSSSSSSSSSSSS----------SS------------------------------------------------------------oo-----XX--[]-
-SS---XXX------------SSSS-S--SSSSSSSSSSSSSSSSSSSSSSSSS--<>------SS------------------XXX---------------------------------------oo----XX---[]-
XSSE---XX------------SSSS-S--SSSSSSSSSSSSSSSSSSSSSSSSS--[]----XXXXXXXXXXXXXXXXXXXXXXX--XXXXXXXXXXXXXXXXXXXXXXXXXXXXXXXXXXXXXXXXXXXXXX----[]-
XSX-XXXXX---------XXXSSSS-S--XXXXXXXXXXXXXXXXXXXXXXXXX--XX---XXXXXXXXXXXXXXXXXXXXXXXX--XXXXXXXXXXXXEEXEXXXXXXXXXXXXEEXEXXXXXXXXXXXXXXXXXXXXX