--------------------------------------------------------------------------------------------------------------------------------------------
--------------------------------------------------------------------------------------------------------------------------------------------
SSSSSSSSSSSSSSS-----------------------------------------------------------------------------------------------------------------------------
--------------------------------------------------------------------------------------------------------------------------------------------
-----------------XXX------------------XXXXX-o-o---------ooo---------------------------------------------------------------------------------
-------------------------------------XX-XX-Xo-o---------XXX------------------------------------------SS---SS-------------SSS-----E----------
------------------------------------XX------X----------------------------SSSSSSSSSSSSSSSS---------------------------------------<>----------
-----------------------------------XX--------X----------------------------------------------------------------------------------[]------XXXX
------------XXXXX--------------XXXXX----------XX---------------XXX--------------------XXXX---------SS--------------XXXXX--------[]----XXX---
XX---------XXXXX-XXXX-XXXXX---XX-XXX---------XX-X-------------XX--X-----------SSSSSS-XX--XXX-XXX---------SSS---XXXXX-XX-XSSS----XXX--XX<>---
S-X-------XXEXXX-XXX-XX----X-XX------------------X-----------XX----X----------------XX------XX--XXX-----------XXXX<>-XX--X----------XX-[]---
S--X-----XXXXXXX-----<>-----XX--------------------X---------XX---------------------XX-------<>--<>-X-XXXXX---XXXXX[]-XXX--X--------XX--[]---
----XXXXXXXXXXXX-----[]-----<>---------------------XXXXXXXXXX------XXXXXXXXXXXXXXXXX--------[]--[]--XX----XXXXXXXX[]-XXX---XXXXXXXXX---[]---
X--XXXXXXXXXXXX------[]-----[]--------------------XXXXXXXXXXX------XXXXXXXXXXXXXXXXX------XXXXXXXXXXXX-X-XXXXXXXX-XXXXXXXXXXXXXXXXXXXXXXXXXX