--------------------------------------------------------------------------------------------------------------------------------------------
--------------------------------------------------------------------------------------------------------------------------------------------
--------------------------------------------------------------------------------------------------------------------------------------------
---------------------------------------------------oo---------------------XXX---------------------------------------------------------------
------------------------------------------------------------------------XXX--X------------------------XXXXXXX-------------------------------
-----------------XXX-----oo--XXXX-------XXXXXX-------------------------XXXX---X----------------------XX-SSSS-X------------------------------
------------------------XX-----------XXXX-XXX-X-XXXXX------XX---------XX-XX----X--------------------XX--------X-----------------------------
----------------------------XXXXX---XXXXX-oo---XX----X---------------XXXXXX-----X------------------XX----------X----------------------------
oXXXXXXXXXX---------------XXX----XXXX---------XXX-----XXXX----------XX-XXXX------X----------------XXX-----------X--------XXXX---------------
XX--XXXXXX-X-------------XXXX---XXXXX-----------------XXX-X--------XXXXXXXX-------X--------S?S---XXEX---S-----X--X------XX<>-X--------------
X-----------X-----------XX---------------------------------X------XX-XXXXXX--------X------------XXXXX---------X---X----XX-[]--X----QQQQQ--?-
-------------X-XXXXX---XX-----------------------------------X----XX--XXXXXX---------X----------XXXXXX---------XX---X--XX--[]---X------------
--------------XX----XXXX-------------------------------------XXXXX---XXXXXX--------X-XXXXXXXXXXXXXXXX----EE---XX---EXXX---[]----XXXXXXXXXXXX
XXXX------XXXXXX----XXXX-----XXXX---------------------------XXXXXXXXXXXXXXXXXXXXXXXXXXXXXXXXXXXXXXXXXXXXXXXXXXXXXXXXXXXXXXXXXXXXXXXXXXXXXXXX