----------------------------------------------------------------XXX--------XXX---------XXXX-------------------------------------------------
---------------------------------------------------------------XX--X------XX--X-------XX---X------------------------------------------------
--------------------------------------------------------------XX----X----XX----X-----XX-----X-----------------------------------------------
-------------------------------------------------------------XX------X--XX------X---XX-------X-XXX------------------------------------------
-----------------------------------------------------------XXX--------XXX--------XXXX---------XX--X-----------------------------------------
----------------------------------------------------------XXXX--------XXX--------XXXX---------XX---X-----------------XXXX-------------------
---------------------------------------------------------XXXXX--------XXX--------XXXX---------XX----X---------------------------------------
--------------------------------------------------------XXXXXX--------XXX--------XXXX---------XX-----X--------------------------------------
-------------------------------------------------------XXXXXXX--------XXX--------XXXX---------XX------X-------------------------------------
--------XX--------------------------------------------XXXXXXXXS-------XXX--------XXXX---------XX-------X------------------------------------
XX-----XB-X---------------E--------------------------XXXXXXXXX--------XXX--------XXXX---------XX--------X-----XXX---------------------------
>-X---XXb--X-----------------------XXXXXX-----------XXXXXXXXXX--------XXX--------XXXX---------XX---------X---XXB-X----------XXX-XXX-----EXXX
]--XXXX-BEE-XXXXXXXXXXXXXXXXXXXXXXXXE-EE-XXXXXXXXXXXXXXXXXXXXX--------XXX--------XXXX---------XX----------XXXX-b--XXXXXXXXXXX--XX--XXXXXXX--
XX-XXXXXXXXXXXXXXXXXXXXXXXXXXXXXXXXXXXXXXXXXXXXXXXXXXXXXXXXXXXXX------XXX--------XXXX---------XXXXXXXXX---XXXXXXXXXXXXXXXXXXX--XX--XXXXXXX--