--------------------------------------------------------------------------------------------------------------------------------------------
-XXXX---------------------------------------------------------------------------------------------------------------------------------------
-XX--X-XXX---SSSSSSSSSSSSSSSS-------------SSS--[]SSSSSSSSSSSSSSSSS-------------------------------S---------------------------------------SSS
XX----XX--X--SSSS------------------------------[]SSSSSSSSSSSSSSSSS-------------------XXXXXXXXXX--S-----------------------------------------[
X----------X-SSSS------------------------------[]SSSSSSSSSSSSSSSSS------------------XX-----------S-----------------XXXX--------------------[
X-----------XSSSS-------------XX--XXXXX--------[]SSSSSSSSSSSSSSSSS-----------------XXX-----------S--------------XXXX---X------XX-----------[
X------E-----X---------------XX-XXX----X-------[]SSSSSSSSSSSSSSSSS----------------XXXX-----------S-------------XXXXX----X----XX-X----------<
S-----<>------X-------------XX--XXX-----X------[]SSSSSSSSSSSSSSSSS---------------XXXXX-----------S------------XX---------X--XX---X----------
------[]------oXXX------XXXXX------------X------]SSSSSSSSSSSSSSSSS--------------XXXXXX-----------S--------XXXXX-----------XXX-----X---------
------X]-----S?SS-X----XX-XXX-------------XXXXX-]SSSSSSSSSSSSSSSSS--------E----XXXXXXX-----------S-------XX-XXX-----------XXX------X--------
-------]-----SSS---X--XX-----------SSS-S--S-SSSSSSSSSSSSSSSSSSSSSS---E---<>---XXXXXXXX----<>-----S------XX-------------XXX----------X-------
-------]-----SS-----XXX------------SSS-S--S-SSSSSSSSSSSSSSSSSSSSSS--<>---[]--XXXXXXXXX----[]-----S-----XX----------------------------X----XX
-------]-------E-EE--XX------------SSS-S--S-SSSSSSSSSSSSSSSSSSSSSS--[]---[]-XXXXXXXXXX----[]-----SXXXXXX----------------------------X-XXXXX-
XXXXXXXXXXXXXXX-XXXXXXX---------XXXSSS-S--X-XXXXXXXXXXXXXXXXXXXXXX--XX---XXXXXXXXXXXXXXXXXXXXXXXXXXXXXXX------------------------XXXXXXXXXXX-