--------------------------------------------------------------------------------------------------------------------------------------------
--------------------------------------------------------------------------------------------------------------------------------------------
--------------------------------------------------------------------------------------------------------------------------------------------
--------------------------------------------------------------------------------------------------------------------------------------------
--------------------------------------------------------------------------XXXX--------------------XXX--------oo-----------------------------
----------------------------------------------QQQQ-----------------------XXXX-X------------------XX--X--------------------------------------
---oooo----------oooo------------oooo-----------------------------------XXXXX--X----------------XX----X-------------------------------------
-----------------------------------------------------------------------XXXXXX---X--------------XX------X------------------------------------
-------------XXXX------------XXXX-------------------------------------XXXXXXX----X-------o---XXX--o-----XXX--------------------------------X
XXX---------XX<>-X----------XX<>-X----------QQ?SSQQQ-----------------XXXXXXXX-----XXX-------XX<>--------<>-X------------------------------XX
XX-X-------XX-[]--X--------XX-[]--X------------------------XXXX-----XXXXXXXXX-----<>-X-----XX-[]--------[]--X-----XXXX-------------------XXX
-X--X-----XX--[]---X------XX--[]---X----------XXX---------XX<>-X---XXXXXXXXXX-----[]--X---XX--[]--------[]---X---XX<>-X-----------------XXXX
-X---XXXXXX---[]----XXXXXXX---[]----XXXXXXXXXXX--XXXXXXXXXX-[]--XXXXXXXXXXXXX-----[]---XXXX---[]--------[]-E-EXXXX-[]-EXXXXXXXXXXXXXXXXXXXXX
XXXXXXXXXXXXXXXXXXXXXXXXXXXXXXXXXXXXXXXXXXXXXXX--XXXXXXXXXXXXXXXXXXXXXXXXXXXXXXXXXXXXXXXXXXXXXXXXXXXXXXXXXXXXXXXXXXXXXXXXXXXXXXXXXXXXXXXXXXX