--------------------------------------------------------------------------------------------------------------------------------------------
--------------------------------------------------------------------------------------------------------------------------------------------
------------XXXX--------------------------------------------------------------------------------------SSSSSSSSSSSSSSSSSSSSSSSSSSSSSSSSSSSSSS
-------------[]---------XXXXX--------------------------------------------------------------------------[]----[]-----------------------------
-------------[]-------XXX----X-------------------------------------------------XXXX--------------------[]----[]--------E---------X------XXX-
-------------<>------XX<>-----X----------------------------------E------------XXXX-X-------------------[]----[]---QQQQQQQ--------XXXXXXXX--X
--------------------XXX[]------X--------------------------------->-----------XXXXX--X------------------[]----[]-----------------XXSSSSSSS---
--------------E-----XXX[]-------X-----------XXXXXX-----oooo------]-------XXXXXXXXX---X-----------------[]----[]----------------XX-SSSSSSS--S
------------------XXXXX[]--------X--XXX---XXX--X--X----oooo------]------XX--XXXXXX----X----------------[]----[]--XXXXXXXXXXXXXXX--SSSSSSS--S
X-----------XXXX-XX<>XX[]---------XXXS-X-XXXX--X---X-------------]-----XX---XXXXXX-----X---------------<]----[]-XXSSSSSSSSSSSSSS--SSSSSSS--S
-XX--------XX---XXX[]XX[]----------X----XXXXX--X----XXXXXXXXXXXXXXXXXXXX----XXXXXX------X--------------->----<>XX-SSSSSSSSSSSSSS------------
<>-X------XX---<>XX[]XX[]----------SS-SSXXXXX--X----XXXXXXXXXXXXXXXXXXXX----XXXXXX-------XX-------XXX--XXX----XX--SSSSSSSSSSSSSS---------<>-
[]--XXXXXXX----[]XX[]XX[]--------X-SS-SSXXXXX--X----X-----------------------XXXXXX-------X-XXXXXXXX--XXXE-XXXXX---SSSSSSSSSSSSSS---------[]-
XXXXXXXXXXX----[]XXXXXXXXXXXXXXXXXXXXXX-XXXXX--X----X-----------------------XXXXXXXXXXXXXXXXXXXXXXX--XXXX-XXXXX---XXXXXXXXXXXXXXXXXXXXXXXXXX