--------------------------------------------------------------------------------------------------------------------------------------------
-----------------------------------------------------------------------------XX-------------------------------------------------------------
----------------------------------------------------------------------------XX-XXX----------------------------------------------------------
---------------------------------------------------------------------------XX--XX-X---------------------------------------------------------
-------------XXXXXX-------------------------------------------------------XX---XX--X--------------------------------------------------------
------------XX?SSS-X---------------------------------SSSSS---?-------XXX--XS---XX---X--------------------------------SSSSSSS---------------E
------------X-------X-----------------------------------------------XX--X-X----XX----X--------------------------------------------------E---
-------XXXXXX-------EX---------------------------------------------XX----XX----XX-----X---------------------------------------------XXXXXXXX
------XX---XE------<>-X-------------------------------------------XX------X----XX------X------------------B-----------E--E---------XXXSSSSSS
-XXX-XX----<>---E--[]--X------------------XXX-----S---E---------XXX-------SS---XX-------X---------B-------b----------SSSSSSS------XXXX------
XX--XX-----[]--<>--[]---X----------------XXX-X-------------E---XX<>------------XX--------X--------b--?-B------?QQ----------------XXXXX----oo
<>--<>-----[]--[]--[]----X-XXXXX-------EXX-X--X---------------XX-[]------------XX---------X-------B----b----------------XXX-----XXXXXX------
[]--[]--E--[]--[]--[]-----XX----XXXXXXXXX--X---XXXXXXXXXXXXXXXX--[]-E----------XX--------X-XXXXXXXXXXXXXXXXXXXXXXXXXXXXXX--XXXXXXXXXXX----oo
XXXXXXXXXXXXXXXXXXXXXXXXXXXX---XXXXXXXXXX--XXXXXXXXXXXXXXXXXXXXXXXXXXXXXXXXXXXXXXXXXXXXXXXXXXXXXXXXXXXXXXXXXXXXXXXXXXXXXX--XXXXXXXXXXXXXXXXX