--------------------------------------------------------------------------------------------------------------------------------------------
--------------------------------------------------------------------------------------------------------------------------------------------
-----------------------------------------------------------------------------[]SSSSSSSSSSSSSSSS---------------------------------------------
-----------------------------------------------------------------------------[]SSSSSSSSSSSSSSSS--------------------------E------------------
-----------------------------------------------------------------------------[]SSSSSSSSSSSSSSSS---------------------------------------------
------------------------------SSSSSSS---------------E------E-----------------[]SSSSSSSSSSSSSSSS--------------------XXXXXEXXXXX--------------
-------------------------------------------------E---------------------------[]SSSSSSSSSSSSSSSS---------------------------------------------
---------------------------------------------XXXXXXXXXXXXXXX-----------------[]SSSSSSSSSSSSSSSS---------------------XXXXX-------------------
-------------------------------E--E---------XXXSSSSSSSSSSSS-X-----------------]SSSSSSSSSSSSSSSS----------------XXXXXX----XXXXXXXX-----------
------------------------------SSSSSSS------XXXX--------------X--------QQ-XXXX-]SSSSSSSSSSSSSSSS---------------XXXXXXXEXEEXXXXXXX-X----------
Q?-------------------Q?QQQ----------------XXXXX----oooooo-----X---------XXSSSSSSSSSSSSSSSSSSSSS-------------XXX-------------------X---------
X-----XXX------------------------XXX-----XXXXXX----------------XXXX----XX-SSSSSSSSSSSSSSSSSSSSS------------XXXXX-------------------X----XXXX
-XXXXXXE-XXXXXXXXXXXXXXXXXXXXXXXXX--XXXXXXXXXXX----oooooo-------X--XXXXX--SSSSSSSSSSSSSSSSSSSSS--<>----XXXXX------------------------XXXXX--X
XXXXXXXXXXXXXXXXXXXXXXXXXXXXXXXXXX--XXXXXXXXXXXXXXXXXXXXXXX-----X--XXXXX--XXXXXXXXXXXXXXXXXXXXX--[]----XXXXXXXXX---------------XXXXXXXXXXEEX