--------------------------------------------------------------------------------------------------------------------------------------------
--------------------------------------------------------------------------------------------------------------------------------------------
------------------------------------------------------------------------------------------XXX-----XXXX-----XX-------------------------------
-----------------------------------------------------------------------------------------XX--X---XX---X-?-XX-X------XXX----XXX--------------
----XXXXXXXXXXX----------E-E------------------XXXXX-------------------------------XXX---XX----X-XX-----X-XX---X-XXXXX--XXXXX--X-------------
---XX--QQQ?QQQ-X-------SSSSSSS-SS-XXXX-----XXXX--X-X-----------------------------XX--X-XX------XX-------XX-----XX--XX--XXXXX---X------------
--XX------------X-------------E--XX---X---XX--E--X--X---------------------------XX-E--XX-------XX-------XX-----XX---------------X-----E-----
-XX------E-------X--------------XX-----X-XX---XX-X---X-------------------------XX-----XX-----------------------------------------X-XXXXX----
XX-----SSSSSSS----X-----------XXX-------XX----XX-X----X------------------XXXXXXX--------------------------------------------------XX----X---
<>--------------E--X---------XX<>-------<>----XX-X-----X----------------XX-XXXXX-------o------------------------------------------XX-----X--
[]-------X------X---X---E---XX-[]-------[]----XX-X------X--------------XX--------------o--XX----------------------------------------------XE
[]-------X------X----X-----XX--[]-------[]----XX-X-------S-----SS-----XX-------------------------------------------------------------------X
[]----E--X------X-----XXXXXX---[]-------[]----XX-X-------XXXXXXXXXXXXXX---------------------------------------------------------------------
XXXXXXXXXXXXXXXXXXXXXXXXXXXXXXXXX-------XX-XXXXX-XXXXXXXXXXXXXXXXXXXXXX------------------------------------------------XXXXXXXX------------X