--------------------------------------------------------------------------------------------------------------------------------------------
---------------------------------XXX--------------------------------------------------------------------------------------------------------
--------------------------------XX--X-----XX------------------------------------------------------------------------------------------------
-----------------------XXXXX---XX----X---XX-X------XXX--------------------------------------------------------------------------------------
----------------------XX----X-XX------X-XX---X-XXXXX--X-------------------------------------------------------------------------------------
---------------------XX?-----XX--------XX-----XX--XX---X-----------------------------------------------------------------------------------X
oo-------------------X-------<>--------XX-----XX--------X---------------------------------------------------------------------------------XX
----------------XXXXXX-------[]--------------------------X-------------------------------------------------------------------------------XXX
---------------XX---XE-------[]---------------------------X---------------------------S----------------XXXX-------------------------XX--XXXX
--------------XX----<>---E---[]----------------------------X---------------------------------XXX------XX<>-X-----------------XXXX--XX-XXXXXX
------------XXX-----[]--<>---[]-----------------------------X---------------XXXX-----XXX----XXX-X----XX-[]--X----QQQQQ?-----XX---XXX---X-XXX
-----------XX<>-----[]--[]---[]------------------------------X-------------XX<>-X---XXS-X--XX-X--X--XX--[]---X-------------XX-----X----XXXXX
XXXXXXXXXXXX-[]--E--[]--[]---[]------------------------------XXXXXXXXXXXXXXX-[]--XXXX-S--XXX--X---XXX---[]----XXXXXXXXXXXXXXX-----X----XXXXX
XXXXXXXXXXXXXXXXXXXXXXXXXXXXXXXXXXXXX-----------------------XXXXXXXXXXXXXXXXXXXXXX<>XXXXXXXXXXXXXXXXXXXXXXXXXXXXXXXXXXXXXXXXX-----X----XXXXX