--------------------------------------------------------------------------------------------------------------------------------------------
--------------------------------------------------------------------------------------------------------------------------------------------
--------------------------XXXXX--XXX-------------------SS-------------------XXXX------------------------------------------------------------
-----------------------XXXX----XXX--X------------------[]--------------------[]-------------------------------------------------------------
---------------------EXXXXX----XXX---X--E--------------[]--------------------[]-------------------------------------------------------------
------------------XXXXX---------------X----------------<>--------------------[]---------------------------------------------------XXXX--SS--
-----------------XX--X-----------------X-------------------------------------[]------------------------------------------XXXX----XX---X----X
XXXX----oooo----XX---X------------------X---------------E--------------------[]-----------------------------------------XX---X--XX-----X--XX
-X--X---oooo-XXXX------------------------X-----------XXXX--------------------[]------XXX------------------------XXXX---XX-----XXX------oXXX-
-X---X------XXXXX-------------------------X---------XX<>-X-QQQQQQ?QQQQQQQ?Q--<>-----XXX-X-------------------XXXXX---X-XX------XXX------XXXX-
-X----XXXXXXX--------------------------------------XX-[]--X------------------------XX-X--X-----------------XX-XXX----XX------E--------------
XX----XXXXXXX-----------------------------X-------XX--[]---X----------------------XX--X---X-----XX--------XX--XX---SXXX-----<>--------------
XX----X-----------------------------------XXXXXXXXX---[]----XXXXXXXXXXXXXXXXXXXXXXX--EX----XXXXXXXXXXXXXXXXX----------------[]--------------
X-----X-----------------------------------XXXXXXXXXXXXXXXXXXXXXXXEEXXXXXEXEXXXXXXXXXXXX----XXXXXXXXXXXXXXXXX----------------[]--------------