--------------------------------------------------------------------------------------------------------------------------------------------
--------------------------------------------------------------------------------------------------------------------------------------------
----------------------------------------------------------------------------------------oo------XXX-----------------------------------------
------------------------------------------------------------------------------------------XXXXXXX--X----------------------------------------
-----------------------------------------------------------------------------Eooo--------XXXXXXXX---X---------ooooo----------E------XXX-----
---------------------------------------------XX------------------------------XXXXX------XX-----------X--------XXXXX----------XXXXXXXX--Xoo-X
-------------E-------------------------------XX----------------------------------------XX-----------ooX---------------------XX-XXXXXX---X-XX
------------<>---------------------------XXX-XX-----------------------------------XXXXXX---------------X-------------------XX------------XX-
--XXXXXX----[]--------------------------XXXX-XX---------------------------XXXXXXXXX---XXXXX-------------X---------------XXXX-------------XX-
-XXXSSS-X---XX-------------------------XXXX--XX--------------------------XXXXXXXXXX----------------------XXXX----------XXXXX----------------
XX-X-----X--------XXXX----------E----EXXXXX-XXX-------------------------XX-------------------------------XXXX?--------XX--------------------
X--X------X----B-XX<>-X---B----------XXXXXX--X---------XXX--------XXXXXXX-----------o------------------------X----XXXXX---------------------
--EX-------XXXXXXX-[]--XXXXXXXXXXXXXXXXXXXX---XXXXXXXXXXX-XXXXXXXXX--XXXX----------XXX------------------------XXXXX--X----------------------
XXXXXXXX---XXXXXXXXXXXXXXXXXXXXXXXXXXXXXXXXXXXXXXXXXXXXXXXXXXXXXXXX---------------------------------XXXX-----XXXXXX-XXXXX-------------------