--------------------------------------------------------------------------------------------------------------------------------------------
--------------------------------------------------------------------------------------------------------------------------------------------
--------------------------------------------------------------------------------------------------------------------------------------------
--------------------------------------------------------------------------------------------------------------------------------------------
--------------------------------------------------------------------------------------------------------------------------------------------
----------------------------------------------------------------------XXX-------------------XXXX--------------------------------------------
--XX-----------------------------------------------------------------XXX-X------------------------------------------------------------------
-XX-X---------------------------------------------------------------XXXX--X-----------------------------------------------------------------
XX---X-----------------------------------------XX------------------XXXXX---X----------------------------------------------------------------
X-----XXX-------------------------------XXXX--XX-X----------------XXXXXX----X----------------------------------------------XXX--------------
>-----<>-X--E------------------oooo----XX---XXX---X--------------XXXXXXX-----X------XXX-----------------------------------XXX-X-------------
]-----[]--X---------------------------XX-----X-----XX-----------XXXXXXXX------X----XXB-X------------XXX-XXX------------B-XX-X--X------------
]-----[]---XXXXXXXXXXXXXXXXXXXXXXXXXXXXX-----X-----X-XXXXXXXXXXXXXXXXXXX-------XXXXX-b--XXXXXXXXXXXXX--XX--XXXXXXXXXXXXXXX--X---XXXXXXXXXXXX
XXXX--XXXXXXXXXXXXXXXXXXXXXXXXXXXXXXXXXX-----X-----XXXXXXXXXXXXXXXXXXXXXXXXXXXXXXXXXXXXXXXXXXXXXXXXXX--XX--XXXXXXXXXXXXXXX--XXXXXXXXXXXXXXXX