--------------------------------------------------------------------------------------------------------------------------------------------
--------------------------------------------------------------------------------------------------------------------------------------------
---------------------------------------------------------------SSSSSSSSSSSSSSSSSSSSSSSSSSSSSSSSSSSSSSSSSSSSSSSSSSSSSSSSSSSSSSSSSSSSSSSSSSSSS
--------------------------------------------------------------------------------------------------------------------------------------------
----------------------------------------------XXXXX-----------------------------------------------------------------------------------------
---------------------------------------------XXXX--X------------------------------------------------oooo------------------------------------
--------------------------------------------XXXXX---X------------------------------------o----------------------------XX--------------------
-----------XXX-----------------------------XXXXXX----X-------------------------------XXXXX--------S-SSSS-S-----------XX-X-XXX---------------
---------XXX--XX--------------------------XXXXXXX-----X--------------------------XXXXX--S-X-------SoS--SoS----------XX---XX--X--------------
X-------XXXX--X-X----------SSQS--------XXXXXXXXXX------X------------QQQQQQ-----XXXXXXX-----XX-----SSS--SSS--------XXX>---<>---X------XXXX---
-X-----XXXXX--XX-X---XXXX------------XXX--XXXXXXX-------X--------------------XXXXXXXXXXX--XX-XX------------------XX<>]---[]----XXX--XXSS-X--
o-X---XXXXXX--XXX-X-XX<>-X----------XX<>-XXXXXXXX--------XX----------------XXXXXXXXXXXXX--XXXX-X----------------XX-[]]---[]----<>-XXX-SS--X-
XX-XXXXXXXXX--XXXX-XX-[]--XXXXXXXXXXX-[]XXXXXXXXX--------X-XXXXXXXXXXXXXXXXXXXXXXXXXXXXXE-XXXX--XXXXXXXXXXXXXXXXX--[]]---[]--E-[]--X--SS---X
XXXXXXXXXXXX--XXXXXXXXXXXXXXXXXXXXXXXXXXXXXXXXXXXXXXXXXXXXXXXXXXXXXXXXXXXXXXXXXXXXXXXXXXXXXXXXXXXXXXXXXXXXXXXXXXXXXXXXXXXXXXXXXXXXXX--XX--XX