---------------------------------------------------------------------------------------------------------------XXX------------------XXX-----
--------------------------------------------------------------------------------------------------------------XX--X-------XXX------XX--X----
------------------------------------------XXX-----XXXX-----XX------------------------------------------------XX----X-----XX--X----XX----X---
-----------------------------------------XX--X---XX---X-?-XX-X------XXX----XXX------------------------------XX------X---XX----X--XX------X--
-----XXXXX------------------------XXX---XX----X-XX-----X-XX---X-XXXXX--XXXXX--X---------------------------XXXE-------X-XX------XXX--------XX
--XXXX--X-X----------------------XX--X-XX------XX-------XX-----XX--XX--XXXXX---X-------------------------XX-<>--------XX-------XXX--------XX
-XX--E--X--X--------------------XX-E--XX-------XX-------XX-----XX---------------X-----E-----------------XX--[]--------XX--------------------
XX---XX-X---X------------------XX-----XX-----------------------------------------X-XXXXX------------XXXXX---[]------------------------oo----
X----XX-X----X-----------XXXXXXX--------------------------------------------------XX----X--------XXXX--XE---[]------------------------SS----
>----XX-X-----X---------XX-XXXXX-------o------------------------------------------XX-----X------XXXXX--<>---[]------------------------------
]----XX-X------X-------XX--------------o--XX----------------------------------------------XE---XX------[]---[]------------------------------
]----XX-X-------S-----XX-------------------------------------------------------------------X--XX-------[]---[]------------------------------
]----XX-X-------XXXXXXX---------------------------------------------------------------------XXX--------[]---[]----------------o---o---------
X-XXXXX-XXXXXXXXXXXXXXX------------------------------------------------XXXXXXXX------------XXXXXXX-----[]---XX-XXX------------X---X---------