----------------XXXXXX----------------------------------------------------------------------------------------------------------------------
------XXX------XX----XXXXXXXXXXXXXXXXXXXXXXXXX---------------------------------------------------------------------------------------------X
-----XX--X----XX-------SSSSSSSSSSSSSSSSSSSSSSS-------------------------------------------------------------------------------------------XXX
----XX----X--XX---------------------------[]------------------------------------------------------------------------------------------XXXXSS
----X------XXX----------------------------[]------------------------------------------------------------------------------------------XSSS--
----X------XXX----------------------------[]------------------------------------------------------------------------------------------X-----
---XX---------------X---------------------[]----------X--EX--------------------------------------------------------------------------XX-----
--XXS-------------------------------------<>----------X---X-------------------------------------------------------XXXXX-------------XXS-----
XXX---------------------------------------------X---X-X---X--------X-EE---X----------X-E----X-------------------XXX--S-X------o---XXX-------
X<>--------------------------------<>-----------XSSSX-XSS?X--------XSSSSSSX----------XSSSSSSX------------------XX<>-----XX-------XX<>------X
-[]--------------------------------[]----S-S-S----------------------------------------------------------------XX-[]----<>-X-----XX-[]-----XX
-[]--------------------ooooooooo---[]----S-S-S-----------------XXX-------------------------------------------XX--[]----[]--X---XX--[]----XXX
-[]-------o------------ooooooooo---[]----S-S-SXXXXXXXXXXXXXXXXXX--XXXXXXXXXXXXXXXXXXXXXXXXXXXXXXXXXXXXXXXXXXXX---[]----[]---XXXX---[]---XXXX
XXXX------X------------XXXXXXXXX---[]----S-S-SXXXXXXXXXXXXXXXXXX--XXXXXXXXXXXEEXEXXXXXXXXXXXXXXXXXXXXXXXXXXXXXXXXXXXXXXXXXXXXXXXXXXXXXXXXXXX