--------------------------------------------------------------------------------------------------------------------------------------------
-----------------------------------------------------------------------------------------------XX-------------------------------------------
----------------------------------------------------------------------------------------------XX-X------------------------------------------
---------------------------------------------------------------------------------------------XX---X-----------------------------------------
-------------------------------XXXXXX-------------------------------------------------------XX-----X----------------------------------------
------------------------------XX?SSS-X---------------------------------SSSSS---?-------XXX--XS---XX-X-----------------------SSSSSSSS--------
------------------------------X-------X-----------------------------------------------XX--X-X----XX--X--------------------------------------
-------------------------XXXXXX-------EX---------------------------------------------XX----XX----XX---X-------------------------------------
---------XXXX-----------XX---XE------<>-X-------------------------------------------XX------X----XX----X---------------------E---E---------X
--------XX<>-X---------XX----<>---E--[]--X------------------XXX-----S---E---------XXX-------SS---XX-----X-----------XXXX---SSSSSSSSS------XX
-?-----XX-[]--X------XXX-----[]--<>--[]---X----------------XXX-X-------------E---XX<>------------XX------X---------XX<>-X----------------XXX
XXX---XX--[]---X----XX<>-----[]--[]--[]----X-XXXXX-------EXX-X--X---------------XX-[]------------XX-------X-------XX-[]--X------XXX-----XXXX
X--XXXXE--[]----XXXXX-[]--E--[]--[]--[]-----XX----XXXXXXXXX--X---XXXXXXXXXXXXXXXX--[]E-----------XX-------XXXXXXXXX--[]---XXXXXXX--XXXXXXXXX
X--XXXXXXXXXX---XXXXXXXXXXXXXXXXXXXXXXXXXXXXXX---XXXXXXXXXX--XXXXXXXXXXXXXXXXXXXXXXXXXXXXXXXXXXXXXXXXXXXXXXXXXXXXXXXXXXXXXXXXXXXX--XXXXXXXXX