--------------------------------------------------------------------------------------------------------------------------------------------
--------------------------------------------------------------------------------------------------------------------------------------------
--------------------------------------------------------------------------------------------------------------------------------------------
--------------------------------------------------------------------------------------------------------------------------------------------
--------------------------------------------------------------------------------------------------------------------------------------------
------------------------------------------------------EXX-----------------------------------------------------------------------------------
-----------------------------------------------------EXXX------------XXX--------------------------------------------------------------------
---------------------------------------E------------EXXXX-----------XXX-X-------------------------------------------------------------------
X-------oo------------------------------XXX------X--XXXXX----------XXXX--Xo------o----o-----------------------------------------------------
-X---------XXX-------------------------------------XXXXXX---------XXXXX---X---------------------XXX----------------------XXX----------------
--X-------XXX-X---XXXX----------------------------XXXXXXX--------XX-XXX----X-------------------XXX-X--------------------XXX-X---------------
X--X-----XX-X--X-XX<>-X--------------------------XXXXXXXX-------XXXXXXX-----X--XXXXXXXXX------XX-X--X----------------B-XX-X--X--------------
X---XXXXXX--X---XX-[]--XXXXXXXXXXXXXXXX---------XXXXXXXXX-------XX--XXX------XXX----X---XXXXXXX--X---XXXXXXXXXXXXXXXXXXX--X---XXXXXXXXXXXXXX
XXXXXXXXXXXXXXXXXXXXX--XXXXXXXXXXXXXXXX--------XXXXXXXXXXXXXXXXXXXXXXXXXXXXXXXXX---XX---XXXXXXXXXXXXXXXXXXXXXXXXXXXXXXXX--XXXXXXXXXXXXXXXXXX