--------------------------------------------------------------------------------------------------------------------------------------------
--------------------------------------------------------------------------------------------------------------------------------------------
--------------------------------------------------------------------------------------------------------------------------------------------
--------------------------------------------------------------------------------------------------------------------------------------------
------------------------------------------------------------------------------------------------------------------E-------------------------
----------------------------------------XXXXS-------SSS-------------------SSQSSS?SSS--------SSS------------------SQS--SQS-------------------
---------------------------------------XX--XXX---------------------------------------------------------XXXX-------------------------------XX
--------------------------------------XX------X-XXX---------------------------------------------------XXXX-X------------------------o-----XX
-E-----------------------------------XX----E-EEXX--XX--------------E------------------------SSS------XXXXX--X------------------------E----XX
<>------------------E--S------------XXX--------XX-XX-X------------<>------SSSSSSSSSSS---------------XXXXXX---X---SQS--S?S---------SSSSS--XXX
-------------------<>---------E----XXXXX-------XX-XX--X--------------------------------------------XXXXXXX----X----------------E--E-----XXXX
------XXXXX------------------<>---XXXXXX-------XX-XXX--X----------------------------------XXXXX---XXXXXXXX-----X----------------------EXX-XX
XXXXXXX----XXXXXXXXXXXXXXXXXXXXXXXXXXXX--------X--XXX--EXXXXXXXXXXXXXXXXXXXXXXXXXXXXXXXXXXX----XXXXXXXXXXX-----EXXXXXXXXXXXXXXXXXXXXXXXX--XX
XXXXXXX---XXXXXXXXXXXXXXXXXXXXXXXXXXXXX--------X--XXXXXXXXXXXXXXXXXXXXXXXXXXXXXXXXXXXXXXXXX----XXXXXXXXXX--XXXXXXXXXXXXXXXXXXXXXXXXXXXXXXXXX