--------------------------------------------------------------------------------------------------------------------------------------------
--------------------------------------------------------------------------------------------------------------------------------------------
--------------------------------------------------------------------SSSSSSSSSSSSSSSSSSSSSSSS----XXXXX--XXX------------------SS--------------
--------------------------------------------------------------------[]-----------------------XXXX----XXX--X-----------------[]--------------
------------------------E-------------------------------------------[]---------------------EXXXXX----XXX---X--E-------------[]--------------
----------------------SSSSSSSS---SSSQ--------------?-----------SS---[]-----------------XXXXXX---------------X---------------<>--------------
X--------------------------------------------------------------------------------XXXXXXX---X-----------------X------------------------------
---------------------E----------------------------------------------------------XX-SSSSS---X------------------X--------------E--------------
-XXX----S---------------------------------------------------------------------XXX--SSS-------------------------X----------XXXX-------------X
-<>-X--------------S?S--------------S-----SS----Q--Q--Q-----S----------------XX<>-------------------------------X--------XX<>-X-QQQQQQ?QQQQX
-[]--X----------------------------------------------------------------------XX-[]---------------------------------------XX-[]--X------------
-[]---X-----XXX------------XXXXX-----------------------------------------QSXX--[]-------------------------------X------XX--[]---X-----------
X[]----XXXXXX--XXXXXXXXXXXXX----XXXXXXXXXXXXXXXXXXXXXXXXXXXXXXXXXXXXXXXXXXXX---[]-------------------------------XXXXXXXX---[]----XXXXXXXXXXX
XXXXXXXXXXXXX--XXXXXXXXXXXXX---XXXXXXXXXXXXXXXXXXXXXXXXXXXXXXXXXXXXXXXXXXXXXXXXXXXXXXXXX------------------------XXXXXXXXXXXXXXXXXXXXXXSEXXXX