---------------------------------------------------------------XXXXXXXXXX-------------------------------------------------------------------
-------------------------------------------------------------------------X------------------------------------------------------------------
--SSSSSSSSSSSSSS-------------SSS--[]SSSSSSSSSSSSSSSSS---------------------X------------SSSSSSSSSSSSSSSSSSSSSSSSSSSSSSSSSSSSSSSSSSSSSSSSSSSSS
--SS------------------------------[]SSSSSSSSSSSSSSSSS-------------------X--X-------------[]----[]-------------------------------------------
--SS------------------------------[]SSSSSSSSSSSSSSSSS------------------XX---X------------[]----[]-------?----------------XXX----------------
--SS-------------XX--XXXXX--------[]SSSSSSSSSSSSSSSSS-----------------XXX----X-----------[]----[]---QQQQQQ---------XXXXXXX--X------------ooo
----------------XX-XXX----X-------[]SSSSSSSSSSSSSSSSS----------------XXXX-----X----------<>----[]-----------------XXSSSSSS---X--------------
---------------XX--XXX-----X------[]SSSSSSSSSSSSSSSSS---------------XXXXX------X---------------[]----------------XX-SSSSSS----X--------S-SSS
XXXXX------XXXXX------------X------]SSSSSSSSSSSSSSSSS--------------XXXXXX-------X--------------[]--XXXXXXXXXXXXXXX--SSSSSS-----X-------SoS--
??SS-X----XX-XXX-------------XXXXX-]SSSSSSSSSSSSSSSSS--------E----XXXXXXX--------X-------------[]-XXSSSSSSSSSSSSSS--SSSSSS------XXX----SSS--
SS----X--XX-----------SSS-S--SSSSSSSSSSSSSSSSSSSSSSSS---E---<>---XXXXXXXX---------X------------<>XX-SSSSSSSSSSSSSS------SS------<>-X--------
SS-----XXX------------SSS-S--SSSSSSSSSSSSSSSSSSSSSSSS--<>---[]--XXXXXXXXX----------X----XXX-----XX--SSSSSSSSSSSSSS------SS------[]--X-------
----EE--XX------------SSS-S--SSSSSSSSSSSSSSSSSSSSSSSS--[]---[]-XXXXXXXXXX---------X-XXXXX--XXXXXX---SSSSSSSSSSSSSS--------------[]---XXXXXXX
XXXXXXXXXX---------XXXSSS-S--XXXXXXXXXXXXXXXXXXXXXXXX--XX---XXXXXXXXXXXXX-XXXXXXXXXXXXXXX--XXXXXXE--XXXXXXXXXXXXXXXXXXXXXX---XXXXXXXXXXXXXXX