--------------------------------------------------------------------------------------------------------------------------------------------
-----------------------------------XX-------------------------------------------------------------------------------------------------------
----------------------------------XX-X------------------------------------------------------------------------------------------------------
---------------------------XX----XX---X----XXXXX--------------------------------------------------------------------------------------------
---------------------XX---XX-XXXXX-----XXXXX----X-----------------------------------------------------------------------------------XXXX----
--------------------XX-X-XX--SSSSS-----SSSSS-----XXXX-------------------------E--S---SSSSSSSSS--------------XXXXX------------------XXXX-X---
-------------------XX---XX------------------------X--X-----XXXX--------------<>----------------------------XX-<>-X----------------XXXXX--X--
---------XXXXXXXXXXX----<>-----------------------<>---X---XX---X-------------[]---------------------------XX--[]--X--------------XXXXXX---X-
-------XXX----X---<>----[]-----------------------[]----X-XX-----XXX----------[]------------XXX----------XXX---[]---X------------XX-XXXX----X
S-----XX<>---SS---[]----XXX----------------ES----[]-----XX------<>-XXXX-----SXXS----------XX>-X--------XX<>--QQQ?---X----------XX-XXXXX--S--
-----XX-[]--------[]----------E-----------<>---E-[]-----<>------[]--X--XXX------XXXX-----XX-]--X------XX-[]----------X-------XXX--XXXXX-----
----XX--[]--------[]---------<>-----<>----[]--<>-[]-----[]------[]-<>--<>-X----XX<>-X---XX--]---X----XX--[]-----------X-----XX<>--XXXXX-----
XXXXX---[]--------[]---------[]-----[]----[]--[]-[]-----[]------[]-[]--[]--XXXXX-[]--XXXX---]----XXXXX---[]------E-----XXXXXX-[]--XXXXX-----
XXXXXXXXXXXXXXXXXXXXXXXXXXXXXXXXXXXXXXXXXXXXXXXXXXXXXXXXXXXXXXXXXXXXXXXXXXXXXXXXXXXX-XXXX---]--XXXXXXXXXXXXX-----X---XXXXXXXXXXXXXXXXXXXXXXX