--------------------------------------------------------------------------------------------------------------------------------------------
--------------------------------------------------------------------------------------------------------------------------------------------
--------------------------------------------------------------------------------------------------------------------------------------------
---------------------------------X----------------------------------------------------------------------------------------------------------
--------------------------------XXXXXXX-----------------------------------------------------------------------------E------------------XXXXX
QQ?SSSS------------------------XX-SSSS-X-------------------QQQQQ--------------SSQSS?SSS-------SSS------------------SQS--SQS-----------XX-SSS
------------------------------XX--------X----------------------------------------------------------------XXXX------------------------XX-----
-----------------------------XXX---------X--------------------------------------------------------------XXXX-X----------------------XX------
-E--E-----------------------XX-X----------X--------XXXX---------------------------------------SSS------XXXXX--X--------------------XXX------
SSSSSSS---X-----------------XXXX--S-----X--X------XX<>-X--E?QQQQ--------------SSSSSSSSSS--------------XXXXXX---X---SQS--S?S-------XXEX---S--
-------EE-X----------------XXXXX--------X---X----XX-[]--X--------------------------------------------XXXXXXX----X----------------XXXXX------
SSSSSSSSSSX---------------XX-XXX--------XX---X--XX--[]---X----------------------------------XXXXX---XXXXXXXX-----X--------------XXXXXX------
XXXXXXXXXXXXXXXXXXXXXXXXXXX--XXX---EE---XX---EXXX---[]----XXXXXXXXXXXXXXXXXXXXXXXXXXXXXXXXXXX----XXXXXXXXXXX-----EXXXXXXXXXXXXXXXXXXXX----EE
XXXXXXXXXXXXXXXXXXXXXXXXXXXXXXXXXXXXXXXXXXXXXXXXXXXXXXXXXXXXXXXXXXXXXXXXXXXXXXXXXXXXXXXXXXXXX----XXXXXXXXXX--XXXXXXXXXXXXXXXXXXXXXXXXXXXXXXX