--------------------------------------------------------------------------------------------------------------------------------------------
--------------------------------------------------------------------------------------------------------------------------------------------
--------------------------------------------------------------------------------------------------------------------------------------------
--------------------------------------------------------------------------------------------------------------------------------------------
------------------------------------------E-------------------------------------------------------------------------------------------------
----------------------------------------SSSSSSSS---SSSQ---------------------------------------------------SSSSSSSSSSSSS-------------------SS
XXXXX------------------------------------------------------------SSSSSSSS-------------------------------------------------------------------
X----X---------------------------------E----------------------------------------------------------------------XXXXXXX-----<>----------------
------XXX-------XXXX----S----------------------------------------------------XXXX---Q--Q--?-----------------XXXSSSSS-X----[]---------------E
------<>-X-----XX<>-X----------------S?S--------------S-----SS----E---S?S---XX<>-X--------------S---------XXXSS-------X--QQQQQQ-------X---SS
------[]--X---XX-[]--X--------------------------------------SS-------------XX-[]--X-----------E----------XX<>----------X--------------X-----
------[]---X-XX--[]---X-----XXX--------------XXXXX----------SS------------XX--[]---X------E-----XXXXXX--XX-[]-----------X-XXXXX---XXX-------
E-----[]----XX-E-[]----XXXXXX--XXXXXXXXXXXXXXX----XXXXXXXXXXXXXXXXXXXXXXXXX---[]----XXXXXXXXXXXXX---X-XXX--[]----E---EE--XX----XXXXE-XXXXXXX
XXXXXXXXXXXXXXXXXXXXXXXXXXXXX--XXXXXXXXXXXXXXX---XXXXXXXXXXXXXXXXXXXXXXXXXXXXXXXXXXXXXXXXXXXXXXXX---XXXXXXXXXXXXXXXXXXXXXXX-X-XXXXXXXXXXXXXX