--------------------------------------------------------------------------------------------------------------------------------------------
--------------------------------------------------------------------------------------------------------------------------------------------
--------------------------------------------------------------------------------------------------------------------------------------------
--------------------------------------------------------------------------------------------------------------------------------------------
--E-----------------------------------------------------------------------------------------------------------------------------------------
SSSSSSSS---------------------------------Q------------------------------------------SQSSS----------------------X---?S-----------S-----------
--------------------------------------------------------------------------------------------------------------XX----------------------------
-------------------------------------------------------------------------------------------------------------XXX----------------------------
-------------------------------------------------------------------------------------------------------------XXX----------------------------
----------Q---X----X----------<>-------S------S-------SS---------------------SSQ--------------------------XX-XXX----------------------------
--------------XX---XX---------[]--------------------------->--------------X------------------------------XXX-XXX----------------------------
--------------XXX--XXX-----<--[-----<>--------------------[]----<>------XXXX----------------------------XXXX-XXX--------------------------<>
----------EE--XX---XXXX----[E-[]----[]----E-E-E--E--------[]----[]------XXXX-----------------------X---XXXXXXXXX--------------------------[]
XXXXXXXXXXXXXXXXX--XXXXXXXXXXXXXXXXXXXXXXXXXXXXXXXXXXXXXXXXXXXXXXXXXXXXXXXXXXXXXXXXXXXXXXXXXX-----XXX--XXXXXXXXX-------X-------------------X