--------------------------------------------------------------------------------------------------------------------------------------------
--------------------------------------------------------------------------------------------------------------------------------------------
--------------------------------------------------------------------------------------------------------------------------------------------
--------------------------------------------------------------------------------------------------------------------------------------------
--------------------------------------------------------------------------------------------------------------------------------------------
--------------------------------------------------------------------------------------SSSSSS--------SSSSS-----------------------------------
-----------------XX-------------------------------------------------------------------------------------------------------------------------
------------------XX------------------------------------------------------------------------------------------------------------------------
-----------------XXXX-S---------------------------------------------------------------------------------------------------------------------
-----------------XXX---------Q--Q--QS---------------------<>-------S------S--------------------------------------------?S--------X-----X----
X------<>-------XXXXX-------------------------------------[]-------------------------------------------------------------------XXX--XXXX----
X------[]------XXXXXX-------------------------------------[]----<>--------------------------------------------<>--------------XXXX--XXXX----
]-EE---[]XX----XXXXXXX-------E-------------E--------------[]----[]------E-E-----------------------------------[]-------------XXXXX--XXXX----
XXXXXXXXXXXX--XXXXXXXXXXXXXXXXXXXXXXXXXXXXXXXXXXXXXXXXXXXXXXXXXXXXXXXXXXXXXXXXXXXXXXXXXXXXX----XXXXXXX----XXXXXXXXXXXXXXXXXXXXXXXXXXXXXXXXXX