--------------------------------------------------------------------------------------------------------------------------------------------
--------------------------------------------------------------------------------------------------------------------------------------------
--------------------------------------------------------------------------------------------------------------------------------------------
--------------------------------------------------------------------------------------------------------------------------------------------
--------------------------------------------------------------------------------------------------------------------------------------------
-----------------------------------------------------------------SSSSQ-----------------------S-----------------X--------------------------SS
--------------------------------------------------------------------------------------------------------------XX----------------------------
-------------------------------------------------------------------------------------------------------------XXX----------------------------
-------------------------------------------------------------------------------------------------------------XXX----------------------------
-----------------<>----------SS-----<>-------XX----------?SSS---SS--------SS-----SS--S-----?S-Q-----X-----XX-XXX-------QS-Q-----X--X--------
-----------------[]-----------------[]------XXX----------------------------------------------------XX----XXX-XXX---------------X----X-------
X-------<>-------[]---------X-------[]-----XXXX--------------------------------XX-----------------XXXX--XXXXXXXX--------------XXX---XXX----<
E-E-----[]-------[]---------EE----E-[]----XXXXX----------E------------E-E-E----E-----E---E-E--E--XXXX--XXXXXXXXX-----E-E--EE-XXXX--XXXXX---[
XXXXXXXXXXXXXXXXXXXXXXXXXXXXXXXXXXXXXXXXXXXXXXXXXXXXXXXXXXXXXXXXXXXXXXXXXXXXXXXXXXXXXXXXXXXXXXXXXXXXXX-XXXXXXXXXXXXXXXXXXXXXXXXXXXXXXXXXXXXX