--------------------------------------------------------------------------------------------------------------------------------------------
--------------------------------------------------------------------------------------------------------------------------------------------
--------------------------------------------------------------------------------------------------------------------------------------------
--------------------------------------------------------------------------------------------------------------------------------------------
----------------------------------------------------------------------------------------E---------------------------------------------------
-------------------------------------?-------------------SS---------------------------SSSQS-------------------------------------------------
--------------------------------------------------------------------------------------------------------------------------------------------
--------------------------------------------------------------------------------------------------------------------------------------------
--------------------------------------------------------------------------------------------------------------------------------------------
---------------------SS----S-SS-----<>-------X--------S-----------------------------X-------------------------------------------------------
------------------>-----------------[]------XX-------------------------X---X-----------------------------------------------------<>---------
--<>-------------<>-----------------[]----XXXX-------------------------XXX-X------------------------------------X----------------[]---------
--[]-------------[]---------EE----E-[]----XXXX-----E---------------E---XXXXXX-----------------------------------------------E----[]-------E-
XXXXXXXXXXXXXXXXXXXXXXXXXXXXXXXXXXXXXXXXXXXXXXXXXXXXXXXXXXXXXXXXXXXXXXXXXXXXXXXXXXXX----------------------------XXXX---XXXXXXXXXXXXXXXXXXXXX