--------------------------------------------------------------------------------------------------------------------------------------------
--------------------------------------------------------------------------------------------------------------------------------------------
--------------------------------------------------------------------------------------------------------------------------------------------
--------------------------------------------------------------------------------------------------------------------------------------------
--------------------------------------------------------------------------------------------------------------------E-----------------------
-------------Q----------------------------------------------------------------------------------------------------SSSQS---------------------
--------------------------------------------------------------------------------------------------------------------------------------------
--------------------------------------------------------------------------------------------------------------------------------------------
--------------------------------------------------------------------------------------------------------------------------------------------
--<>-------------<>--------S--------------------------<>-----------S?S---<>--------S--------------------------------------------------------
--[]-------------[]-----------------------------------[]-----------------[]-----------------------------------------------------------------
--[]----<>-------[]-----------------------------------[]-----------------[]---------------------------------------------------------------<>
--[]----[]--E-E--[]-------E---------------------------[]--E---------E----[]-----------------------------------------------------------------
XXXXXXXXXXXXXXXXXXXXXXXXXXXXXXXXXXXX------------XXXXXXXXXXXXXXXXXXXXXXXXXXXXXXXXXXXX--------------------------------------------------------