--------------------------------------------------------------------------------------------------------------------------------------------
--------------------------------------------------------------------------------------------------------------------------------------------
--------------------------------------------------------------------------------------------------------------------------------------------
--------------------------------------------------------------------------------------------------------------------------------------------
--------------------------------------------------------------------------------------------------------------------------------------------
----------------------------------------SSS----------S-S----------------SS-S------------------------SS--------------------------------------
--------------------------------------------------------------------------------------------------------------------------------------------
---------------------------------------E----------------------------------------------------------------------------------------------------
--------------------------------------------------------------------------------------------------------------------------------------------
Q--Q-------S?S----S--Q--Q--SQ-<>-----S?S--------S?SQS----------------------X---------------------------------XXX-----------------<>---------
------------------------------[]--------------------------------------XX---XX-----------------------------X--XXX--->----<>-------[]---------
------------------------------[]-------------------------------<------XXX--XX------<----------------------XXXXXXX-[]----<]-------[]------<>-
---E--------E---E-E--E--------[]------------E----E---------E---[]-EE-XXXX--XXX-----[----------------------XXXXXXE-[]----[]-------[]------[]-
XXXXXXXXXXXXXXXXXXXXXXXXXXXXXXXXXXXXXXXXXXXXXXXXXXXXXXXXXXXXXXXXXXXXXXXXXXXXXXXXXXXXXXXXXXXXXXXXXXXXXXXXXXXXXXXXXXXXXXXXXXXXXXXXXXXXXXXXXXXX