--------------------------------------------------------------------------------------------------------------------------------------------
--------------------------------------------------------------------------------------------------------------------------------------------
--------------------------------------------------------------------------------------------------------------------------------------------
--------------------------------------------------------------------------------------------------------------------------------------------
--------------------------------------------------------------------------------------------------------------------------------------------
----------------------------------------SSS---SSS--SSSQS--S---------------------------------------------------------------------------------
--------------------------------------------------------------------------------------------------------------------------------------------
--------------------------------------------------------------------------------------------------------------------------------------------
-----------------------------------------------------------------------------------------------------X--------------------------------------
-SS----<>--------XX-XX------Q--Q--QS-S----SS----S---S---------------QS-------------------------------XXX---------SS--------------XX--XX---X-
-------[]-------XXX-XX---------------------------------------------------------------------<>------XXXXXX-----------------------XXX--XX--XX-
-------[]------XXXX-XXX-------------------------------------------------------------X------[]------XXXXXX---------------]-------XXX--XX--XXX
---E-E-[]-----XXXXXXXXX------------------------------E-E--------------------------E---EE---[]-X---XXXXXXXX------[------[]------XXXX--XXXXXXX
XXXXXXXXXXXXXXXXXXXXXXXXXXXXXXXXXXXXXXXXXXXXXXXXXXXXXXXXXXXX----XXX-XXX-XXX---XXXXXXXXXXXXXXXXXXXXXXXXXXXXXXXXXXXXXXXXXXXXXXXXXXXXXXXXXXXXXX