--------------------------------------------------------------------------------------------------------------------------------------------
--------------------------------------------------------------------------------------------------------------------------------------------
--------------------------------------------------------------------------------------------------------------------------------------------
--------------------------------------------------------------------------------------------------------------------------------------------
--------------------------------------------------------------------------------------------------------------------E-----------------------
---------SSSSS----------SSSS-------------------------------------------------------------------------------------SSSSSSS----?S--SSSS--------
--------------------------------------------------------------------------------------------------------------------------------------------
--------------------------------------------------------------------------------------------------------------------------------------------
--------------------------------------------------------------------------------------------------------------------------------------------
----Q--SSS---------SS---S-----<S-----S-S-S----S--Q---SSS-----------X--X----X----------------------X-X--X------------------------------------
-------------------------------------------------------------------X--XX---XX------------------X--XX---XX-----------------------------------
--------------------------------------------------------X------<>-XX--XXX--XXX----<>-------<>-XX--XXX--XX---------------------------------<>
-E-----------EEE-E------------E-----------E-E-E--E----E---EE---[]XXX--XXX--XXXX---[]---E---[]XXX-XXXX--XXX--------------------------------[]
XXXXXXXXXXXXXXXXXXXXXXXXXXXXXXXXXXXXXXXXXXXXXXXXXXXXXXXXXXXXXXXXXXXX--XXXXXXXXXX-XXXXXXXXXXXXXXXXXXXXXXXXXXXXXXXXXXXXXXXXXXXXXXX----XXXXXXXX