--------------------------------------------------------------------------------------------------------------------------------------------
--------------------------------------------------------------------------------------------------------------------------------------------
--------------------------------------------------------------------------------------------------------------------------------------------
--------------------------------------------------------------------------------------------------------------------------------------------
--------------------------------------------------------------------------------------------------------------------------------------------
--------------------------------------------------------------------------------------------------------------------------SSSSQ----------SSS
--------------------------------------------------------------------------------------------------------------------------------------------
-------------------------------------------------------------------------------------------------------------------------E--------------E---
--------------------------------------------------------------------------------------------------------------------------------------------
--S-----<>-------X-----------------<>-Q-----X-----XX------------<>-------XX-----------------------X----X-----------SS--S?S---------SS-S?SSS-
--------[]------XX-----------------[]------XXX--XX-X--XX--->----[]------XX---------------------X--XX--XXX-----------------------------------
--------[]-----XXX-----------------[]-----XXXX--XXXX--XX--[]----[]-----XXXX----------------<>-X---XXXXXXX-----------------------------------
E-E---E-[]----XXXX-------------E-E-[]-E--XXXX--XXXXX--XX--[]----[]----XXXX------------EE---[]XX---XXXXXXXX-------E-----------EEEEE--E-------
XXXXXXXXXXXXXXXXXXXXXXXXXXXXXXXXXXXXXXXXXXXXXX-XXXXXXXXXXXXXXXXXXXXXXXXXXXXXXXXXXXXXXXXXXXXXXXXX---XXXXXXXXXXXXXXXXXXXXXXXXXXXXXXXXXXXXXXXXX