--------------------------------------------------------------------------------------------------------------------------------------------
--------------------------------------------------------------------------------------------------------------------------------------------
--------------------------------------------------------------------------------------------------------------------------------------------
--------------------------------------------------------------------------------------------------------------------------------------------
--------------------------------------------------------------------------------------------------------------------------------------------
----------------------------------------SSSQ-------SQSQS------------------------------------------SQ-------SSSQSSS-------S------------------
--------------------------------------------------------------------------------------------------------------------------------------------
---------------------------------------E------------------------------------------------------------------E---------------------------------
--------------------------------------------------------------------------------------------------------------------------------------------
-----------SQS-------Q-------SSSS----S?S------S-SQ--S-------------------------------X--Q--Q--Q---S?S----S?--Q--Q-Q-----QS-Q-----XX----------
-------------------------------------------------------------------------------------------------------------------------------XXX--X-------
------------------------------------------------------------------------------------------------------------------------------XXXX---X------
------------------E----------E------------E-E----E---------------------------------------------------------------E---E-E-----XXXXX-XXXXX----
XXXXXXXXXXXXXXXXXXXXXXXXXXXXXXXXXXXXXXXXXXXXXXXXXXXXXXXXXXXXXXXXXXXXXX--XXX-XXXXXXXXXXXXXXX-XXXXXXXXXXXXXXXXXXXXXXXXXXXXXXXXXXXXXXXXXXXXXXXX