--------------------------------------------------------------------------------------------------------------------------------------------
--------------------------------------------------------------------------------------------------------------------------------------------
--------------------------------------------------------------------------------------------------------------------------------------------
--------------------------------------------------------------------------------------------------------------------------------------------
--------------------------------------------------------------------------------------------------------------------------------------------
------------S-----SS----------------------------------------------------------------------------S---------------SS---SSS------S-SSSSS--SSSS-
-----------------------------------------------------------------------------------X--------------------------------------------------------
-----------------------------------------------------------------------------------X--------------------------------------------------------
--------------------------------------------------------------------------------------------------------------------------------------------
----Q--SSS---------SS------------------------<>--------S-------<-------------XXX--XX--S-----<>-----------SSQS-----------------SS------------
------------------------------------<>-------[]----------------[-------XXX--XXXX--XX--------[]----------------------------------------------
----------------------------X-------[]-------[]----------------[]-----XXXXX-XXXX-XXX--------[]-----X----------------------------------------
--------------E-E--------EEEE-EE----[]-------[]-------E----E---[]-E---XXXXXXXXXXXXXXE-EE--E-[]----XEXE-------------------------------------E
XXXXXXXXXXXXXXXXXXXXXXXXXXXXXXXXXXXXXXXXXXXXXXXXXXXXXXXXXXXXXXXXXXXXXXXXXXXXXXXXXXXXXXXXXXXXXXXXXXXXXXXXXXXXXXXXXXXXXXX--XXXXXXXXXXX-XXXXXXX