--------------------------------------------------------------------------------------------------------------------------------------------
--------------------------------------------------------------------------------------------------------------------------------------------
--------------------------------------------------------------------------------------------------------------------------------------------
--------------------------------------------------------------------------------------------------------------------------------------------
--------------------------------------------------------------------------------------------------------------------------------------------
--------------------------------------------------------SSSSSSSS--------SSSS--------SSS-------------------------------------SSS--------SSSSS
---------------------------------------------------------------------------------------------------------------X----------------------------
---------------------------------------------------------------------------------------------------------------X----------------------------
--------------------------------------------------------------------------------------------------------------------------------------------
X-------------QS-------------SSS-------------<>-----------------------SS----------<>-------<--Q-----X-----XX--XXX--Q--Q--Q----SS----S-------
---------------------------------------------[]-----------------------------------[]-------[]-----XX----XXXX--XX----------------------------
------------------------------------<>-------[]------<>---------------------------[]-------[]-----XXX---XXXX-XXX----------------------------
---------------------------EE-------[]--E-E--[]------[]-------------------------E-[]-----E-[]-EX-XXXX--XXXX-XXXX---------------------------E
XXXXXX---XXXXXXXXXXXXXXXXXXXXXXXXXXXXXXXXXXXXXXXXXXXXXXXXXXXXX---XXXXXXXXXX-XXXXXXXXXXXXXXXXXXXXXXXXXX-XXXXXXXXXXXXXXXXXXXXXXXXXXXXXXXXXXXXX