--------------------------------------------------------------------------------------------------------------------------------------------
--------------------------------------------------------------------------------------------------------------------------------------------
--------------------------------------------------------------------------------------------------------------------------------------------
--------------------------------------------------------------------------------------------------------------------------------------------
------------------------------------------------------------E-------------------------------------------------------------------------------
-------------Q---------------QQ-----------S-------------SSSSSSSS--------SS-----------------------------------------------SSSSQ--------------
-----------------------------------------------------------------------------------------------------XX-------------------------------------
-----------------------------------------------------------------------------------------------------XXX------------------------------------
-----------------------------------------------------------------------------------------------------XXXX-----------------------------------
-SSSS-------------SS-----XX----Q-----Q----SS--------------------------S-------XX--<>----------------XXXXX---------S-S---<>-------X-S----X---
-------------------------XX--------------------------------------------------XX---XX-------<>------XXXXXXX--------------[]-------X------X---
-----------------------XXXX------------------------------------------------XXXX---[XX------[]-----XXXXXXXX--------------[]-----XXX----X-X---
-E----------E-E-E-E----XXXX----------------------------E----------EE---E---XXXX---XX]-EE---[]----XXXXXXXXXX-----EE----E-[]----XXXX----XXX---
XXXXXXXXXXXXXXXXXXXXXXXXXXXXXXXXXXXXXXXXXXXXXXXXXXXXXXXXXXXXXXXXXXXXXXXXX--XXXXXXXXXXXXXXXXXXXXXXXXXXXXXXXXXXXXXXXXXXXXXXXXXXXXXXXXXXXXXXXXX