--------------------------------------------------------------------------------------------------------------------------------------------
--------------------------------------------------------------------------------------------------------------------------------------------
--------------------------------------------------------------------------------------------------------------------------------------------
--------------------------------------------------------------------------------------------------------------------------------------------
--------------------------------------------------------------------------------------------------------------------------------------------
------------------------------SSSS----------------------------------SQS---------------SSSSSS------SSSSSSS--SSSS-----------SSSQQ-------------
--------------------------------------------------------------------------------------------------------------------------------------------
--------------------------------------------------------------------------------------------------------------------------------------------
--------------------------------------------------------------------------------------------------------------------------------------------
X--Q--------QS----Q--Q--Q--S--------------------------<>---SS----S--------SS-----SS-X-------------SS---------------SS--SSS---------SS----SS-
--------------------------------------------------X---X]--------------------------------------------------------------------------------X---
---------------------------------------------->--XX---XX-------------------------------------------------------<-----------------------XX---
------------------E--E-----------------------[---XX-XXXX--------------E-E-E----E-------------------------------[-E------------E-E---E--E----
XXXXXXXXXXXXXXXXXXXXXXXXXXXXXXXX---XXX----XXX---XXXXXXXXXXXXXXXXXXXXXXXXXXXXXXXXXXXXXXXXXX----XXXXXXXXX----XX--XXXXXXXXXXXXXXXXXXXXXXXXXXXXX