--------------------------------------------------------------------------------------------------------------------------------------------
--------------------------------------------------------------------------------------------------------------------------------------------
--------------------------------------------------------------------------------------------------------------------------------------------
--------------------------------------------------------------------------------------------------------------------------------------------
--------------------------------------------------------------------------------------------------------------------------------------------
--------------------------------------------------------------------SSS---------QSQS----SSSS------SSSSSSS--SS---SSSSSSS---------------------
--------------------------------------------------------------------------------------------------------------------------------------------
--------------------------------------------------------------------------------------------------------------------------------------------
--------------------------------------------------------------------------------------------------------------------------------------------
-------------------------------------------------SS-------<>-----S-S--------S?SQS-----------------SS---------------------------------SS-----
----------------------------------------------------------[]--------------------------------------------------------------------------------
-----------------<>-----------[]----<>------->------------[]--------------------------------------------------------------------------------
------------E----[]-----------[]----[]------E]------------[]------------E------------------------------------E-E----------------------------
XXX----XXXX----XXXXXXXXXXXXXXXXXXXXXXXXXXXXXXXXXXXXXXXXXXXXXXXXXXXXXXXXXXXXXXXXXXXXXXXXXXXXXXXXXXXXXXXXXXXXXXXXXXXXX---XXX--XX--XXX--XXXXXXX