--------------------------------------------------------------------------------------------------------------------------------------------
--------------------------------------------------------------------------------------------------------------------------------------------
--------------------------------------------------------------------------------------------------------------------------------------------
--------------------------------------------------------------------------------------------------------------------------------------------
--------------------------------------------------------------------------------------------------------------------------------------------
---------------------------------------------------------------------------Q-------------------------------------------------SS--------SSSSS
--------------------------------------------------------------------------------------------------------------------------------------------
--------------------------------------------------------------------------------------------------------------------------------------E-----
--------------------------------------------------------------------------------------------------------------------------------------------
-------------SQS--------------<>-----------------SSQS-----------SS---------S------------------------------X----XX--Q--Q--Q----SS----S?S?S---
------------------------------[>------------------------------------------------------------------XX----XXX---XX----------------------------
------------------------------[]----[]-----------------------------------------XXX-X-------<>-----XXX---XXX---XX----------------------------
------------------------------[]----[]-----EEE-----------------------E-EEE--E-EXXXXX-------[]-EX--XXX--XXXXXX-XX----------------------------
XXXXXXXX----XXXXXXX---XXXXXXXXXXXXXXXXXXXXXXXXXXXXXXXXXXXXXXXXXXXXXXXXXXXXXXXXXXXXXXXXXXXXXXXXXXXXXXXX-XXXXXXXXXXXXXXXXXXXXXXXXXXXXXXXXXXXXX