--------------------------------------------------------------------------------------------------------------------------------------------
--------------------------------------------------------------------------------------------------------------------------------------------
--------------------------------------------------------------------------------------------------------------------------------------------
--------------------------------------------------------------------------------------------------------------------------------------------
--------------------------------------------------------------------------------------------------------------------------------------------
SSSSSSSS----?SSSSSSSS---SSSS--------------------------------------------------------SSQ---SS--SSSSQS---Q----SSSS-QQ-------------------------
--------------------------------------------------------------------------------------------------------------------------------------------
------------------------------------------------------------------------------------------------------------E-------------------------------
---------------------------------------------X----------------------------------------------------------------------------------------------
X-------------S?-------------------<>-------XX-XX-----------------------------------X--Q-----Q----S-----S-S?S---------------QS--------------
-----------------------------------[]------XXX-XXX------------------------XX-------------------------------------------------------------<[]
---------------------------<-------[]-----XXXX-XXX-------------<>-X------XXXX-----<>-----------------------------------------------------XXX
---------------------------[---E-E-[]----XXXXX-XXXX------------[]-E-----XXXXXX----[]----------------------------------------------------EXXX
XXXXXX----XXXXX--XXX--XXXXXXXXXXXXXXXXXXXXXXXXXXXXXXXXXX---XXXXXXXXX--XXXXXXXXXXXXXXXXXXXXXXXXXXXXXXXXXXXXXXXXXXXXXXXX-XXXXXXXXXXXXXXXXXXXXX