--------------------------------------------------------------------------------------------------------------------------------------------
--------------------------------------------------------------------------------------------------------------------------------------------
--------------------------------------------------------------------------------------------------------------------------------------------
--------------------------------------------------------------------------------------------------------------------------------------------
--------------------------------------------------------------------------------------------------------------------------------------------
-----------SSSS---SQ---------------------Q-----------------------?---------------------------SSQQ-------------------------------------------
-------------------------------------------------------------------------X------------------------------------------------------------------
-------------------------------------------------------------------------XX-----------------------------------------------------------------
-------------------------------------------------------------------------XX-----------------------------------------------------------------
---Q-----S---------S----------SS----<>-------?SS-----SS--SS----<>X-------XX-XX-------Q--Q--SS-Q--------S-----XX-----------------------------
------------------------------[]----[]-------------------------[]-------XX--XXX---------------------------XXXXX-----------------------------
-----------------------X---X--------[]------------------X------[]-----XXXXX-XXXX-XX-----------------------XXXXX---------------------------->
----------------E---E-XXXX-XE-EE--E-[]----EEE------E----[]-E-EE[]-----XXXX--XXXXXXX--E-----------E-E-E--E-XXXXXX---------------------------]
XXXXXXXXXXXXXXXXXXXXXXXXXXXXXXXXXXXXXXXXXXXXXXXXXXXXXXXXXXXXXXXXXXXXXXXXXXXXXXXXXXXXXXXXXXXXXXXXXXXXXXXXXXXXXXXX---X-------------------X--XX