--------------------------------------------------------------------------------------------------------------------------------------------
--------------------------------------------------------------------------------------------------------------------------------------------
--------------------------------------------------------------------------------------------------------------------------------------------
--------------------------------------------------------------------------------------------------------------------------------------------
------------------------------------------------------------E-------------------------------------------------------------------------------
---------S?SQ-------------SS------------------------------SSSSS--------------------------------------------SSSSS----------------------------
--------------------------------------------------------------------------------------------------------------------------------------------
----------------------------------------------------------------------------------------------------------E----------------E----------------
--------------------------------------------------------------------------------------------------------------------------------------------
--S----<>-------XX-XX--XX----------Q--Q---------------------------------------------X-------------QS-----SS------SSSS---SS?S------S?S----S--
-------[]------XXX--XX-X--------------------------------------------------------------------------------------------------------------------
-------[]-----XXXX--XXX--------------------X-----X---->--------------------XX------>--------------------------------------------------------
-E-E-E-[]----XXXXX-XXXXX-----------E--E----XXX----X---X-----------EE-------XXX-----------------------------------E------------E-E--------EE-
XXXXXXXXXXXXXXXXXXXXXXXXXXXXXXXXXXXXXXXXXXXXXXXXXXXXXXXX---XXXXXXX---------XXX----XXXXXXXX---XXXXXXXXXXXXXXXXXXXXXXXXXXXXXXXXXXXXXXXXXXXXXXX