--------------------------------------------------------------------------------------------------------------------------------------------
--------------------------------------------------------------------------------------------------------------------------------------------
--------------------------------------------------------------------------------------------------------------------------------------------
--------------------------------------------------------------------------------------------------------------------------------------------
--------------------------------------------------------------------------------------------------------------------------------------------
------------SSSQ--------QS-----------SSQQ--------------X------------SSS--------SSSS----------------------------------------------------SSS--
-----------------------------------------------------XXX------------------------------------------------------------------------------------
-----------E----------------------------------------XX--------------------------------------------------------------------------------------
---------------------------------------------------XXXX-------------------------------------------------------------------------------------
Q--Q-----S?S------S-SQ--Q--Q-Q--Q--?S-Q--------S---XXXX----S-----S---------SS--------------------------X---------------------SQS------------
--------------------------------------------------XXXX------------------------------X-----------------XX------------------------------------
------------------------------------------XX-----XXXXX--------------------------------<>---<>-X------XXXX-----------------------------------
--------------E-E----E-------E-----------XXX-E--XXXXXX-X--------------E-E--------E-E--E]---[]XX-----XXXXXX----------------------------------
XXXXXXXXXXXXXXXXXXXXXXXXXXXXXXXXXXXXXXXXXXXXXXXXXXXXXXXXXXXXXXXXXXXXXXXXXXXXXXXXXXXXXXXXXXXXXXXX----XXXXXXX----X--XXX-------XXX--XX---XXX-XX