[
    204750377,
    13191728,
    12882726,
    12730249,
    12414706,
    12266174,
    12183228,
    12134994,
    12259274,
    12168537,
    12210837,
    12159025,
    12261742,
    12072627,
    12057048,
    12101107,
    12149583,
    12155363,
    12161970,
    12130895,
    12033773,
    12025380,
    12087897,
    12104399,
    12441791,
    12194530,
    12144401,
    12127868,
    12016658,
    12174910,
    12113797,
    12143643,
    12046636,
    11889730,
    12127168,
    12111340,
    12023712,
    12106771,
    11989306,
    12163614,
    12127298,
    12027274,
    12206986,
    12091452,
    12184709,
    12158251,
    11998169,
    12031914,
    12028427,
    12188434,
    12005145,
    12115433,
    12053220,
    12038109,
    12169181,
    12197727,
    12152427,
    12025925,
    11920467,
    12203102,
    12347935,
    12165663,
    12082314,
    11966005,
    13546664,
    12050751,
    12215756,
    12151141,
    12178188,
    11971812,
    12080016,
    12058853,
    12180688,
    12228181,
    12172748,
    12168785,
    11990060,
    12117019,
    12131324,
    12183813,
    12134574,
    12131785,
    12048610,
    11985092,
    12089629,
    12342357,
    12198319,
    12227225,
    12077877,
    12159761,
    11993483,
    12002691,
    12198094,
    12033550,
    16324219,
    12193379,
    11862740,
    11849327,
    12078044,
    12062619,
    12218778,
    12138975,
    12191804,
    12191952,
    12000075,
    12008971,
    12100150,
    12117567,
    12479527,
    12192050,
    11966851,
    12017219,
    11885524,
    12141029,
    12115102,
    12166272,
    12106996,
    12071722,
    12015048,
    12086782,
    12184389,
    12202395,
    12034598,
    11895418,
    12053773,
    12090440,
    12179246,
    12030113,
    12012299,
    12346347,
    12050684,
    12192386,
    12065540,
    12127207,
    12138076,
    11939593,
    12121917,
    12116853,
    11923176,
    11981169,
    12134499,
    12135748,
    12187794,
    12155914,
    12008467,
    11884594,
    12125537,
    12173970,
    12340939,
    12112851,
    12038230,
    11998329,
    12098155,
    12150798,
    12157561,
    12080253,
    12020366,
    12040436,
    11977070,
    12036417,
    12176525,
    11965549,
    12074344,
    12027337,
    12178997,
    12114921,
    12219337,
    11914887,
    12071182,
    12195810,
    12170444,
    12141399,
    12088111,
    12048690,
    11968130,
    12176383,
    12116015,
    12172643,
    11881868,
    12052986,
    12092749,
    12161609,
    12113128,
    12144818,
    12020577,
    12133053,
    12180581,
    12105990,
    11996584,
    11931049,
    11831259,
    12195074,
    12191235,
    12000240,
    12267720,
    12067841,
    12129163,
    12150337,
    12154282,
    12026368
]