--------------------------------------------------------------------------------------------------------------------------------------------
--------------------------------------------------------------------------------------------------------------------------------------------
--------------------------------------------------------------------------------------------------------------------------------------------
--------------------------------------------------------------------------------------------------------------------------------------------
--------------------------------------------------------------------------------------------------------------------------------------------
--------------SQ-------SQ---SSSSSSSS--------SS----------SSQ------SSSQS-----Q------XS-------------------------------------S-----------------X
------------------------------------------------------------------------------------------------------------------------------------------XX
--------------------------------------------------------------------------------X-------------------------------------------------------XXXX
--------------------------------------------------------------------------------X------------------------------------------------------XXXXX
S--Q--Q--S-----S---?S------Q--------------S--------------------SS-Q--------S---XX---------------?S---------------------?S-Q-----------XXXXXX
-------------------------------------------------------------------------------XX--------------------[]-------------------------X----XXXXXXX
-----------------------------------------------------------------------------XXXX-----<>----<>-------[]-----------------------XXX---XXXXXXXX
----------------E--------E-E---------------------------------------E-E-E-E--EXXXX-----[]----[---E----[]-------E--E-----------XXXXX--XXXXXXXX
XXXXXXXXXXXXXXXXXXXXXXXXXXXXXXXXXXX----XXXXXXX----XXXXXXXXXXXXXXXXXXXXXXXXXXXXXXXXXXXXXXXXXXXXXXXXXXXXXXXXXXXXXXXXXXXXXXXXXXXXXXXXXXXXXXXXXX