--------------------------------------------------------------------------------------------------------------------------------------------
--------------------------------------------------------------------------------------------------------------------------------------------
--------------------------------------------------------------------------------------------------------------------------------------------
--------------------------------------------------------------------------------------------------------------------------------------------
------------------------------------------------------------------------------------------------------------------E-E-----------------------
-------------------------------------SSSSQ-----Q------XX--------------------------------------------------------SSSSSSSS--------SS----------
--------------------------------------------------------------------------------------------------------------------------------------------
----------------------------------------------------X---------------------------------------------------------------------------------------
---------------------------------------------------XXX--------------------------------------------------------------------------------------
------------QS-------SS----Q-?S-S--SSS---------S---XXX----S-----<>-------XX------SS--S--S--SS----------------SS---------------X-------XX--<X
--------------------------------------------------XXXX----------[]-------X----------------------------------------------------X-----XXXX--XX
-------------------------------------------------XXXXX--X-------[]-----XXX----------------------------------------------------------XXX---XX
--E---------------E----------E-----------EEEEE--EXXXXX--E-----E-[]-----XXX-----E-----E------------EEEE-----E---------------E---X---XXXX---XX
XXXX--XXXXXXXXXXXXXXXXXXXXXXXXXXXXXXXXXXXXXXXXXXXXXXXXXXXXXXXXXXXXXXXXXXXXXXXXXXXXXXXXXXXXXXXXXXXXXXXXXXXXXXXXXXXXXXXXXXX-XX--XX---XXXXXXXXX