--------------------------------------------------------------------------------------------------------------------------------------------
----------------------------------------------------------------------------------------------------------------------S---------------------
--------------------------------------------------------------------------------------------------------------------------------------------
--------------------------------------------------------------------------------------------------------------------------------------------
--------------------------------------------------------------------------------------------------------------------------------------------
--SSSSS-------S---------SSSS-------------------------------SSQ-----------------------SSSSS--------S?-------SSS------------------------------
--------------------------------------------------------------------------------------------------------------------------------------------
--------------------------------------------------------------------------------------------------------------------------------------------
--------------------------------------------------------------------------------------------------------------------------------------------
X-------------SS----SSSQ----------------------------------------------X----X------<>X-------------QS------------X-----------QS-------SS----Q
-------------------------------------------------------------------X--XX---XX-----[]--------------------------------------------------------
---------------------------------------------------------------<>-XX--XXX--XXX----[]------------------------------Q-------------------------
---------------------------------------------------------------[]XXX--XXX--XXXX---[]----------------------------------------E-----E---------
XXXXXX---XXXXXX--XXXXXXXXXXXX-XX---X----------X--XXXXXXX---XXXXXXXXXX-XXX--XXXXXXXXXXXXXX----XXXXXX--XX---XXXXXXXXXX---XXXX-XXXXXXX--XXXXXXX