--------------------------------------------------------------------------------------------------------------------------------------------
--------------------------------------------------------------------------------------------------------------------------------------------
--------------------------------------------------------------------------------------------------------------------------------------------
--------------------------------------------------------------------------------------------------------------------------------------------
----------------------------------------------------------------------------------------E---------------------------------------------------
----------------------------------------------------------------------SSS------------SSSSSS-------------------------------------------------
--------------------------------------------------------------------------------------------------------------------------------------------
--------------------------------------------------------------------------------------------------------------------------------------------
--------------------------------------------------------------------------------------------------------------------------------------------
---------------------SS----S--------<X-------XX--------S------------Q--------SS-------------------S-------------------------QS--------------
-----------------<>------------>----<>------XXX---------------------------------------------------------------------------------------------
--<>----<>-------[]---------X-------[]------XXX---------------------------------------------------------------->----------------------------
--[]----[]--E----[]---------E-EE--E-[]-----XXXX----------------------------------------------------------------]--------------------------E-
XXXXXXXXXXXXXXXXXXXXXXXXXXXXXXXXXXXXXXXXXXXXXXXXXXXXXXXXXXXXXXXXXXXXXXXXXXXXXXXXXXXXXXXXX-------XXX-------XXXXXXXXXX---XXXXXXXXXXXXXXXXXXXXX