--------------------------------------------------------------------------------------------------------------------------------------------
--------------------------------------------------------------------------------------------------------------------------------------------
--------------------------------------------------------------------------------------------------------------------------------------------
--------------------------------------------------------------------------------------------------------------------------------------------
--------------------------------------------------------------------------------------------------------------------------------------------
--------------------------------------S-SSS----Q---SSSQS--------------S---------QS--SSQ--SSS------SSSQS-S--SSSQS------------SSS--------SSSQS
--------------------------------------------------------------------------------------------------------------------------------------------
-------------------------------------E------------------------------------------------------------------------------------------------------
--------------------------------------------------------------------------------------------------------------------------------------------
X------------SQS---------------QS---?S---------SS---------<>-----S-S------S--Q--Q--QX-------------SS----S----------Q-----S----------S?S-S---
----------------------------------------------------------[]--------------------------------------------------------------------------------
----------------------------------------------------------[]--------------------------------------------------------------------------------
--------------------------------------------E---E--E-E-E--[]------------E-E--E-------------------------------E-E----------------E-----------
XXXXXX---XXXXXXXXXX---XXXXXXXXXXXXXXXXXXXXXXXXXXXXXXXXXXXXXXXXXXXXXXXXXXXXXXXXXXXXXXXXXXXX---XXXXXXXXXX--XXXXXXXXXXXXXXXXXXXXXXXXXXXXXXXXXXX