--------------------------------------------------------------------------------------------------------------------------------------------
--------------------------------------------------------------------------------------------------------------------------------------------
--------------------------------------------------------------------------------------------------------------------------------------------
--------------------------------------------------------------------------------------------------------------------------------------------
--------------------------------------------------------------------------------------------------------------------------------------------
----------------SSS-----------------------S-----------------------------------------SSSSSSSS-----SSSS-------SS------------------------------
--------------------------------------------------------------------------------------------------------------------------------------------
-----------------------------------------E--------------------------------------------------------------------------------------------------
--------------------------------------------------------------------------------------------------------------------------------------------
-S-----------S----------------<>-------S?S----S--Q--Q--Q------------QS----------------------------SS------S------SS-----<>-------XX---------
------------------------------[]----------------------------------------------------------------------------------------[]------XXX------XX-
------------------------------[]--------------------------------------------------------------------------------X-------[]------XXX-----XXXX
--------------------------E---[]------------E-E--E--------------------------------------------------------------[]----E-[]-----XXXX----XXXXX
XXXXXXXXXXXXXXXXXXXXXXXXXXXXXXXXXXXXXXXXXXXXXXXXXXXXXXXXXXXX----X---XXXXXXX-XXXXXXXXXXXXX----XXXXXXXXXX--XXXXXXXXXXXXXXXXXXXXXXXXXXXXXXXXXXX