--------------------------------------------------------------------------------------------------------------------------------------------
--------------------------------------------------------------------------------------------------------------------------------------------
--------------------------------------------------------------------------------------------------------------------------------------------
--------------------------------------------------------------------------------------------------------------------------------------------
----E---------------------------E-----------------------------------------------------------------------------------E-----------------------
--SSSSSS--------SS------S----SSSSSSS--------SSQS--------------------SSS---------QS-S----------------------------SSSSSSSS--------SS----------
--------------------------------------------------------------------------------------------------------------------------------------------
-------------------------------------------------------------------E------------------------------------------------------------------------
--------------------------------------------------------------------------------------------------------------------------------------------
--------------S---------------------------S---------------<>-----S?S--------S?SQS--Q-----------------X------------------------X-----------<>
----------------------------------------------------------[]-------------------------------<--------XXX-----------------------X----XX-----[]
------------------------------------------------------<>--[]-------------------------------[]------XXXXXXX----XX-------------------XXX----[]
------------------------------------------------------[]--[]----------E-E----E-------------[]-----XXXXXXXXX---[]----------EE-------XXXX---[]
---XXX------XXX--X--------XX---XX-------XXX--------X---XXXXXXXXXXXXXXXXXXXXXXXXXXXXXXXXXXXXXXXXXXXXXXXXXXXXXXXXX------X-------------XXXXXXXX