--------------------------------------------------------------------------------------------------------------------------------------------
--------------------------------------------------------------------------------------------------------------------------------------------
--------------------------------------------------------------------------------------------------------------------------------------------
--------------------------------------------------------------------------------------------------------------------------------------------
--------------------------------------------------------------------------------------------------------------------------------------------
---------------------------------------------------------SS-SSSS----SSSSSSSSS---SSSS----SSSS-----------SS----SSS------------SSSQS-SQ---SS---
--------------------------------------------------------------------------------------------------------------------------------------------
--------------------------------------------------------------------------------------------------------------------------------------------
--------------------------------------------------------------------------------------------------------------------------------------------
---------------------SSQS---------------------------------------------SS--------------------------S?---------------SS----S---------SS-------
---------------X----------------------------------------------------------------------------------------------------------------------------
-------<>------XX--X----------<>----------------------<>------------------------------------------------------------------------------------
-------[]XX---XXX--X----------[]----------------------[]---------------------------[-----------E---E--------------------------E-E------EEE-E
XXXXXXXXXXXXXXXXXXXXXXXXXXXXXXXXXXXX------------XXXXXXXXXXXXXXX--XXXXXXXXXX---XXXXXXXXXXXXXXXXXXXXXXXXXXXXXXXXXXXXXXXXXXXXXXXXXXXXXXXXXXXXXX