--------------------------------------------------------------------------------------------------------------------------------------------
--------------------------------------------------------------------------------------------------------------------------------------------
--------------------------------------------------------------------------------------------------------------------------------------------
--------------------------------------------------------------------------------------------------------------------------------------------
--------------------------------------------------------------------------------------------------------------------------------------------
---------SSSSSQ----Q-----SSS------------SSSQ-------SQS-------------------------------------------------------------?S-----------------------
--------------------------------------------------------------------------------------------------------------------------------------------
---------E-----------------------------E----------------------------------------------------------------------------------------------------
--------------------------------------------------------------------------------------------------------------------------------------------
----S--S?S---------SQ---------->-----S?S--------SQ--Q--Q-----------S?S---<>--Q-----S------------------------------------------------------<>
------------------------X------]--------------------------X>-------------[]---------------------------------------------------------------[]
----------------------------------------------------------[]----<>-------[]----------------<>---------XX---------------<-----------X------[]
-E-----------EEEEE--E--E---E---]------------E----E--------[]----[]--E----[]----------------[]---------XX---------------[]----------X------[]
XXXXXXXXXXXXXXXXXXXXXXXXXXXXXXXXXXXXXXXXXXXXXXXXXXXXXXXXXXXXXXXXXXXXXXXXXXXXXXXXXXXX-XXXXXXXXX----XXXXXXXXXXXXXX-XXX--XXX-----------XXXXXXXX