--------------------------------------------------------------------------------------------------------------------------------------------
--------------------------------------------------------------------------------------------------------------------------------------------
--------------------------------------------------------------------------------------------------------------------------------------------
--------------------------------------------------------------------------------------------------------------------------------------------
--------------------------------------------------------------------------------------------------------------------------------------------
---------SSSSQQ----Q------------SSS---------------------SSSSSSSS----SSSSSSSSS--SS---SS----?S-SSSQS---SSQS--------------------Q--------------
--------------------------------------------------------------------------------------------------------------------------------------------
--------------------------------------------------------------------------------------------------------------------------------------------
--------------------------------------------------------------------------------------------------------------------------------------------
-?SSS--SSS---------SQ----SS-X-----------------------------------------SS----------------Q--QS-Q----------------------------S?S---<>--Q-----S
------------------------X--------------------------------------------------------------------------------------------------------[]---------
------------------------X-----------------------------<>-------------------------------------------------X--------<>-------------[]---------
-E-----------EEEEE--E-EE-------------------------------]-------------------------EEE-----------E-E-E----XXXX------[]--------E-E--[]---------
XXXXXXXXXXXXXXXXXXXXXXXXXXXXXXXXXX---XXXXXX--X-----X---XXXXXXXXXXXXXXXXXXXXXXXXXXXXXXXXXXXXXXXXXXXXXXXXXXXXXXXXXXXXXXXXXXXXXXXXXXXXXXXXXXXXX