--------------------------------------------------------------------------------------------------------------------------------------------
--------------------------------------------------------------------------------------------------------------------------------------------
--------------------------------------------------------------------------------------------------------------------------------------------
--------------------------------------------------------------------------------------------------------------------------------------------
------------------------------E-------------------------------------------------------------------------------------------------------------
------------SQS----------SSSSSQS-SSS---S?S-----Q-----SSS-------------SSSS------SSSSS--------------------------------------------------------
--------------------------------------------------------------------------------------------------------------------------------------------
--------------------------------------------------------------------------------------------------------------------------------------------
--------------------------------------------------------------------------------------------------------------------------------------------
--SSS----S---------SS---SSS-X-------------SS---S--------Q--Q----------SS----S-S-------------------------------------------------------------
----------------------------------------------------------------------------------------------------------------X---------------------------
-------------------------------------------------------<----------------------------------------------------------<>-------------<>---------
--------------EEEE-----E-------------------E----E-EE---[---E------------------------------------------------------[]-------------[]---------
XXXXXXXXXXXXXXXXXXXXXXXXXXXXXXXXXXXXXXXXXXXXXXXXXXXXXXXXXXXXXXXX-XXXXXXXXXXXXXXXXXXX--XXX---XX-------XX----XXXXXXXXXXXXXXX------XXX--XXXXXXX