--------------------------------------------------------------------------------------------------------------------------------------------
--------------------------------------------------------------------------------------------------------------------------------------------
--------------------------------------------------------------------------------------------------------------------------------------------
--------------------------------------------------------------------------------------------------------------------------------------------
--------------------------------------------------------------------------------------------------------------------------------------------
------------SQ------------------------------S------SS---------?S--------SSSSS--SS---SS-------SSSSSQ----Q------XS----------------------------
--------------------------------------------------------------------------------------------------------------------------------------------
-----------E---------------------------------------------------------------------------------E--------------E-------------------------------
--------------------------------------------------------------------------------------------------------------------------------------------
--SSS----S-S------SS-----S--X------------SQS-------------------Q------S?----------------Q--S?S---------S---XX-----<S-------S?S----Q--Q--Q--Q
------------------------X----------------------------------------------------------------------------------XX-------------------------------
--------<--------------XX----------------------------------------------------------<-----------------------XX-------------------------------
EE------[]--E-E-E-E----XXX-----------------------------E-----------E---------------[-------------EEEEE--E-XXX---E-[]--------E-----E--E------
XXXXXXXXXXXXXXXXXXXXXXXXXXXXXXXXXX---XXXXXXXXXX--XXXXXXXXXXXXXXXX-XXXXXXXXX-XXXXXXXXXXXXXXXXXXXXXXXXXXXXXXXXXXXXXXXXXXXXXXXXXXXXXXXXXXXXXXXX