--------------------------------------------------------------------------------------------------------------------------------------------
--------------------------------------------------------------------------------------------------------------------------------------------
--------------------------------------------------------------------------------------------------------------------------------------------
--------------------------------------------------------------------------------------------------------------------------------------------
--------------------------------------------------------------------------------------------------------------------E-----------------------
---------------------------------------------------------Q----------------------S-------------SSSQQ----Q----------SSSSSS--------------------
--------------------------------------------------------------------------------------------------------------------------------------------
--------------------------------------------------------------------------------------------------------------------------------------------
--------------------------------------------------------------------------------------------------------------------------------------------
-----------------------------------------------------------------Q----SS----S-------S-SSS---SS---------S----------------------S-------------
-----------------------------------------------------------------------------------------------------------XX-------------------------------
-----------------<>--------------------------<>-------<>---------------------------------------------------XX-------------------------------
-----------------[]-------E------------------[]------[[]-------------------------E-E-E-----------EEEEE--E-XXXX----------------------E-------
XXXXXXXXXXXXXXXXXXXXXXXXXXXXXXXXXXXXXXXXXXXXXXXXXXXXXXXXXXXXXXXXXXXXXXXXXXXXXXXXXXXXXXXXXXXXXXXXXXXXXXXXXXXXXXXX---XXXX--------------------X