--------------------------------------------------------------------------------------------------------------------------------------------
--------------------------------------------------------------------------------------------------------------------------------------------
--------------------------------------------------------------------------------------------------------------------------------------------
--------------------------------------------------------------------------------------------------------------------------------------------
--------------------------------------------------------------------------------------------------------------------------------------------
------------------------------------------S--------SS-------------------------------------------SSSQS------SSSQS----------------------------
--------------------------------------------------------------------------------------------------------------------------------------------
----------------------------------------------------------------------------------------------------------E---------------------------------
-------------------------------------------------------------------------XX-----------------------------------------------------------------
-----------------------------S-S-------S-S----S-----Q--Q-SS----<>--------XX-XX------X--Q--Q--Q-----S----S?-----------------X--X----X--------
------------------XX-------------------------------------------[]------XXX--XX---------------------------------------------X--XX---XX-------
-------<>-X------XXXX-----------------------------------X------[]------XXXX-XXX--XXX-----------------------------------<>-XX--XXX--XXX----<>
--E----[]XX-----XXXXX-----------------------E-E---------[------[]----XXXXXXXXXX-XXXX-----------------------------------[]XXX--XXX--XXXX---[]
XXXXXXXXXXXX---XXXXXXXXXXXXXXXXXXXXXXXXXXXXXXXXXXXXXXXXXXXXXXXXXXXXXXXXXXXXXXXXXXXXXXXXXXXXXXXXXXXXXXXXXXXXXXXXX---XXXXXXXXX--XXXXXXXXXXXXXX