--------------------------------------------------------------------------------------------------------------------------------------------
--------------------------------------------------------------------------------------------------------------------------------------------
--------------------------------------------------------------------------------------------------------------------------------------------
--------------------------------------------------------------------------------------------------------------------------------------------
--------------------------------------------------------------------------------------------------------------------------------------------
--------------------------------SSSS--------SSSS--------------------------------------SSSQ---------------------------------SSQ--------------
--------------------------------------------------------------------------------------------------------------------------------------------
--------------------------------------------------------------------------------------------------------------------------------------------
--------------------------------------------------------------------------------------------------------------------------------------------
-SS--------------<>----------------Q------S-----------<>--------<>-------XX-XX------------------------------------SSS---<>---------S--------
-----------------[]-----------------------------------[]--------[]------XXX--XX--XX-------------------------------------[]--------------X---
--------<>-------[]-----------------------------------[]X-------[]-----XXXX--XXXXXX-------------------------------------[]-------------XX---
[-------[]--E----[]-------E------------E--------------[]E-EE--E-[]-----XXXX--XXXXXXX----------------------------E-E---E-[]----EEEE----XXX---
XXXXXXXXXXXXXXXXXXXXXXXXXXXXXXXXXXXXXXXXXXXXXX-XXXXXXXXXXXXXXXXXXXXXXXXXXXXXXXXXXXXX------XX--------------------XXXXXXXXXXXXXXXXXXXXXXXXXXXX