--------------------------------------------------------------------------------------------------------------------------------------------
--------------------------------------------------------------------------------------------------------------------------------------------
--------------------------------------------------------------------------------------------------------------------------------------------
--------------------------------------------------------------------------------------------------------------------------------------------
--------------------------------------------------------------------------------------------------------------------------------------------
-----SSS--SSSSSSSSS-----SSS---SSS-----------------------SSS---SS-------------------XSS----SS-S-SQ---SSSSS--------QQ-------SSQQ--------------
-----------------------------------------------------------------------------------X--------------------------------------------------------
----------------------------------------------------------------------------------XX----------------------------------------------------E---
-----------------------------------------------------------------------------------X--------------------------------------------------------
--------------------S-S----------------------------------------Q--Q-----------XX--XX-------Q--Q-----X--X----------------SS---------S---XX---
----------------------------------------------------------------------XX-----XXX--XX--------------XX---XX------------------------------XX---
----------------------------------------------------------------------XXX---XXXX--XX--------------XXX---XX-----<---------------------X--X---
------------------------------------------------------------------EE-XXXX--XXXXXX-XX-------E--EE-XXXX--XXXXX---[-------------E-E-E--EXXX----
XXXXXXXXXXXXXXXXXXXXXXXXXXXXXXXXXXXXX-------------XX--XXXXXXXXXXXXXXXXXXX--XXXXXXXXXXXXXXXXXXXXXXXXXXX-XXXXXXXXXXXXXXXXXXXXXXXXXXXXXXXXXXXXX