--------------------------------------------------------------------------------------------------------------------------------------------
--------------------------------------------------------------------------------------------------------------------------------------------
--------------------------------------------------------------------------------------------------------------------------------------------
--------------------------------------------------------------------------------------------------------------------------------------------
--------------------------------------------------------------------------------------------------------------------------------------------
------------------------------------------------------------S-S---------------------SSSSSSSS--------SSSSS----------------------------------X
------------------------------------------------------------------------------------------------------------------------------------------XX
-----------------------------------------------------------------------------------------------------------------------------------------XXX
-----------------------------------------------------------------------------------------------------------------------------------------XXX
--------->-----------SS------------------------X----------------------Q---------------------------S--------------------<>-Q-----X----XXX-XXX
--[>-------------------------------->---------XX-----------------------------------------------------------------------[]------XXX---XXX-XXX
--[]----[]------------------X------<>-X-----XXXXX-----<>-------------------------------------------------------<-------[]-----XXXX--XXXX-XXX
--[]----[]-----E-E----------]-EE---[]XX-----XXXXXX----[]---------------------------------------E--------E------[-----E-[]-E--XXXXX-XXXXXXXXX
XXXXXXXXXXXXXXXXXXXXXXXXXXXXXXXXXXXXXXXX--XXXXXXXXXXXXXXXXXXXXXXXXXXXXXXXXX--XXXXXXXXXXXXXX---XXXXX--------X---XXXXXXXXXXXXXXXXXXXXXXXXXXXXX