--------------------------------------------------------------------------------------------------------------------------------------------
--------------------------------------------------------------------------------------------------------------------------------------------
--------------------------------------------------------------------------------------------------------------------------------------------
--------------------------------------------------------------------------------------------------------------------------------------------
--------------------------------------------------------------------------------------------------------------------------------------------
------------SSSQ-------SSSSSSSSSSSSS----------------------SSSQ--------------------------------------S---------------------------------------
--------------------------------------------------------------------------------------------------------------------------------------------
----------------------E---------------------------------------------------------------------------------------------------------------------
--------------------------------------------------------------------------------------------------------------------------------------------
Q-<>--Q--Q----SS----S?SQS-----------------X----X---X------------------X----X------<>--------------------------->-------<>--------XX---------
--[]--------------------------------------XX---XXX-----X--------------X---XXX-----[]---------------------------]-------[]-------XX----------
--[]--------------------------------------XXX--XXXX---X<-------<>-X------XXXXX----[]--------------------------[]-------[]------XXXX---------
--[]-------------------------------[E-EX--XXX--XXXXX--XX-------[]-X-----XXXXXXX---[]--------------------------[]-------[]-----XXXXXX--------
XXXXXXXXXXXXXXXXXXXXXXXXXXXX--XXXXXXXXXX--XXX--XXXXXXXXX--XXXXXXXXXX--XXXXXXXXXXXXXXXXXX---XXX-----XXX---XXXXXXXXXXXXXXXXXXXXXXXXXXXXXXXXXXX