--------------------------------------------------------------------------------------------------------------------------------------------
--------------------------------------------------------------------------------------------------------------------------------------------
--------------------------------------------------------------------------------------------------------------------------------------------
--------------------------------------------------------------------------------------------------------------------------------------------
--------------------------------------------------------------------------------------------------------------------------------------------
----------------------------S-----?S--SSSS--SSSQS------------------------------------------------Q------------------------------------------
--------------------------------------------------------------------------------------------------------------------------------------------
--------------------------------------------------------------------------------------------------------------------------------------------
--------------------------------------------------------------------------------------------------------------------------------------------
---------------------SSQ--------Q--SS----------S---------SQ--------------<>-----------<>----->-S--------SSSQS-----------<>-------XX---------
-------------------------------------------------------------------------[]-----------[]-----]--------------------------[]------XXX--X------
X------<>------XX--X-------------------------------XXXX-X-------<>-------[]------<>---[]----[]------------------X-------[]-----XXXX--XX-----
--EE---[]X-----XX--X-----------------------E----E--XXXXXE-E-----[]--E----[]------[]---[]----[]----E-E-----------E-EE--E-[]----XXXXX---XX----
XXXXXXXXXXXXXXXXXXXXXXXXXXXXXXXXXXXXXXXXXXXXXXXXXXXXXXXXXXXXXXXXXXXXXXXXXXXXXXXXXXXXXXXXXXXXXXXXXXXXXXXXXXXXXXXXXXXXXXXXXXXXXXXXXXXXXXXXXXXX