--------------------------------------------------------------------------------------------------------------------------------------------
--------------------------------------------------------------------------------------------------------------------------------------------
--------------------------------------------------------------------------------------------------------------------------------------------
--------------------------------------------------------------------------------------------------------------------------------------------
--------------------------------------------------------------------------------------------------------------------------------------------
----------------SSQ------------------S?----------------X--------------SQ-------SSS----SSS-----------------------------------------------SSS-
------------------------------------------------------XX------------------------------------------------------------------------------------
-----------------------------------------------------XXX----------------------E-------------------------------------------------------------
-----------------------------------------------------XXX------------------------------------------------------------------------------------
-----------------------------------<>-Q-----XX--XXXX-XXXQ--Q--Q--Q---S?S----S---Q----------------------X--------Q--Q--Q--Q----SS----S-------
-----------------------------------[]------XXX---XXX-XXX-----------------------------------------------X------------------------------------
---------------------------<-------[]-----XXXX--XXXXXXXX-----------------------------------------------XX-----------------------------------
---------------------------[-E---E-[]----XXXXX--XXXXXXXX----------------E--------E-E-------------------XXX----------------------------------
XXXXXXXXX-----------XXXXXXXXXXXXXXXXXXXXXXXXXXXXXXXXXXXXXXXXXXXXXXXXXXXXXXXXXXXXXXXX---XX-XXX----------XXXXXXXXXXXXXXXXXXXXXXXXXXXXXXXXXXXXX