--------------------------------------------------------------------------------------------------------------------------------------------
--------------------------------------------------------------------------------------------------------------------------------------------
--------------------------------------------------------------------------------------------------------------------------------------------
--------------------------------------------------------------------------------------------------------------------------------------------
----E---------------------------------------------------------------------------------------------------------------------------------------
SSSSSSSS-----SS-SSSSS---SSSS-----SSS-----------------------QS---------------------------------------------------SSSSSSS---------------------
--------------------------------------------------------------------------------------------------------------------------------------------
--------------------------------------------------------------------------------------------------------------------------------------------
--------------------------------------------------------------------------------------------------------------------------------------------
X-------------S?----------------------Q--------X----------------------X----X--X---<>------------QS-------SS----S-------------SQ-------------
-------------------------------------------X---XX------------------X--XX---XXX----[]--------------------------------------------------------
---------------------------<--------------XXX--XXX-------------<>-X---XXX--XXX----[]--------------------------------------------------------
---------------------------[-------E--EE-XXX---XXXX------------[]XXX--XXX-XXXXX---[]------------------E-----------------------------------EE
XXXXXX----XXXXXX-XX---XXXXXXXXXXXXXXXXXXXXXXXXXXXXXXXXXXXXXXXXXXXXXX--XXXXXXXXXXXXXXXXXXXXXXXXXXXXXXXXXXXXXXXXXXXXXXX---XXXXXXXXXXX--XXXXXXX