--------------------------------------------------------------------------------------------------------------------------------------------
--------------------------------------------------------------------------------------------------------------------------------------------
--------------------------------------------------------------------------------------------------------------------------------------------
--------------------------------------------------------------------------------------------------------------------------------------------
--------------------------------------------------------------------------------------------------------------------------------------------
----------SSSQQ----Q----------------------------------------SSSS-----SSSSSS----SSSSS---------SSSQS-----Q-----SSS??----------SSSQ--SQ--------
--------------------------------------------------------------------------------------------------------------------------------------------
------------------------------------------------------------------------------------------------------------E-------------------------------
--------------------------------------------------------------------------------------------------------------------------------------------
--SSS--SSS---------SQ----SS-----------------------------X-------------SS----------------Q--SSS----------S-S?S---?--Q--Q--Q-----S---SS-------
------------------------X-----------------------------------------------------------------------------------------------------------------XX
-----------------------XX--------------------<>------->----------------------------------------------------------------------------------XXX
-E-----------EEEEE--E--XX--------------------[]-------]------------------------------------------E-E-E--------------------------E-------XXXX
XXXXXXXXXXXXXXXXXXXXXXXXXXXX-------XX------XXXXXXXXXXXXXXXXXXX----XXXXX--XX---XXXXXXXXXXXXXXXXXXXXXXXXXXXXXXXXXXXXXXXXXXXXXXXXXXXXXXXXXXXXXX