--------------------------------------------------------------------------------------------------------------------------------------------
--------------------------------------------------------------------------------------------------------------------------------------------
--------------------------------------------------------------------------------------------------------------------------------------------
--------------------------------------------------------------------------------------------------------------------------------------------
--------------------------------------------------------------------------------------------------------------------------------------------
-------------Q-----------------------S?------------------------------SSQ-------SSS-SSQ----?S---------SSSS-----------------------------------
-------------------------------------------------------X------------------------------------------------------------------------------------
-----------E-------------------------------------------X-------------------------------------------------------------------------X----------
------------------------------------------------------XX------------------------------------------------------------------------------------
S--SS----S?S-S----S--Q--Q--Q-S-----<>--------X---XX--XXXX-------------------SSSQ------------------SS----------<>-------<>-------X--XX-------
-----------------------------------[]-------XX---XX--XXX------------------------------------------------------[]-------[]------XXX-XX-------
------------------------------------]------XXXX--XXXXXXX------------------------------------------------------[]-------[]-----XXXX-XXX------
----------------E-E--E-------E---E-[]-----XXXXX-XXXXXXXX-------------------------------------------E----------[]---E---[]----XXXXX-XXXX-----
XXXXXXXXXXXXXXXXXXXXXXXXXXXXXXXXXXXXXXXXXXXXXXXXXXXXXXXXXXXXX----XXXXXXXXXXXXXXXXXXXXXXXXXXX-XXXXXXXXXXXXXXXXXXXXXXXXXXXXXXXXXXXXXXXXXXXXXXX