--------------------------------------------------------------------------------------------------------------------------------------------
--------------------------------------------------------------------------------------------------------------------------------------------
--------------------------------------------------------------------------------------------------------------------------------------------
--------------------------------------------------------------------------------------------------------------------------------------------
----E---------------------------------------------------------------------------------------------------------------------------------------
--SSSSSS--------SSQS-----------------------------------X--------------------------------------------------------SSSSS-----------------------
-------------------------------------------------------X------------------------------------------------------------------------------------
------------------------------------------------------XX------------------------------------------------------------------------------------
-------------------------------------------------------X------------------------------------------------------------------------------------
--------------------------------------------------XX-XXX-SS----QS-Q--------------------------------------------S----------------------------
-------------------------------------------XX---XXXX--XX---------------------------------------------<>-------------------------------------
--------------------------<>-------<>-----XXXX--XXXX-XXX------------------------------<>----<>-------[]-----------------------------------<>
--------------------------[]---E---[]-E---XXX--XXXXXXXXX-----E-E-----E-E--------------[]----[]-------[]-----------------------------------[]
XXXX--------XX-------------XXXXXXXXXXXXXXXXXXXXXXXXXXXXXXXXXXXXXXXXXXXXXXXXXXXXXXXXXXXXXXXXXXXXXXXXXXXXXXXXXXXXXXXXX----XXX---------XXXXXXXX