--------------------------------------------------------------------------------------------------------------------------------------------
--------------------------------------------------------------------------------------------------------------------------------------------
--------------------------------------------------------------------------------------------------------------------------------------------
--------------------------------------------------------------------------------------------------------------------------------------------
--------------------------------------------------------------------------------------------------------------------------------------------
--------------------------------------------------------SSSSSSSS-------------------------SS-------SSSQS----SSSQS----------SSSS--------------
--------------------------------------------------------------------------------------------------------------------------------------------
--------------------------------------------------------------------------------------------------------------------------------------------
----------------------S---------------------------------------------------------------------------------------------------------------------
-SS--------------<>--------------------X--X-X--X------------------------------------X--Q--Q--Q----QS----S-----------S--SSS---------SS----SS-
--------<>-------[]--------------------X--XX---XX-------------------------------------------------------------------------------------------
X-------[]-------X]----------------<>-XX--XXX--XXX----[]------------------------------------------------------------------------------------
E]E---E-[]-------[X-------E----E---[]XXX-XXXX--XXXX---[]--------------------X----------------------------------E-E-----------EEEE------E----
XXXXXXXXXXXXXXXXXXXXXXXXXXXX--XXXXXXXXXXXXXXXX-XXXXXXXXX--XXXXX-------X------------XXXXXXXX-XXXXXXXXXXX--XXXXXXXXXXXXXXXXXXXXXXXXXXXXXXXXXXX