--------------------------------------------------------------------------------------------------------------------------------------------
--------------------------------------------------------------------------------------------------------------------------------------------
--------------------------------------------------------------------------------------------------------------------------------------------
--------------------------------------------------------------------------------------------------------------------------------------------
--------------------------------------------------------------------------------------------------------------------------------------------
--------------------------------------------------------SSQ------Q------------------SSSSSSSS--------SSSSS-----------------------------------
--------------------------------------------------------------------------------------------------------------------------------------------
--------------------------------------------------------------------------------------------------------------------------------------------
--------------------------------------------------------------------------------------------------------------------------------------------
--------S>-------X------------------------S--------------------<>-Q-----XX-XX---------------------S-----------------------------------------
--------[-------XX---------------------------------------------[]------XXX--XX---------------------------------X-----------------<>---------
--------[------XXX------------<>-------------------------------[------XXXX--XXX--------------------------X----[<-----------------[]---------
E-E-----[]----XXXX------------[]-------E-------X-------------E-E]-E--XXXXX-XXXXX------------------------EXX---[[------------E----[]-------E-
XXXXXXXXXXXXXXXXXXXXXXXXXXXXXXXXXXXXX---X-X-----------XXXXXXXXXXXXXXXXXXXXXXXXXXXXXXXXXXXXX---XXXXXXXX-XXXXXXXXXXXXX---XXXX---XXXXXXXXXXXXXX