--------------------------------------------------------------------------------------------------------------------------------------------
--------------------------------------------------------------------------------------------------------------------------------------------
--------------------------------------------------------------------------------------------------------------------------------------------
--------------------------------------------------------------------------------------------------------------------------------------------
--------------------------------------------------------------------------------------------------------------------------------------------
------------------------S---SSSSSSSS-------------------X------------------------------------------------------------------------------------
--------------------------------------------------------------------------------------------------------------------------------------------
--------------------------------------------------------------------------------------------------------------------------------------------
--------------------------------------------------------------------------E---S-------------------------------------------------------------
X-----------QSQS--------------------------X-X--X--XX---------------------XX---------------------------------------------<>-------<>---------
------------------------------------------XX----XXXX--XX-------<>-------XXX---------------------------------------------[]-------[]---------
-----------------------------------<>-----XXX---XXXX--XXX------[]-------XXXX----------------------------------->--------[]-------XX---------
-----------------------------------[]-EX-XXXX--XXXXX--XX]-EE---[]------XXXXXX---------------------------------[]E-EE--E-[]-----X-XX---------
XXXXX----XXXXXX-XXX--XXXXXXX--XXXXXXXXXXXXXXX--XXXXXXXXXXXXXXXXXXXXXXXXXXXXXXXXXXXXXXXXXXXXXXXXXXXXXXXXXXXXXXXXXXXXXXXXXXXXXXXXXXXXXXXXXXXXX