--------------------------------------------------------------------------------------------------------------------------------------------
--------------------------------------------------------------------------------------------------------------------------------------------
--------------------------------------------------------------------------------------------------------------------------------------------
--------------------------------------------------------------------------------------------------------------------------------------------
------------------------------------------------------------E-------------------------------------------------------E-----------------------
--Q-----------SQS------SSSQS--------------SQSQ-----SSS--SSSSSSSS--------S-----------------------------------SSS---SSSQS---------------------
--------------------------------------------------------------------------------------------------------------------------------------------
----------------------E---------------------------------------------------------------------------------------------------------------------
--------------------------------------------------------------------------------------------------------------------------------------------
X--Q--Q--Q---S?S----S----------------Q----SS----S-------------------------------------SSS---SS----------S---------------------X----X--------
---------------------------------------------------------------------------------------------------------------------------X--XX---XX-------
-----------------------------------------------------------------------------X-----<-----------------------------------<>-XX--XXX--XXX----<>
-------------------------E-E------------------------------------------------EX-----[-------------EEEE------------------[]XXX---XX--XXXX---[]
XXXXXXX--XXXXXXXXXXXXXXXXXXXXXXXXXXXXXXXXXXXXXXXXXXXXXXX---X-----------------------XXXXXXXXXXXXXXXXXXXXXXXXXXXXX---XXXXXXXXX--XX---XXXXXXXXX