--------------------------------------------------------------------------------------------------------------------------------------------
--------------------------------------------------------------------------------------------------------------------------------------------
--------------------------------------------------------------------------------------------------------------------------------------------
--------------------------------------------------------------------------------------------------------------------------------------------
--------------------------------------------------------------------------------------E-E---------------------------------------------------
----SSS---------SSQS------------------------------------------------SQ--------------SSSSSSSS--------SSQSS-----------------S-SQ--------------
--------------------------------------------------------------------------------------------------------------------------------------------
--------------------------------------------------------------------------------------------------------------------------------------------
--------------------------------------------------------------------------------------------------------------------------------------------
------------------------------->-------S-----<>--Q-----S--SSS----S--------S--Q-----S--------------S-----------<>-SSSS---S>---------SQ----SS-
------------------------------[]-------------[]---------------------------------------------------------X-----[]---------]------------------
------------------------------[]----<>-------[]---------------------------------------------------------XX----[]----------------------------
------------------------------[]----[]-------[]---------EEE---------E-E-E-E--E-----------------E-------XXXX---[[-E------------EEEE--E--E----
--XX-----------------------XXXXXXXXXXXXXXXXXXXXXXXXXXXXXXXXXXXXXXXXXXXXXXXXXXXXXXXXX-XXXXXX----XXXXX----XXXXXXXXXXXXXXXXXXXXXXXXXXXXXXXXXXXX