--------------------------------------------------------------------------------------------------------------------------------------------
--------------------------------------------------------------------------------------------------------------------------------------------
--------------------------------------------------------------------------------------------------------------------------------------------
--------------------------------------------------------------------------------------------------------------------------------------------
--------------------------------------------------------------------------------------------------------------------------------------------
----------------------------SS------------------------XX--------------------------------------------------------SSSSSSSS--------SSSS-------X
-------------------------------------------------------X-----------------------------------------------------------------------------------X
----------------------------------------------------XX------------------------------------------------------------------------------------XX
---------------------------------------------------XX------------------------------------------------------------------------------------XXX
-----------------<>----------------QS-Q-----X------XX----SS--------------XX----------------------------X---------------Q--------------XX-XXX
-----------------[]------<>----------------XX---XX-X--XX-----------------XX----------------------------X------------------------------XX-XXX
--------<>-------[]------[]---------------XXX---XXXX---X--------<>-------[]----------------<>------XX--XX----------------------------XXX-XXX
E-E]----[]-------[]-----E[]------E-EE-E--XXXX--XXXXXX-XX[-------[]-------[X-------E---EE---[]-E----XX--XX------------------E---E----XXXXXXXX
XXXXXXXXXXXXXXXXXXXXXXXXXXXXXXXXXXXXXXXXXXXXXX-XXXXXXXXXXXXXXXXXXXXXXXXXXXXXXXXXXXXXXXXXXXXXXXXX--XXXXXXXXXXXXXXXXXXXXXXXXXXXXXXXXXXXXXXXXXX