--------------------------------------------------------------------------------------------------------------------------------------------
--------------------------------------------------------------------------------------------------------------------------------------------
--------------------------------------------------------------------------------------------------------------------------------------------
--------------------------------------------------------------------------------------------------------------------------------------------
--------------------------------------------------------------------------------------------------------------------------------------------
----------SSQS-----Q------SS----------SSSSSSSSSSS--SS---------------SSS---------QSQS--------------------------------------------------------
--------------------------------------------------------------------------------------------------------------------------------------------
-------------------------------------E-----------------------------E------------------------------------------------------------------------
--------------------------------------------------------------------------------------------------------------------------------------------
-----------------------X--------S--S?S---------SS-------Q-<>-----S?S--------S?SQSSSQ-----------------<>------------------------------SS-----
-----------------------X----------------------------------[]-----------------------------------------[]------X>-----------------------------
---------------------X-----<------------------------------[]------------------------X-------<>-------[]-----X[]-----------------------------
---E---------E-E-E--EXXX---[----------------E-------EEEE--[]----------E-E----E------E-E-----[]-------[]-----XXX----]------------------------
XXXXXXXXXXXXXXXXXXXXXXXXXXXXXXXXXXXXXXXXXXXXXXXXXXXXXXXXXXXXXXXXXXXXXXXXXXXXXXXXXXXXXXXXXXXXXXXXXXXXXXXXXXXXXXXX---XXX------XX---XX--XXXXXXX