--------------------------------------------------------------------------------------------------------------------------------------------
--------------------------------------------------------------------------------------------------------------------------------------------
--------------------------------------------------------------------------------------------------------------------------------------------
--------------------------------------------------------------------------------------------------------------------------------------------
--------------------------------------------------------------------------------------------------------------------------------------------
-----------------------------QQ-------------------------SSSSSSSS--------SSSSS---------------------------------------------------------------
--------------------------------------------------------------------------------------------------------------------------------------------
--------------------------------------------------------------------------------------------------------------------------------------------
----------------------------------------------------------------------------------------------------------------------------------E---S-----
Q--Q--Q--Q---------------------------------------X---X----------------S-----------<X-SS--------------<>-------------------------------------
--------------------------XX------------------X--XX--XX---------------------------[X-----------------[]------<>-------------------XX--------
-----------------------XXXXX-----------------[]---XXXXX----------------------X----[]-----------------[]------[]-X------<>-X-----XXXX--------
---E-------------------XXXXX-----------------[]---XXXXX------------E---E----EXX---XX------------E----[]------[]---E----[]XX-----XXXXX-------
XXXXXXXXXXXXXXXXXXXXXXXXXXXXXXXXXXXXXXXXXXXXXXXXXXXXXXXXXXXXXXXXXXXXXXXXXX-XXXXXXXXXXXXXXXXXXXXXXXXXXXXXXXXXXXXXXXXXXXXXXXXX--XXXXXXXXXXXXXX