--------------------------------------------------------------------------------------------------------------------------------------------
--------------------------------------------------------------------------------------------------------------------------------------------
--------------------------------------------------------------------------------------------------------------------------------------------
--------------------------------------------------------------------------------------------------------------------------------------------
--------------------------------------------------------------------------------------------------------------------------------------------
--------------SSSSSS---SS------------SSSQS------------SS------------------------------------------------------------------------SSSS--------
--------------------------------------------------------------------------------------------------------------------------------------------
--------------------------------------------------------------------------------------------------------------------------------------------
--------------------------------------------------------------------------------------------------------------------------------------------
X--Q--Q--Q----SS-------------SS-Q--?S-Q---------------------------------------------X-----------QS----------------------------SS------------
---------------------------------------------------X----------------------------------------------------------------------------------------
-------------------------------------------------XX------------<>>------------------------------------------------------------------------->
-------------------------E-E-E---E-E-----EXE-E--XXXX------EE---[]]-------]----------------------------E-------E----------------------------E
XXXXXXXXXXXXXXXXXXXXXXXXXXXXXXXXXXXXXXXXXXXXXXXXXXXXXXXXXXXXXXXXXXXXXXXXXXXXXXXXXXXXXXXXX---XXXXXXXXXXXXXXXXXXXXXXXXXXXXXXXXXXXXXXX-XXXXXXXX