--------------------------------------------------------------------------------------------------------------------------------------------
--------------------------------------------------------------------------------------------------------------------------------------------
--------------------------------------------------------------------------------------------------------------------------------------------
--------------------------------------------------------------------------------------------------------------------------------------------
--------------------------------------------------------------------------------------------------------------------------------------------
----------------------------SS-------SSSQS-----Q------SS-SS-SSSS--------SSSSS-----------------------------------------------QS-----Q------SS
-----------------XX-------------------------------------------------------------------------------------------------------------------------
-----------------XXX------------------------------------------------------------------------------------------------------------------------
-----------------XXXX-----------S-----------------------------------------------------------------------------------------------------------
------------------XXX-----<>----Q--SSS---------SQ-----------------Q---S-----------<>-------------------------------Q---------------S---XX---
-------<>------XXXXXX-----[]------------------------------------------------------[]--------------------------------------------------XXX---
X------[]-----XXXXXXXX----[]------------------------------------------------XX----[]--------------------------<>---------------------XXXX--<
[--E---[]-X---XXXXXXXXX---[]-------------E-E-E--E-EE---E----------EE---E----XXX---[]--------------------------[]-------------E-E-E--EXXXX--[
XXXXXXXXXXXXX-XXXXXXXXXXXXXXXXXXXXXXXXXXXXXXXXXXXXXXXXXXXXXXXXXXXXXXXXXXX--XXXXXXXXXXXX-----X------XXX---XXXXXXXXXXXXXXXXXXXXXXXXXXXXXXXXXXX