--------------------------------------------------------------------------------------------------------------------------------------------
--------------------------------------------------------------------------------------------------------------------------------------------
--------------------------------------------------------------------------------------------------------------------------------------------
--------------------------------------------------------------------------------------------------------------------------------------------
--------------------------------------------------------------------------------------------------------------------------------------------
----------------------------------------SQ--------------------------------------------------------------------------------------------------
--------------------------------------------------------------------------------------------------------------------------------------------
--------------------------------------------------------------------------------------------------------------------------------------------
--------------------------------------------------------------------------------------------------------------------------------------------
-------<>-Q---X-X--X----------SSS---<>--------SS-----SS-------------QS---------------SS-----S--------XX------X------------------------------
-------[]--X--XXX--XXX--------------[]--------------------------------------------------------------XX-------X------------------------------
-------[]--X--XXX--XXX-----<--------[]-------------------------------------------------------------XXXX----XXXX------------------<>---------
---E-E-[]-EX-XXXX--XXXX----[EE----E-[]----E-E-E----E-E--------------------------------------[]----XXXXX---XXXXX-------------E----[]---------
XXXXXXXXXXXXXXXXXXXXXXXXXXXXXXXXXXXXXXXXXXXXXXXXXXXXXXXXXXXX----XX-------XX---XX--XXXXXXXXXXXXXXXXXXXXXXXXXXXXXXXXXX---XXXXX--XXXXXXXXXXXXXX