--------------------------------------------------------------------------------------------------------------------------------------------
--------------------------------------------------------------------------------------------------------------------------------------------
--------------------------------------------------------------------------------------------------------------------------------------------
--------------------------------------------------------------------------------------------------------------------------------------------
--------------------------------------------------------------------------------------------------------------------E-----------------------
---------?----------------------------------------------S----SSS--------SSSSS---SSSS----------------------------SSSSSSSS--------SSQ---------
--------------------------------------------------------------------------------------------------------------------------------------------
--------------------------------------------------------------------------------------------------------------------------------------------
-----------------------------------------------------------------------------------------------------X--------------------------------------
-SS----<>>-------X--X------------------------------------------Q------S--------------------<>-------X--XX---------------------S-------------
-------[]]------XX--XXXXXX-----------------------------------------------------------------[]------XXX-XXX----------------------------------
--------]------XXX---XXXXX----------------------------------------------------------X------[]-----XXXXXXXXX----X--------------------------<>
[E---EE[]-----XXXX--XXXXXX-----------------------------------------E---E------------]-EE---[]----XXXXXXXXXX---XX--------------------XX----[]
XXXXXXXXXXXXXXXXXXXXXXXXXXXXXXXX--XXX-----XXXX--XXXXXXXXXXXXXXXXXXXXXXXXXXXXXXXXXXXXXXXXXXXXXXXXXXXXXXXXXXXXXXXX---XX-----------------------