--------------------------------------------------------------------------------------------------------------------------------------------
--------------------------------------------------------------------------------------------------------------------------------------------
--------------------------------------------------------------------------------------------------------------------------------------------
--------------------------------------------------------------------------------------------------------------------------------------------
----E---------------------------------------------------------------------------------------------------------------------------------------
--SSSSS------------------------------------------------------------------------------------------Q----------------------------S---------QSSS
--------------------------------------------------------------------------------------------------------------------------------------------
--------------------------------------------------------------------------------------------------------------------------------------------
--------------------------------------------------------------------------------------------------------------------------------------------
X-------------------------------------------------------------------------------------SS-------S------S--Q--Q--S--<>-----Q-S--------S?SQS---
----------------------------X-----------------XX------------------------------------------------------------------[]------------------------
----------------------------X------<>--------XXX------------------------------------------------------------------[]------------------------
----------------------------]-E----[]XX-----XXXX--------------------------------------------[]--E-E-E-E--E--------[]------------E-----------
----------------------------XXXXXXXXXXXX--XXXXXXXXXXXXXXXXXXXXXXXXXXXXXXXXXXXXXXXXXXXXXXXXXXXXXXXXXXXXXXXXXXXXXXXXXXXXXXXXXXXXXXXXXXXXXXXXXX