--------------------------------------------------------------------------------------------------------------------------------------------
--------------------------------------------------------------------------------------------------------------------------------------------
--------------------------------------------------------------------------------------------------------------------------------------------
--------------------------------------------------------------------------------------------------------------------------------------------
--E-----------------------------------------------------------------------------------------------------------------E-----------------------
SSSSSSSS--------SSSSS-----------------------SSSS-----------------------------------------------------------------SSSSSSS--------------------
--------------------------------------------------------------------------------------------------------------------------------------------
--------------------------------------------------------------------------------------------------------------------------------------------
--------------------------------------------------------------------------------------------------------------------------------------------
--------------S--------------SQ-----------S-----------<>--SS----->-S------S--Q--Q--Q-------------------X------------------------------S-----
------------------------------------------------------[]--------[]-----------------------------X---X--XX------------------------------------
---------------------X-----<--------------------------[]--------[]------------------X------<>-X-----XXXXX-----------------------------------
-----------E---E----EXX----[------------------------E-[]E-EE----[]----E-E-E-----------EE---[]XX-----XXXXX-----------------------------------
XXXXXXXXXXXXXXXXXXXXXXXXXXXXXXXXXXXXXXXXXXXXXXXXXXXXXXXXXXXXXXXXXXXXXXXXXXXXXXXXXXXXXXXXXXXXXXXX--XXXXXXXXXXXXXXXXXXXXXXXXXXXXXXXXXXXXXXXXXX