--------------------------------------------------------------------------------------------------------------------------------------------
--------------------------------------------------------------------------------------------------------------------------------------------
--------------------------------------------------------------------------------------------------------------------------------------------
--------------------------------------------------------------------------------------------------------------------------------------------
--------------------------------E-----------------------------------------------------------------------------------------------------------
----------------------------SSSSSSSS--------S-------------------------SQ-------SSSQSS-------------S---------Q-------------------------------
--------------------------------------------------------------------------------------------------------------------------------------------
------------------------------------------------------------------------------E-------------------------------------------------------------
--------------------------------------------------------------------------------------------------------------------------------------------
-----------------XX-----------------------S-----------<-X--Q--Q--Q----QS----S?S------------S-S-----S---SS----SS-----------------X--X--------
--->----<>------XXX-----------------------X-----X------]-----------------------------------------------------------------------XXX-XXX------
--[]----[]------XXX-----------------------------XX----[<---------------------------------------------------------------<>-----XXXX-XXXX----X
--[]----[]-----XXXX-------E-----------EE-------XXXX---[[--------------------------------------------E--------E-E--EE---[]XE--XXXXX-XXXXX--XX
XXXXXXXXXXXXXXXXXXXXXXXXXXXX---XXXX----XX-X----XXXXXXXXXXXXXXX---XXXXXXXXXX--XXXXXXXXXXXXXXXXXXXXXXXXXXXXXXXXXXXXXXXXXXXXXXXXXXXXXXXXXXXXXXX