--------------------------------------------------------------------------------------------------------------------------------------------
--------------------------------------------------------------------------------------------------------------------------------------------
--------------------------------------------------------------------------------------------------------------------------------------------
--------------------------------------------------------------------------------------------------------------------------------------------
----------------------------------------------------------------------------------------E---------------------------------------------------
----------SSSQ----------------------------------------------------------------------SSSSSSSS--------SSS----------------------SSQ-------SQSQS
--------------------------------------------------------------------------------------------------------------------------------------------
--------------------------------------------------------------------------------------------------------------------------------------E-----
--------------------------------------------------------------------------------------------------------------------------------------------
--S-S---<>---------S-------------------------<>--S-----S--------------------------<>--------------S-----------<XQ--Q--Q--Q-----S----S?S-S--Q
--------[]--------------X--------------------[]----------------------------X------[]--------------------------XX----------------------------
--------[]-------------XX------>-------------<]---------X------<>-X--------XXX----[]--------------------------XX----------------------------
EE----E-[]----EEEE----XXX-----[]--------E----[]-----------E----[]XX--------XXXX---[]----------------------X---XX---E------------E----E------
XXXXXXXXXXXXXXXXXXXXXXXXXXXXXXXXXXXXXXXXXXXXXXXXXXXXXXXXXXXXXXXXXXXX--XXX--XXXXXXXXXXXXXXXXXXXXXXXXXXX-XXXXXXXXXXXXXXXXXXXXXXXXXXXXXXXXXXXXX