--------------------------------------------------------------------------------------------------------------------------------------------
--------------------------------------------------------------------------------------------------------------------------------------------
--------------------------------------------------------------------------------------------------------------------------------------------
--------------------------------------------------------------------------------------------------------------------------------------------
--------------------------------------------------------------------------------------------------------------------------------------------
S--------SSSQS-----Q------XX----------------------------------------------------------------------------------------------------------------
-------------------------XXX----------------------------------------------------------------------------------------------------------------
------------------------XXXX---------------------------------------------X------------------------------------------------------------------
-----------------------XXXX-----------------------------------------------------------------------------------------------------------------
----Q--SS-Q------------XXXXX-----------S?S----Q--Q--Q--Q-------<>-------XX-XX---------S-----<>-------XX--------------------------XX---------
----------------------XXXXXX-----------------------------------[]------XXX-XX---------------[]------XX------------------<>-------XX---------
--------------------XXXXXXXX-----------------------------------[]-----XXXX-XXX-----<--------[]-----XXXX---------X-------[]-------XX---------
-E---------E-E-E-E--XXXXXXXX------------------E------------E-E-[]----XXXXX-XXXX----[E-----E-[]-----XXXX---------E-EE----[]------XXX---------
XXXXXXXXXXXXXXXXXXXXXXXXXXXXXXXXXXXXXXXXXXXXXXXXXXXXXXXXXXXXXXXXXXXXXXXXXXXXXXXXXXXXXXXXXXXXXXXXXXXXXXXXXXXXXXXXXXXXXXXXXXXXXXXXXXXXXXXXXXXX