--------------------------------------------------------------------------------------------------------------------------------------------
--------------------------------------------------------------------------------------------------------------------------------------------
--------------------------------------------------------------------------------------------------------------------------------------------
--------------------------------------------------------------------------------------------------------------------------------------------
--------------------------------------------------------------------------------------------------------------------------------------------
------------SSS----Q--------------------------------?---------------------------------------------------------------------------------------
---------------------------------------------------------------------------------------------------------------------------------XX---------
---------------------------------------------------------------------------------------------------------------------------------XXX--------
---------------------------------------------------------------------------------------------------------------------------------XX-X-------
X--Q--Q--Q----SS----S---------SS-----S?S--------S?S-S---------------?--------------S--------------------------------------------XXXXX-------
-------------------------------------------------------------------------<>--------------------------------------------<>------XXX-XX-------
-------------------------------------------------------------------------[]---------X------<>-X-------XX--------X------[]-----XXXXXXXX------
-------------------------E-E----------------E-----------------------E----[]-----------EE---[]XX-----X-XX--------E-EE---[]----XXXXX-XXXX-----
XXXXXXXXXXXXXXXXXXXXXXXXXXXXXXXXXXXXXXXXXXXXXXXXXXXXXXXXXXXX---XXXXXXXXXXXXXXXXXXXXXXXXXXXXXXXXX--XXXXXXXXXXXXXXXXXXXXXXXXXXXXXXXXXXXXXXXXXX