--------------------------------------------------------------------------------------------------------------------------------------------
----------------------------------------------------------------------------------------------------------XXXXXXXXXXX-----------------------
--------------------------------------------------------------------------------------------------------XXXSS????SSSS------------SSSSSSSSSSS
-----------------------------------------------------------------------------------------------------XXXXSS-------------------------[]----[]
-----------------------------------------------------------------------------------------------------XSSS---------------------------[]----[]
SQQS---------------------XXX---------------------------------------------E-E-E--------------S--------X------------------------------[]----[]
------------------------XXX-X-------------------------------------------<><><><>--------------------XX------------------------------<>----[]
-----------------------XXXX--X--------------XXXXX-----------------------[][][][]-------------------XXS------------------------------------[]
--------XXXXXX--------XXXXX---X----------XXXX-<>-X------------------Q?--QQQQQQQQ--------------XXXXXX-------XXXXX-------XX-----------------[]
-SS----XXX--X-X------XXXXXX----X--------XXQQ?-[]--X--------------------------------------Q--XXX---<>------XXXXXX------XX-X----------------[]
------XXXX--XX-X----XXXXXXX-----X------XX-----[]---X--------------------------------XXXX---XX<>---[]-----XXXXXXX-----XX---X---------------<>
-----XXXXX--XXX-X--XXXXXXXX------X----XX------[]----X----------------XXX-----------XX<>-X-XX-[]---[]----XXXXXXXX---XXX-----XX------XXX-----X
XXXXXXXXXX--XXXX-XXXXXXXXXX-------XXXXX--X----[]-----XXXXXXXXXXXXXXXXX--XXXXXXXXXXXX-[]--XX--[]---[]---XXXXXXXXX-----------X-XXXXXXX--XXXXXX
XXXXXXXXXXXXXXXXXXXXXXXXXXXXXXXXXXXXXXXXXXXXXXXXXXXXXXXXXXXXXXXXXXXXXX--XXXXXXXXXXXXXXXX-XXX-XX--XXXXXXXXXXXXXXXX----------XXXXXXXXX--XXXXXX