--------------------------------------------------------------------------------------------------------------------------------------------
--------------------------------------------------------------------------------XXX-------XX------------------------------------------------
-----------------------------SSSSSSSSSSSSSSSSSSSSSSSSSSSSSSSSSSSSSSSSSS--------XX--X-----XX-X-----------------------------------------------
------------------------------------------SSSSSSSSSSSSSSSSSSSS---------------XXX----X---XX---X----XXXXX-------------------------------------
------------------------------------------SSSSSSSSSSSSSSSSSSSS-----------XXX-XX------XXXX-----XXXXX----X------------------------------------
-S----------------------------------------SSSSSSSSSSSSSSSSSSSS--QQ------XXXX-XSS-----XXSS-----SSSSS-----XXXX-----------------------------E--
-----------------------------------------------------------------------XX---XX---------------------------X--X-----XXXX-----XXX----------<>--
--------XXXXX----XXXXX--------------------------XXX----------XXX-XXX--XX-----XS-------------------------<>---X---XX---X---XX--X---------[]--
S-----XXX----X-XXX----X-------------------XXXXXXX?-XXXXXXXXXXX--XX--XXX------S-S------------------------[]----X-XX-----X-XX----XXX------[]--
-----XX<>-----XX<>-----XX----------------XX-SSSSS??SSSSSSSSSSS--QQ--QQQ---------------------------ES----[]-----XX-------XX-----<>-X----SXXS-
----XX-[]----E<>[]----<>-X--------------XX--SSSS---SSSSSSSSSSS-----------------------E------E----<>---E-[]-----<>-------<>-----[]--XX------X
X--XX--[]---<>[][]----[]--X----XXXX-XXXXX---SSSS---SSSSSSSSSSS----------------------<>-----<>----[]--<>-[]-----[]-------[]-----[]-<>-X----XX
-XXX---[]---[][][]----[]---XXXXX---XX--X--------oooSSSSSSSSSSS----------------------[]-----[]----[]--[]-[]-----[]-------[]-----[]-[]--XXXXX-
XXXXXXXXXXXXXXXXXXXXXXXXXXXXXXXX---XX--X---XXXXXXXXXXXXXXXXXXXXXXXXXXXX------XXXXXXXXXXXXXXXXXXXXXXXXXXXXXXXXXXXXXXXXXXXXXXXXXXXXXXXXXXXXXXX