--------------------------------------------------------------------------------------------------------------------------------------------
--------------------------------------------------------------------------------------------------------------------------------------------
SSSSSS--------------------------------------------------------------------------------------------------------------------------------------
-----------------XXXXX----------------------------------------------------------------------------------------------------------------------
---------------XXX----X--------------------------------------ooo-----------XXXX----------------------------------------------------------XXX
--------------XX<>-----X-------------------------------------ooo----------XXX--X------------------------------------------------------E-XX--
-------------XXX[]------X------------------------------------------------XXEX---X------------------------------------------------------XX---
XX-----------XXX[]-------X-----------XXXXXX-----oooo---------XXXX-------XXXXX----X-----------------------------------------------XXXXXXX----
?-XXXXXXXXXXX-XX[]--------X--XXX---XXX--X--X----oooo--------XX---XXXXXXXXXXXX-----X------------------------XXXX-----------------XX----X-----
??SSSSSSSSSS<SXX[]---------XXXS-X-XXXX--X---X-------------EXX---XXXXXXEXXXXXX------X----------------------XX<>-X---------------XX----<>-----
--SSSSSSSSSSSSXX[]----------X----XXXXX--X----XXXXXXXXXXXXXXX----X-------XXXXX-------X-------XXX----------XX-[]--X------------XXX-----[]-----
--SSSSSSSSSSSSXX[]----------SS-SSXXXXX--X----XXXXXXXXXXXXXXX----X-------XXXXX--------X-------X-X--------XX--[]---X----XXXXX-XX<>-----[]-----
ooSSSSSSSSSSSSXX[]--------X-SS-SSXXXXX--X----X-------------X----X-------XXXXX-------X-XXXXXXXX--XXXXXXXXXE--[]----XXXXX----XX-[]--E--[]----X
XXXXXXXXXXXXXXXXXXXXXXXXXXXXXXXX-XXXXX--X----X-------------X----X-------XXXXXXXXXXXXXXXXXXXXXXXXXXXXXXXXXXXXXXXXXXXXXXX---XXXXXXXXXXXXXXXXXX