--------------------------------------------------------------------------------------------------------------------------------------------
--------------------------------------------------------------------------------------------------------------------------------------------
--------------------------------------------------------------------------------------------------------------------------------------------
-----------------------------------------------------------------------------XXXX-----------------------------------------------------------
----------------------------------------------------------------------------XX---X--------------------------------XXXXXXX-------------------
SS--------------------------------------------------SSSSS------SSSSS--------XX----X---------E--------------------XX--SSS-X------------------
--------------------------------------------------SS------------[]---------XX------X----------------------------XX--------X-----------------
-------------------------------------------------SSS------------[]---------X--------X--XXXXXX------------------XX----------X----------------
---------------------E--------------------------SSSS----X---?---[]-------XXX---------XXXXSSS-X----------------XXX-----------X--------XXXX---
--------------------<>-------------------------SSSSS-----X------<>------XX<>----------XXX-----X--------S?S---XXEX----S----X--X------XX<>-X--
-----------------------------------------------------------------------XX-[]---------XXXX------X------------XXXXX---------X---X----XX-[]--X-
XX-------XXX--------------XXXXX--------XXX----XXX------------XXX-E----XX--[]--------XXXXX-------X----------XXXXXX---------XX---X--XX--[]---X
X-XXXXXXXXE-XXXXXXXXXXXXXXX----XXXXXXXXXE-XXXXXB-XXXXXXXXXXXXXB-XXXXXXX---[]-------XXXXXX------X-XXXXXXXXXXXXXXXX---E-E---XX---EXXX---[]----
X-XXXXXXXXXXXXXXXXXXXXXXXXX---XXXXXXXXX<>XXXXXXXXXXXXXXXXXXXXXX-XXXXXXXEXXXX---XXXXXXXXXXXXXXXXXXXXXXXXXXXXXXXXXXXXXXXXXXXXXXXXXXXXXXXXXXXXX