--------------------------------------------------------------------------------------------------------------------------------------------
--------------------------------------------------------------------------------------------------------------------------------------------
--------------------------------------------------------------------------------------------------------------------------------------------
--------------------------------------------------------------------------------------------------------------------------------------------
-----------------------------E------------------------------------------------------------------------------------------------------------XX
-------------------------SSSSSSSSSSS-----------ooo------------------XXX------------------------------------------------------------------XXX
-------------------------------------------------------------------XXX-X----------------------------------------------------------------XX-X
------------------------------------------------------------------XXXX--X------------------------------------------XXXXXXXX------------XXXXX
-----------------------------------------------------------------XXXXX---X----------XXX----------------------------X--X----XX---------XX-XXX
---------------------------XXX---SSSSSSX------------------------XXXXXX----X--------XXQ-X------------------------------?----S-X-------XXXXXXX
--Q-----------------------XXX-X--------------------------------XX-XXXX-----X------XX----X-------------------------------------X-----XX-XXXXX
-Q----------XXX---XXXXX--XX-X--X------------------------------XX--XXXX------X----XX------X--------------S---S-----X------------X---XX--XXXXX
XXXXXXXXXXXXX--XXXX----XXX--X---XXXXXXXXXXXXXXXXXXXXXXXXXXXXXXX---XXXX-------XXXXX--X-----XXXXXXXXXXXXXXXXXXXXXXXXXoooo---------XXXX---XXXXX
XXXXXXXXXXXXX--XXXX--X-XXXXXXXXXXXXXXXXXXXXXXXXXXXXXXXXXXXXXXXXXXXXXXXXXXXXXXXXXXXXXXXXX-XXXXXXXXXXXXXXXXXXXXXXXXXXXXXXX----X--XXXXXXXXXXXXX