--------------------------------------------------------------------------------------------------------------------------------------------
--------------------------------------------------------------------------------------------------------------------------------------------
--------------------------------------------------------------------------------------------------------------------------------------------
--------------------------------------------------------------------------------------------------------------------------------------------
--------------------------------------------XXXXXXXXXXX----------E-E------------------XXXXX-------------------------------------------------
-----------------SSS?SSS-------QQ?---------XX--QQQ?QQQ-X-------SSSSSSS-SS-XXXX-----XXXX--X-X-----------------------------------XX-----------
Q-----------------------------------------XX------------X-------------E--XX---X---XX--E--X--X------------------?---------------[]-----------
S----------------------------------------XX------E-------X--------------XX-----X-XX---XX-X---X---------------------------------[]-----------
?------------------------------SSS-----XXX-----SSSSSSS----X-----------XXX-------XX----XX-X----X-----------------------XXX------[]-----------
Q?QQQQ-----------SSSSSSS------XXXX----XX<>--------------E--X---------XX<>-------<>----XX-X-----X---------------XX----XX--X-----<>SSSSSS-----
-----------------------------XX---X--XX-[]-------X------X---X---E---XX-[]-------[]----XX-X------X-------E---XXX-----XX----X-----------------
--XXXX---XXX---------XXXXXXXXX-----XXX--[]-------X------X----X-----XX--[]-------[]----XX-X-------S---------------B-XX------XX---EXXX--------
XXX---XXXXE-XXXXXXXXXX---X--X-------X---[]----E--X------X-----XXXXXX---[]-------[]----XX-X-------XXXXXXXXXXXXXXXXXXX------XX-XXXXXE-XXXXXXXX
XXX--XXXXXXXXXXXXXXXXX-X-X--X-------XXXXXXXXXXXXXXXXXXXXXXXXXXXXXXXXXXXXX-------XX-XXXXX-XXXXXXXXXXXXXXXXXXXXXXXXXXX------XXXXXXX<>XXXXXXXXX