---------------------------------------------------------------------------XXX--------------------------------------------------------------
--------------------------------------------------------------------------XX--X-------------------------------------------------------------
------------------------------------------------------XXXX------XXXX-----XX----X------------------------------------------------------------
------------------------E----------------------------XX<>-X----XX--XXX--XX------X-ooXXX-----------------------------------------------------
----------------------------------------------------XX-[]--X--XX------XXX--------XXXX--X------------------------------------XXXXX-----------
------------------XXXXXEXXXXX----------------------XXXX[]X--XXX-------XXX--------XXXX---X----------------------------------XXXX--X----------
--------------------------------------------------XX---------X---------------------------X-----------------E------E-------XXXXX---X---------
-------------------XXXXX-------------------------XX--------XXX----------------------------X------------------------------XXXXXX----X--------
E-------------XXXXXX----XXXXXXXX------------XXXX-X-----------------------------------------X----------------------------XXXXXXX-----X-------
QQX----------XXXXXXXEXEEXXXXXXX-X-----------XXXXEXXX----------------------------------------X--------------------------XXXXXXXX---S--X------
-----------XXX-------------------X---------XX------------------------------E-----E-------S---X------XXX---------------XXXXXXXXX-------X-----
----------XXXXX-------------------X----XXXXX------------------------------<>----<>-------S----X----XXB-X-------------XXXXXXXXXX--------XX---
oXXXXXXXXXX------------------------XXXXX--X---------------------XXX-------[]----[]-------S-----XXXXX-b--XXXXXXXXXXXXXXXXXXXXXXX--------X-XXX
XXXXXXXXXXXXXXX---------------XXXXXXXXXXEEXEXX---------------------------X[]X--X[]XXXXX--S-----XXXXXXXXXXXXXXXXXXXXXXXXXXXXXXXXXXXXXXXXXXXXX