--------------------------------------------------------------------------------------------------------------------------------------------
--------------------------------------------------------------------------------------------------------------------------------------------
SE------------------------------E-----------------------------------------------------XXXX--------------------------------------------------
SSS------------------------------------------------------------------------------------[]---------XXXXX-------------------------------------
SSS------------------------------------------------------------------------------------[]-------XXX----X------------------------------------
SSS------------------------------XX----------------------------------------------------<>------XX<>-----X-----------------------------------
SSS-------------------------------------------------------------------------------------------XXX[]------X----------------------------------
SSS-------------------------------------------------------------------------------------E-----XXX[]-------X-----------XXXXXX-----oooo-------
SSS-----------------X----X----X--------------------XXX--------------------------------------XXXXX[]--------X--XXX---XXX--X--X----oooo?------
SSS--------------X--------------------------------XX--X----------------XXXXX----------XXXX-XX<>XX[]---------XXXS-X-XXXX--X---X--------------
SSS---E----------X-------------------------------XX----X--------------XX----XX-------XX---XXX[]XX[]----------X----XXXXX--X----XXXXXXXXXX-XXX
SSS--<>---<>-----X----X-------------------X-----XX------X----XXXXX---XX----<>-X-----XX---<>XX[]XX[]----------SS-SSXXXXX--X----XXXXXXXXX-XX--
SSS--[]---[]-----X----X---------X----------XXXXXX--------XXXXXE---X-XX-----[]--XXXXXX----[]XX[]XX[]--------X-SS-SSXXXXX--X----X---------XX--
XXX--XX---XXXXXXXX----X----XXXXXX---------XXXXXXX--------XXXX<>----XX------XXXXXXXXXX----[]XXXXXXXXXXXXXXXXXXXXXX-XXXXX--X----X----------X--