--------------------------------------------------------------------------------------------------------------------------------------------
-------------------------------------------------------------XXXXXXXXXXXXXXXXXXXXXXXXXXXXXXXXXXXXXXXXX-------------------------------------X
--------------------SSSSSSSSSSSSSSSSS--SSSSSSSSSSSSS--------XXSSSSSSS????SSSSSSSSSSSSSSSSSSSSSSSSSSSSSX-----------------------------------XX
--------------------SSSSSSSSS------------------------------XX------------------------------------------X---------------------------------XX-
-------------------SSSSSSSSSS-------------------------XXX-XX--------------------------------------------X-------------------------------XX--
------------------SSSSSSSSSSS----------------QQ------XXXX-XSSS-------------------------------------------X-----------------------XXXXXXXX---
-----------------------------XXX--------------------XX---XX----------------------------------------------oX--ooo---SSS----------XX?QQQQQQ---
----------------------------XX?-X---------XXX-XXX--XX-----XS-----------------------------------------------X-------------------XX-----------
----XX-----------XX------XXXX----XXXXXXXXXX--XX--XXX------S-S------------------------------------XXX--------X-----------------XX------------
XXXXX-X---------XX-X-XXXXSSSS--?SSSSSSSSSSS--QQ--QQQ---------S-----XXXXX------------------XXX----------------X----------XXXXXXX-------------
Bo-X---X-------XX---XXSSSSSSS---SSSSSSSSSSS-----------------------XXXXXX-----------XXX------------------------X---SSSS-XX--QQQ?---S---------
<>-SS-S-------XX---SSSSSSSSSS---SSSSSSSSSSS-----------------------XXXXXX---XXX----------------------------------------XX--------------------
[]-SS-S-XXXXXXX----------SSSS-ooSSSSSSSSSSS---------------------E-XXXXXX---------------------------------------X-----XX---------------------
XXXXXXXXXXXXXXX---XXXXXXXXXXXXXXXXXXXXXXXXXXXXXXXXXX------XXXXXXXXXXXXXXX-------------------------------XXXX----XXXXXX-------------EE-------