--------------------------------------------------------------------------------------------------------------------------------------------
-------------------------------------------------------------------------------XXX----------------------------------------------------------
-----------------XXXX---------------------------------------------XXXX-----SS-XX--X-----XX--------------------------------------------------
------------------[]---------------------------------------------XX--XXX-----XX----X---XX-X------XXX----XXX---------------------------------
------------------[]-----------------------------------XXXXX----XX------XXXXXX------X-XX---X-XXXXX--XXXXX--X-------------------------XXXXX--
E-----------------[]----------------------------------XX----X--XX-------XXXXXXE------XX-----XX--XX--XXXXX---X---------------------XXXX--X-X-
o-----------------[]---------------------------------XX-E--E-XXX---------------------XX-----XX---------------X-----E-------------XX--E--X--X
b-----------------[]-------------------------------XXX-------XXX----------------------------------------------X-XXXXX-----------XX---XX-X---
?-----------------[]------XXXX--------------------XX-E--------XX-----------------------------------------------XX----X--------XXX----XX-X---
QQQQQQ?QQQQQQQ?Q--<>-----XXX--X------------------XX------------------------------------------------------------XX-----X------XX<>----XX-X---
------------------------XX-X---X----------------XX---------------------------------------------------------------------XE---XX-[]----XX-X---
-----------------------XX--X----X--------------XX-----------------------------------------------------------------------X--XX--[]----XX-X---
XXXXXXXXXXXXXXXXXXXXXXXX--EX-----XXXXXXXXXXXXXXXX-----------------XXX----------XXXX--------------------------------------XXX---[]----XX-X---
XXXXXXEEXXXXXEXEXXXXXXXXXXXX-----XXEXXXXXXXXXXXXX-----------------------------X---------------------XXXXXXXX------------XXXXXXXXXXXXXXX-XXXX