--------------------------------------------------------------------------------------------------------------------------------------------
XXXXXXX-------------------------------------------------------------------------------------------------------------------------------------
SSSSSSS-------------------------------------------------------------------------------------------------------------------------------------
[]------------------------------------------------------------------------------------------------------------------------------------------
[]------------------------------------------------------------------------------------------------XXXXXXXXXXX----------E-E------------------
[]-----------------------------E-----------------------------------------------------------------XX--QQQ?QQQ-X-------SSSSSSS-SS-XXXX-----XXX
[]----------------------------<>----------------------------------------------------------------XX------------X-------------E--XX---X---XX--
[]----------------------------[]---------------------------------------------------------------XX------E-------X--------------XX-----X-XX---
[]----------------------------[]-----------------------------X---------X-EE----X-------------XXX-----SSSSSSS----X-----------XXX-------XX----
[]--------------------------SSXXSS--------------------------XX---------XSSSSSSSX------------XX<>--------------E--X---------XX<>-------<>----
<>---SS-----------------------------------------------------XX-----------------------------XX-[]-------X------X---X---E---XX-[]-------[]----
-E---SS-----------------Q?-------XXXXX--------------Q?-Q---SXX----XXX---------------------XX--[]-------X------X----X-----XX--[]-------[]----
-----SSXXXXXXXXXXXXXXXXXXXXXXXXXXX----XXXXXXXXXXXXXXXXXXXXXXXXXXXXX--XXXXXXXXXXXXXXXXXXXXXX---[]----E--X------X-----XXXXXX---[]-------[]----
XXX--XXXXXXXXXXXXXXXXXXXXXXXXXXXXX---XXXXXXXXXXXXXXXXXXXXXXXXXXXXXX--XXXXXXXXXXXXXEEXEXXXXXXXXXXXXXXXXXXXXXXXXXXXXXXXXXXXXXXXXX-------XX-XXX