------------------------------------------------------------------------------------------------------------XXX-----------------------------
------------------------------------------------------------------------------------------------------------X-XX----------------------------
----------------------------------------------------------------------------------------------------------------XX--------------XXXX--?-----
------------------------------------------------------------------------------------------------------------------X-ooXXX------XX---X---XXX-
-XXX---------------------------------------------------------------------------------------------------------------XXXX--X----XX-----XXXX--X
XX--X-------------------------------------------------------------------XX-----------------------------------------XXXX---X--XX------XXXX--o
X----X----------------------------------S-------------------E----------XX-X------------------------------------------------XXX-------------o
E-----X----oooooo-----------------------------------------------------XX---X----oooooo-------------------------------------XXX--------------
E------X-----XX---------------------------------------------------XXXXX-----X-----XX--------------------------------------------------------
S-------X---XX-X-------------------------------------------------XX--XX------X---XX-X-------------------------------------------------------
b--------X-XX---X------------E------XXXXXX-----------E----------XX---XXX------X-XX---X-----------E-------XXXXX-----E------------------------
B---------XX-----XXX---------------XX---X-X--------------------XX----XXXX------XX-----XXX---------------XX----X---<>---------------------XXX
----------<>-----XX-XXXXXXXXXXXXXXXXX---X--XXXXXXXXXXXXXXXXXXXXXX----XXXXX-----<>-----XX-XXXXXXXXXXXXXXXXX----X---[]------------------------
XXXXXX----[]------XXXXXXXXXXXXXXXXXXX---X--XXXXXXXXXXXXXXXXXXXXXX----XXXXXX----[]------XXXXXXXXXXXXXXXXXXX------XX[]XXXXX-------XXEX--------