--------------------------------------------------------------------------------------------------------------------------------------------
----------------------------------------------------------------------------------------------XX--------------------------------------------
---------------------------------------------------------------------------------------------XX-X-------------------------------------------
---------------------------------------------------------------------------------------XXXXXXX---X--XXX-------------------------------------
--------------------------------------------------------------------------------------XX----X-----XXX--X-----------------------------SSS----
QXXXXX-----------------X---------------------------------------------------XXXX--SS--XXX---XX-----XXX---X-----S---------XQQ?QQX-------------
--------------------------------------------------------------------------XX---X----XX-------------------X----S---------X-----X-------------
XX-------------------X-------------------------------------------XXXXX---XX-----X--XX----ooooooo----------X-------------X-----X------X------
S-X------------XXX----------------------------------------------XX-X--X-XX------oXXX-----ooooooo-----------X--SSS-------XE-E--X------XEE----
---X----------XX<>X------------------------------XXXX----------XX--X---XX-------XXXX-----------E------------X-SSS-------XQQ-QQX------XSSSSSS
X---X--------XX-[]-X----------------------------XX<>-X-------XXX---X---XE---------------------<>-------------XSSS---------------------------
o----X------XX--[]--X----------XX-------------QXX-[]--X-----XX<>---X---XB----------------E----[]---------------SSX------------E-------------
E----EXXXXXXX---[]---XXXXXXXXXXXXXXXXXXXXXXXXXXX--[]---XXXXXX-[]---X---XS---------------<>----[]-------------X-SS-XXXXXXXXXXXXXXXXXXXXXXXXXX
XXXXXXXXXXXXXX--XXXXXXXXXXXXXXXXXXXXXXXXXXXXXXXXXXXXXXXXXXXXXXXXXX-X---<>XXX------------[]----[]-------------XXXXXXXXXXXXXXXXXXXXXXXXXXXXXXX