--------------------------------------------------------------------------------------------------------------------------------------------
--------------------------------------------------------------------------------------------------------------------------------------------
---------------XXXXX--XXX------------------SSS-----------------XXXX-------------------------------------------------------------------------
------------XXXX----XXX--X-----------------[]-------------------[]--------------------------------------------------------------------------
-----------XXXXX----XXX---X--E-------------[]-------------------[]------------------------------------XXXXXXXXXXX---------------------------
--?-------XX---------------X---------------<>-------------------[]-----------------------------------XX---X---XX-X-----------SSSS-----------
---------XX-----------------X-----------------------------------[]----------------------------------XX-E--E---[]--X-----------[]------------
--------XX-------------------X--------------E-------------------[]--------------------------------XXX---------[]---X----------[]------------
-------XX---------------------X----------XXXX-------------------[]------XXXX-------------E-------XX-E---------[]----X---------[]------------
-----XXX---S-------------------X--------XX<>-X-QQQQQQ?QQQQQQ?Q--<>-----XXX--X-----------<>------XX------------[]-----XX-------[]----------XX
E---XX<>-------------------------------XX-[]--X-----------------------XX-X---X-----------------XX-------------<>-----B-X------<>---------XXE
---XX-[]-----------------------X------XX--[]---X---------------------XX--X----X---------------XX---------------------b--X-----XXX-------XX<>
XXXX--[]E----------------------XXXXXXXX---[]----XXXXXXXXXXXXXXXXXXXXXX--EX-----XXXXXXXXXXXXXXXXX---------------E-----B---XXXXXXE-XXXXXXXX-[]
XXXXXXXXXXXXX------------------XXXXXXXXXXXXXXXXXXXXXXEEXXXXEXEXXXXXXXXXXXX-----XXEXXXXXXXXXXXXXX-------------XXXXXXXXXXXXXXXXXXXXXXXEXXXXXXX