--------------------------------------------------------------------------------------------------------------------------------------------
--------------------------------------------------------------------------------------------------------------------------------------------
SSSSSS?SSSSSSSSSSSSSSSSSSSSSSSSSSSSSSSSSSSSSSSSSSSSSSSSS------------------------------------------------------------------------------------
------------------------------------------------------------X-------------------------------------------------------------------------------
----------------------------------------------------------XXX--------------------------------------------XXX--------------------------------
-oooooo-------------------------------------------------------------------XXX---------------------------XX--X--XXXE-----oo------------------
-----------------------XX------------------------------------------------------------------------------XX----XXX--X-------------XX----------
-SSSSSS---------------XX-X-XXX-------------------------------------------------------------------XXXXXXX-----XXX---X---XXX-----------------X
-SSSSSS--------------XX---XX--X----------------------XXXXX-----SSSSSS??----------------------XXXXX----X-------------XXXX--XXXXX----------XXX
-------------------XXX----<>---X------XXXX----------XXXXX-XXXX------------------------------XXXXXX---XX-------------XXXX--XXXX-X--------XX<>
------------------XX<>----[]----XXX--XXSS-X--------XXEXXX-XXX-X----------------------------XX--------XXX------------------------X------XX-[]
X----------------XX-[]----[]----<>-XXX-SS--X------XXXXXXX------X-------XXX----------XXXXXXXX-------------------------------------X----XX--[]
-XXXXXXXXXXXXXXXXX--[]----[]--E-[]--X--SS---XXXXXXXXXXXXX-------XXXXXXXX--XXXXXXXXXXX--XXXXX----------------------oo--------------XXXXX---[]
XXXXXXXXXXXXXXXXXXXXXXXXXXXXXXXXXXXXX--XX--XXXXXXXXXXXXX-------XXXXXXXXX--XXXXXXXXXXX-----------------------------XX-------------XXXXXXXXXXX