--------------------------------------------------------------------------------------------------------------------------------------------
--------------------------------------------------------------------------------------------------------------------------------------------
-----------------------------------------------SSSSSSSSSSSSSSSSSSSSSSSSSSSSS-------------SSS--<>SSSSSSSSSS----------------------------------
------------------------------------------------------------SSSS------------------------------XSSSSSSSSSSS-------------------XXXXXXXXXX-----
------------------XXXXXXXXXX-----------E-E------------------SSSS------------------------------BSSSSSSSSSSS------------------XX--------------
E----------------XX--QQQ?QQ-X--------SSSSSSS-SS-XXXX-----XXXSSSS-------------XX--XXXXX--------SSSSSSSSSSSS-----------------XXX--------------
b---------------XX-----------X--------------E--XX---X---XX--X---------------XX-XXX----X-------SSSSSSSSSSSS----------------XXXX--------------
b--------------XX------E------X---------------XX-----X-XX----X-------------XX--XXX-----X------SSSSSSSSSSSS---------------XXXXX--------------
XXX----------XXX-----SSSSSS----X------------XXX-------XX-----oXXX------XXXXX------------X-----SSSSSSSSSSSS--------------XXXXXX--------------
------------XX<>-------------E--X----------XX<>-------<>----S?SS-X----XX-XXX-------------XXXXX-SSSSSSSSSSS--------E----XXXXXXX-------------X
X----------XX-[]-------X-----X---X----E---XX-[]-------[]----SSS---X--XX-----------SSS-S--SSSSSSSSSSSSSSSSS---E---<>---XXXXXXXX----<>------XX
-XXXXXX---XX--[]-------X-----X----X------XX--[]-------[]----SS-----XXX------------SSS-S--SSSSSSSSSSSSSSSSS--<>---[]--XXXXXXXXX----[]-----XX-
--X----XXXX---[]----E--X-----X-----XXXXXXX---[]-------[]------E-EE--XX------------SSS-S--SSSSSSSSSSSSSSSSS--[]---[]-XXXXXXXXXX----[]-----X-X
XXX----XXXXXXXXXXXXXXXXXXXXXXXXXXXXXXXXXXXXXXXX-------XXXXXXXX-XXXXXXX---------XXXSSS-S--XXXXXXXXXXXXXXXXX--XX---XXXXXXXXXXXXXXXXXXXXXXXXXXX