--------------------------------------------------------------------------------------------------------------------------------------------
--------------------------------------------------------------------------------------------------------------------------------------------
--------------------------------------------------------------------------------------------------------------------------------------------
--------------------------------------------------------------------------------------------------------------------------------------------
---------------------------------------------------------------------------------XXXXXXXXXXX----------E-E------------------XXXXX------------
----------------------------------------------------------------XXXX------------XX--QQQ?QQQ-X-------SSSSSSS-SS-XXXX-----XXXX--X-X-----------
----X--EX-------------------------------------------------------X<>-X----------XX------------X-------------E--XX---X---XX--E--X--X----------
----X---X-------------------------------------------------------X[]--X-----XX-XX------E-------X--------------XX-----X-XX---XX-X---X---------
----X---X--------X-EE----X--------------ooo---------------E----XX[]---X---XX-XX-----SSSSSSS----X-----------XXX-------XX----XX-X----X--------
-X--XSS?X--------XSSSSSSSX--------------ooo-------------------XXS[]----X-XX--<>--------------E--X---------XX<>-------<>----XX-X-----X-------
-X--X-------------------------------------------------oo-----XX--[]-----XX---[]-------X------X---X---E---XX-[]-------[]----XX-X------X------
QX--X--------XXX--------------------------------------oo----XX---[]-----<>---[]-------X------X----X-----XX--[]-------[]----XX-X-------S----S
XXXXXXXXXXXXXX--XXXXXXXXXXXXXXXXXXXXXXXXXXXXXXXXXXXXXXXXXXXXX----[]----------[]----E--X------X-----XXXXXX---[]-------[]----XX-X-------XXXXXX
XXXXXXXXXXXXXX--XXXXXXXXXXXXEEXEXXXXXXXXXXXXEEXEXXXXXXXXXXXXXXXXXXXXXXXXXX---XXXXXXXXXXXXXXXXXXXXXXXXXXXXXXXXX-------XX-XXXXX-XXXXXXXXXXXXXX