--------------------------------------------------------------------------------------------------------------------------------------------
X----------------------------------------------------------XXX------------------------------------------------------------------------------
SSSS--SSSS-------------------------------------------------XX-XXX-------------------------------------XXXXX--XXX------------------SSSSSSSSSS
SSSS--------------XXXX------------------------------------XX--XX-X---------------------------------XXXX----XXX--X-----------------[]--------
SSSS------------XXXXX------------------------------------XX---XX--X------------------------------EXXXXX----XXX---X--E-------------[]--------
SSSS-----------XXXX--X-----------SSS---?-----------------XS---XX---X-------------------------XXXXXX---------------X---------------<>--------
--------------XXXXX---X----------------------------------X----XX----X---------------ooo-----XX---X-----------------X------------------------
XX--XX-------XXXXXX----X---------------------------------X----XX-----X---------------------XX----X------------------X-----------------------
?-XX--X-----XXXXXXX-----X-------------------------------XX----XX------X-----------------XXXX-------------------------X----------XXXXX-------
??SS---X---XXXXXXXX------X----------------XXXX---------XXX----XX-------X---------------XXXXX--------------------------X--------XX<>Q-X------
--SS----X-XXXXXXXXX-------X----------E---XX<>-X-------XX-X----XX--------X--------XXXXXXX--------------------------------------XX-[]b--X-----
--SS-----XXXXXXXXXX--------XX-----------XX-[]--X-----XX--X----XX---------X-----QXXXXXXXX------------------------------X------XX--[]E---XXXX-
ooSS-----XXXXXXXXXX--------X-XXXXXXXXXXXX--[]---XXXXXXE--X----XX--------X-XXXXXXX-------------------------------------XXXXXXXX---[]B----X--X
XXXX---XXXXXXXXXXXXXXXXXXXXXXXXXXXXXXXXXXXXXXXXXXXXXXXXXXXXXXXXXXXXXXXXXXXXXXXXXX-------------------------------------XXXXXXXXXXXXXXXXXXX--X