--------------------------------------------------------------------------------------------------------------------------------------------
--------------------------------------------------------------------------------------------------------------------------------------------
--------------------------------------------------------------------------------------------------------------------------------------------
--------------------------------------------------------------------------------------------------------------------------------------------
--------------------------------------------------------------------------------------------------------------------------------------------
------------------QQQQQ----------SSSS--------SSSSSS---XX------------------------------------------------------------------------------------
-----------------------------------------------------------------------------------------------XXXX-----------------------------------------
--------------------------------------------------------------------------------------------XXXX---X----------------------------------------
--o-------XXXX-----------------------XXXX--------E-----------------------------------------XXXSS----X-----------------XXXX------------------
-XXX-----XX<>-X--E?QQQQ---------S---XX<>-X-QQQQ--QQQQQ-------------XXX--------------------XXXX-------XXX------?------XX<>-X-----------------
XXX-X---XX-[]--X-------------------XX-[]--X-----------------------XXX-X------------------XXXXX-------<>-X--E--------XX-[]--X----------------
X-X--X-XX--[]---X-----------------XX--[]---X-----------------XXX-XX-X--X------XX--------XXXXXX-------[]--X---------XX--[]---X----XXXX-XXX---
--X---XX---[]----XXXXXXXXXXXXXXXXXX---[]----XXXXXXXXXXXXXXXXXX--XX--X---XXXXXXXXXXXXXXXXXXXXXX-------[]---XXXXXXXXXXE--[]----XXXXX---XXX-XXX
XXXXXXXXXXXXXXXXXXXXXXXXXXXXXXXXXXXXXXXXXXXXXXXXXXXXXXXXXXXXXX--XXXXX--XXXXXXXXXXXXXXXXXXXXXXXXXXXXXXXXXXXXXXXXXXXXXXXXXXXXXXXXXXX--XXXXXXXX