--------------------------------------------------------------------------------------------------------------------------------------------
----------------------------------------------------------------------------XXX-------------------------------------------------------------
------------------------------------------------------------X--------------XX--X------------------------------------------------------------
----------------------------o--------------------------------------XXX----XXS---X-----------------------------------------------------------
-------------------------------------------------------------XX---XX--XXXXXS-----X----------------------------------------------------------
--------------------------SSS-------E-----------------------XX-X-XX---SSSSS-------X---------------------E--S---SSSSSSSSS------------SS---SS-
XXX--------------------------------<>----------------------XX---XX-----------------X-----XXXX----------<>-----------------------------------
XX-X-------------------XXXXXXXXX---[]------------XXXXXXXXXXX----<>------------------X---XX---X---------[]-----------------------------------
XX--X----------------XXX---X----XX-XXX---------XXX----X---<>----[]-------------E-----X-XX-----XXX------[]------------XXXX---------SS--------
XX---X-------SSS----XX<>---S---<>-X-----------XX<>---SS---[]----XXX-----------<>------XX------<>-X----SXXS----------XX--XXX-XXX---------SSS-
XX----X------------XX-[]-------[]--X-XXXXX---XX-[]--------[]------------------[]------<>------[]--XX------XXXX-----XX------XX--XXX----------
XX-----XXX--------XX--[]-------[]---XX<>X-X-XX--[]--------[]----------<>------[]------[]------[]-<>-X----XX<>-X---XX-------<>--<>-X-XXXXX---
XX-----XX-XXXXXXXXX---[]----E--[]----X[]X--XX---[]--------[]----------[]-----X[]------[]------[]-[]--XXXXX-[]--XXXX--------[]--[]--XX----XXX
X--XXXXXXXXXXXXXXXXXXXXXXXXXXXXXXXXXXXXXXXXXXXXXXXXXXXXXXXXXXXXXXXXXXXXXXXXXXXXXXXXXXXXXXXXXXXXXXXXXXXXXXXXXXXXXXXX------XXXXXXXXXXXX-X-XXXX