----------------------XXXXXX----------------------------------------------------------------------------------------------------------------
------------------XXXXX----XXXXXXXXXXXXXXXXXXXXXXX------------------------------------------------------------------------------------------
SS----SSSSSSSSS--XX--X-------SSSSSSSSSSSSSSSSSSSSS------------------------------------------------------------------------------------------
[]--------------XX---X------------------------[]--------------------------------------------------------------------------------------------
[]-----X-------XX-----------------------------[]----------------------------------------XXXXX-----------------------------------------------
[]-----XXXXXXXXX------------------------------[]-----E-------------------------------E-XXXXX-X-------------------------------E--S---SSSSSSSS
[]-----XSSSSSSSS-X--------X-------------------[]----<>--------------------------------XXXXXX--X-----------------------------<>--------------
[]-----XSSSSSSS-------------------------------<>----[]-----XXXX----XXXXX-------------XXXXXXX---X----------------------------[]--------------
[]--XXXXSSSSSS--------------------------------------[]---XXX---X-XXX----X----------XXXXXXXXX----X---------------------------[]------------XX
<>-XX--?SSSSS--------------------------<>-----------XXX-XX<>----XX<>-----XX-------XX<>XXXXXX-----X------------------XXX-----XXS----------XX-
-EXX-----------------------------------[]----S-S-S-----XX-[]---E<>[]----<>-X-----XX-[]XXXXXX------X------------------XXXX------XXXX-----XX--
XQX------------------X-------ooooooo---[]----S-S-S----XX--[]--<>[][]----[]--X---XX-X[]XXXXXX-------XXX--------XXX---XX<>-X----XX<>-X---XX---
XEX--------------------------ooooooo---[]----S-S-SXXXXX---[]--[][][]----[]---XXXX-XX[]XXXXXX-------XX-XXXXXXXXX--XXXX-[]--XXXXX-[]--XXXX----
XXX---XXXXXXXXX--------------XXXXXXX---[]----S-S-SXXXXXXXXXX--XXXXXXXXXXXXXXXXXXXXXXXXXXXXXXXXXXXXXXXXXXXXXXXXX--XXXXXXXXXXXXXXXXXXXXXXX----