-------------------------------------------------------------------------------------XXXXXX-------------------------------------------------
-------------------------------------------------------XX-XX-XXXXXXXXXXXXXXXXXXXXXXXXX--XX-XXXXXXXXXXXXXXXXXXXXXXX--------------------------
SSSSSSSSSSSSSSSSSSSSSSSS-------------SSS--<>SSSSSSSSSSSSSSSSSSSSSSSSSSSSSSSSSSSSSSSSSS-----SSSSSSSSSSSSSSSSS????SSSSSSSSSSSSSSSSS----SSSSSSS
SS------S-<>------------------------------[]SSSSSSSSSSSSSSSSS------------------------------SSSSSSSSSSSSSSSS--------------[]-----------------
SS------S-[]------------------------------[]SSSSSSSSSSSSSSSSS------------------------------SSSSSSSSSSSSSSSS------?-------[]--------------XXX
SS--------[]-------------XX--XXXXX--------[]SSSSSSSSSSSSSSSSS------------------------------SSSSSSSSSSSSSSSS------b-------[]--------XXXXXXX--
----------[]------------XX-XXX----X-------[]SSSSSSSSSSSSSSSSS------------------------------S--------------------<>-------[]-------XXSSSSSS--
----------[]-----------XX--XXX-----X------[]SSSSSSSSSSSSSSSSS------------------------------S-----------------------------[]------XX-SSSSSS--
E---------[]-------XXXXX------------X------QSSSSSSSSSSSSSSSSS-----------------------XXX-----?oooooooooo------------------[]-XXXXXX--SSSSSS--
QQQQQQ---?SS------XX-XXX-------------XXXXX-?SSSSSSSSSSSSSSSSS--------------XXX--------------??SSSSSSSSS----XXXX----------[]XXSSSSS--SSSSSS--
----------------EXX-----------SSS-S--SSSSSSSSSSSSSSSSSSSSSSSS-------XXX-----------------------------------XXXXX------Q---<>X-SSSSS----------
----------------XX------------SSS-S--SSSSSSSSSSSSSSSSSSSSSSSS---------------------------XX---------------XXXXXX--X--------XX-SSSSS--------<>
XXXXXXXXXXXXXXXXXX------------SSS-S--SSSSSSSSSSSSSSSSSSSSSSSS--------------------------------------EE---XXXXXXX---XXXXXXXXX--SSSSS--------[]
XXXXXXXXXXXXXXXXXX---------XXXSSS-S--XXXXXXXXXXXXXXXXXXXXXXXX------------------------------XXXXXXXXXXXXXXXXXXXXX---XXXXXXXXE-XXXXXXXXXXXXXXX