--------------------------------------------------------------------------------------------------------------------------------------------
------------------------------------------------------------------------------------------------------X-------------------------------------
SSSSSSSSSSSSSSSSSSSSSSSSSSSSSSSSSSSSSS?SSSSSS-SSSSSSSSSSSS?SSSSSSSSS-----SSS-------------SSS--<>SSSSSSS-------------------------------------
---SS--SSSSSS--SSSS------SSSS-------------------------------------[]--------------------------[]SSSSSSS-------------------------------------
---SS--SSSSSS--SSSS--E---SSSS-------------------------------------[]--------------------------[]SSSSSSS-------------------------------------
SSS--------SS---S----SS----------oooooo---------------------------[]---------XX--XXXXX--------[]SSSSSSS-------------------------------------
SSS--------SS---S----SS-------------------------------------------[]--------XX-XXX----X-------[]SSSSSSS----------------XX-------------------
SSS--------SS---S----SS----------SSSSSS---------------XX----------[]-------XX--XXX-----X------[]SSSSSSS---------------XXX-------------------
SSS----ooooSS---So??-SS---E------SSSSSS---------------E-X---------[]---XXXXX------------X------?SSSSSSS--------------XXXX---------------XXXX
SSSSS--SSSSSS---SSS--SS--SSSS-----------------------XXo--XX-------[]--XX-XXX-------------XXXXX-QSSSSSSS--------E----XXXXX--------------XXXXX
---SS-------------------EE-------------------------XX<bXXX-XX-----<>-XX-----------SSS-S--SSSSSSSSSSSSSS---E---<>---XXXXXX------------XXX----
---SS-----------------------XXXXX---------------B-XX-[]XXXXX-X-----EXX------------SSS-S--SSSSSSSSSSSSSS--<>---[]--XXXXXXX-----------XXXXX---
XXXXXXXXXXXXXXXXXXXXXXXXXXXXX----XXXXXXXXXXXXXXXXXX--[]XXXXX--XXXXXXX-------------SSS-S--SSSSSSSSSSSSSS--[]---[]-XXXXXXXX---------XXX-------
XXXXXXXXXXXXXXXXXXXXXXXXXXXXX---XXXXXXXXXXXXXXXXXXXXXXXXXXXXXXXXXXXXX----------XXXSSS-S--XXXXXXXXXXXXXXXXXX---XXXXXXXXXXX--------XXXXXXXX---