--------------------------------------------------------------------------------------------------------------------------------------------
--------------------------------------------------------------------------------------------------------------------------------------------
-------------------------------------------------------------E------------------------------------------------------------------------------
--------------------------------------------------------------------------------------------------------------------------------------------
--------------------------------------------------------------------------------------------------------------------------------------------
X-----------------------------------------------------SSSSSSS?S-----------------------------SSSSSS------------------------------------------
-X----------------ES---S---------------E---------------[]-----------------------------------------------------------------------------------
--X--------S-----------------QQQ------<>---------------[]-----------------------------------------------------------------------------------
---X----------------------------------[]---------------[]-------------XXX------------------------------------E------------------------------
----X------------------------------QQQQQQQQQQ----------[]------------XXB-X--------XX-----------XX-----------<>----ooo-----------------------
-----X------XXX----------------------------------------<>-----------XX-<>-X------XB-X---------XB-X------------------------------------------
<>----X----XXB-X---------------XXXXX-------------------XXX---------XX--[]--X----XXb--X-------XXb--X-----------------XXX-----XXXX------------
[]-----XXXXX-b--XXXXXXXXXXXXXXXXB---XXXXXXXXXXXXXXXXXXXXE-XXXXXXXXXX---[]E--XXXXX-BEE-XXXXXXXX-BEE-XXXXXXXXXXXXXXXXXX--XXXXXXEE-XXXXXXXXXXXX
XXXXXXXXXXXXXXXXXXXXXXXXXXXXXXXXX--XXXXXEEXXXXXXXXXXXXXXXXXXXXXXXXXXXXXXXXXXXXXXXXXXXXXXXXXXXXXXXXXXXXXXXXXXXXXXXXXXX--XXXXXXXXXXXXXXXXXXXXX