----------------XXX-XX----------------------------------------------------------------------------------------------------------------------
XXXXXXXXXXXXXXXXX-XXX-XXXXXXXXXXXXXXXXXXXXXXXXXXXXXXXXXXXXXXXXXX----------------------------------------------------------------------------
?SSSSSSSSSSSSSSSS--S--SSSSSSSSSSSSSSSSSSSSSSSSSSSSSSSSSSSSSSSSSS----------------------------------------------------------------------------
B---------------------SSSSSSSSSSSSSSSS----------------------[]------------------------------------------------------------------------------
S---------------------SSSSSSSSSSSSSSSS----------------------[]------------------------------------------------------------------------------
B---------------------SSSSSSSSSSSSSSSS-----E----------------[]----------------------------------E-----------------------------------------E-
----------------------S-------------------<>----------------[]----------X-EX----------------------------E----------------------------------X
S---------------------S-------------------[]----------------<>----------X--X---------------------------<>------XXXXX----XXXXX-------------XX
------E----------------?oooooooooo--------[]----------------------X---X-X--X--------X-EE----X----------[]----XXX----X-XXX----X----------XXXX
--E--<>----------------??SSSSSSSSS----XX--[]---------<>-----------XSSSX-XS?X--------XSSSSSSSX----------XX---XX<>-----XX<>-----XX-------XX<>X
-<>--[]---------XX-------------------XXX--[]---------[]----S-S-S-------------------------------------------XX-[]----E<>[]----<>-X-----XX-[]X
-[]--[]--------XXXXXX---------------XXXX--[]---------[]----S-S-S----------------XXX-----------------------XX--[]---<>[][]----[]--X---XX-X[]X
-[]--[]-------XXXX------------EE---XXXXX--[]---ooo---[]----S-S-SXXXXXXXXXXXXXXXXX--XXXXXXXXXXXXXXXXXXXXXXXX---[]---[][][]----[]---XXXX-XX[]X
XXXXXXX--XXXXXXXX-----XXXXXXXXXXXXXXXXXXXXXXX--XXX---[]----S-S-SXXXXXXXXXXXXXXXXX--XXXXXXXXXXXXEEXXEXXXXXXXXXXXXXXXXXXXXXXXXXXXXXXXXXXXXXXXX