----------------------------------------------------------------------------------------XXX-------------------------------------------------
-----------------------------------------------------------------XXX--------E----------XX--X------------------------------------------------
SSSSSSSSSSSSSSSSSSSSSS?SSSSSSSSSSSSSSSSSSSSSSSS-----SSSSSSSSS---XX--X------XX---------XX----X------------------E----------------------------
SSSSSSSSSSSSSSSSS------SSSSSSSSSSSSSSS-------[]--------------<>XX----X----XX-XX------XX------X----------------------------------------------
SSSSSSSSSSSSSSSSS------SSSSSSSSSSSSSSS-------[]--------------[]X------X--XX----X-XXXXX--------X---------------------------------------------
SSSSSSSSSSSSSSSSS------SSSSSSSSSSSSSSS-------[]------XXXXXXXXXX--------XXX------XX--XX------E--XXXXXXXXXXXXXX-------------------------------
--------------------XXXXX--------------------[]------XSSSSSSSSS-X------XXX------XX-------------SSSSSSSSSSSSS-X-----XX---------------ES------
XX-XXX---------XXXXXX----X-------------------[]------XSSSSSSS-------------------------------------------------X---XB-X-------S------------QQ
E-X---XXXXXXXXXXE--<>-----X-----XXXXXXX------[]---XXXXSSSSSS---------------------------------------------------X-XXb------------------------
?SS---SSSSSSSSSSS--[]------X--XXX-<><>-X-----[]--XX--?SSSSS------------------------------------------E----------XXXXX-XS--------------------
-------------------[]-------XXXXX-[][]--X----<>-XX--------------------------------------------------<>---S------XXXXX--X------XXX----------X
---<>--------------[]-------EEXXX-[][]---X-----XX--------------------oo-----------------------------[]---S------XXXXX---X----XXB-X---------X
---[]--------------[]------E-XXXX-[][]----XXXXXX---------------------SS-----------------------------[]---S------XXXXX----XXXXX-b--XXXXXXXXXX
XXXXXXXXXXXXXXXXXXXXXXX-XXXEXXXXX-XXXXXXEXXXXXXX----XXXXXXXXX---------------------------------------[]---S------XXXXXXXXXXXXXXXXXXXXXXXXXXXX