--------------------------------------------------------------------------------------------------------------------------------------------
XXX-----------------------------------------------------------------------------------------------------------------------------------------
X--X-------------------------------------------------------------------------------------------------------------------------------------?--
----XX--------------------------------------------------------------------------------------------------------------------------------------
----E-XXXXXX----------------------------------------XXXXXXX---------------------------------------------------------------------------------
-------X----X-------SS-----------------SSSSS-------XX-SSSS-X-------------------QQQQQ----------SSSS----------------------SSSSS---------------
------<>-----X------------------------------------XX--------X------------------------------------------------------------------------------S
------[]------XXXX---XXX--XXXX-------------------XX----------X------------------------------------------------------------------------------
------[]-------XB-XXXX--XXX---------------?-----XXX-----------X--------XXXX-----------------------XXXX-------------------E-------------SS---
------XX-------XXXXESS---<>---X----------S?S---XXEX---S-----X--X------XX<>-X--E?QQQQ---------S---XX<>-X------------------SSSS-XXX-----------
--------------XXXXXX-----[]----X--------------XXXXX---------X---X----XX-[]--X-------------------XX-[]--XX---------XXXX-------XXX-X--B------X
-------------XXXXXXX-----[]-----XX-----------XXXXXX---------XX---X--XX--[]---X-----------------XX--[]-<>-X---B---XX<>-X-----XX-X--X-b----XXX
X-----------XXXXXXXX-----[]-----X-XXXXXXXXXXXXXXXXX----EE---XX---EXXX---[]----XXXXXXXXXXXXXXXXXX---[]-[]--XXXXXXXX-[]--XXXXXX--X---XXXXXXX-X
X-----------XXXXXXXXXXXXXXXXXXXXXXXXXXXXXXXXXXXXXXXXXXXXXXXXXXXXXXXXXXXXXXXXXXXXXXXXXXXXXXXXXXXXXXXXXXXXXXXXXXXXXXXXXXXXXXXXXXXXXXXXXXXXXX-X