--------------------------------------------------------------------------------------------------------------------------------------------
--------------------------------------------------------------------------------------------------------------------------------------------
----------------------------------------------------XXXX--------------------------------------------------------XXXX------------------------
--------------------------------------------XXXXX--XX---X--------------------------------------------------------[]---------XXXXX-----------
-------------------------------------------XX----XXX-----XXXXXX--------------------------------------------------[]-------XXX----X----------
----------------QQQ?QQQQQQQQ?QQQQ---------XXX-----X-------X----X-------------------------------------------------<>------XX<>-----X---------
------------------------------[]---------XXXX----XX------XX-----X-------------------------------------------------------XXX[]------X--------
------------------------------[]--------XXXXXXX------------------X------------------------------------------------E-----XXX[]-------X-------
XXX---------------------------[]-------XXXXXX---------------------XXXXX-----------------------------------------------XXXXX[]--------X--XXX-
XX-X--------------SSSSSSSSSSS-<>------XXXXXXX----------------------XXX-X-------------------------XXXX-----------XXXX-XX<>XX[]---------XXXS-X
-X--X--------------------------------XXXXXXXX----------------------XXX--X-----------------------XX---XX--------XX---XXX[]XX[]----------X----
-X---X-----------E---E--------XXX---XXXXXXXXX-E-------------------XXXX---X-------------XXXXX---XX---<>-X------XX---<>XX[]XX[]----------SS-SS
QX----XXXXXXXXXXXXXXXXXXXXXXXXXE-XXXXXXXXXXXX<>------------------XXXXX----XXXXXXXXXXXXXXE---X-XX----[]--XXXXXXX----[]XX[]XX[]--------X-SS-SS
XXXXXXXXXXXXXXXXXXXXXXXXXXXXXX<>-XXXXXXXXXXXX[]------------------XXXXXXXXXXXXXXXXXXXXXX<>----XX-----XXXXXXXXXXX----[]XXXXXXXXXXXXXXXXXXXXXX-