--------------------------------------------------------------------------------------------------------------------------------------------
--------------------------------------------------------------------------------------------------------------------------------------------
-----------------------------S--------------------------------------------------------------------------------------------------------------
--------------------------------------------------------------------------------------------------------------------------------------------
--------------------------------------------------------------XXXXX-------------------------------XXXX----------------------XXXXXXX---------
-------XXXX------------SSSSSSSSS-----------------------------XXXXX-X----------------------------------X--------------------XX-SSSS-X--------
----------------------------------------------------E-------XXXEXX--X----------------------------------X------------------XX--------X-------
-----------------------------------------------------------XXEXXXX---X----------------------------------X----------------XX----------X------
----------------------XXX---------------------------------XXEXXXXX----X-----------E----------------------X--------------XXX-----------X-----
---------------------XX--X----?S-----X-------------------XXXXXXXXX-----X------------XXXX------------------X------S?S---XXEX---S-----X--X----
XX------------------XX----X----------X------E-----------XXXXXXXXXX------X----------XX<>-X------------------X----------XXXXX---------X---X---
B-X------------XXX-XX------X---------X-----------------XXXXXXXXXXX-------X--------XX-[]--X------------------X--------XXXXXX---------XX---X--
b--XXXXXXXXXXXXX--XX--------XXXXXXXXXXXXXXXXXXXXXXXXXXXXXXXXXXXXXX-------XXXXXXXXXX--[]---XXXXXXXXXXXXX----X-XXXXXXXXXXXXXX----EE---XX---EXX
XXXXXXXXXXXXXXXX--XX-------XXXXXXXXXXXXXXXXXXXXXXXXXXXXXXXXXXXXXXXXXXXXXXXXXXXXXXXXXXXXXXXXXXXXXXXXXXXXXXXXXXXXXXXXXXXXXXXXXXXXXXXXXXXXXXXXX