----------------------------------------------------------------------------------------------------XXXX------------------------------------
---------------------------------------------------------------------------------------------------XX---X------XX---------------------------
---------------------------------------------------------------------------------------------------X-----X----XX-X--------------------------
---------------------------------------------------------------------------------------------------o------X--XX---X-------XXX----XXX--------
--------------------------------------------------------------------------------ooo-------------XXXb-------XXX-----X-XXXXXX--XXXXX--X-------
---------------XXX--------------------------------------------------------------ooo------------XX-<B-------XXX------XX---XX--XXXXX---X------
---------------<>-X---------------------------------------------------------------------------XX--[]-------XXX------XX----------------X-----
--------------X[]--X-------------XXXXX---------------XXXXXXXX-----oooo----------XXXX---------XX---[]-------XXX-------------------------X---X
-------------XX[]---X-----------XXX---XX------------XX---X---X----oooo---------XX---XXXXXXXXXXB---[]-------XXX--------------------------X-XX
------------XXS[]----X----------X----<>-X----------XX----X----X--------------EXX---XXXXXXXXXX<E---[]-------XXX---------------------------XX-
oo---------XX--[]-----X--------XX----[]--X-------XXX-----X-----XXXXXXXXXXXXXXXX----X---------[]---[]-------XXX-----------------------E---<>-
oo--------XX---[]------X------XX-----[]---X-----XX<>---X-X-----XXXXXXXXXXXXXXXX----X---------[]---[]-------XXX----------------------<>---[]-
XXXXXXXXXXX----[]------XXXXXXXX------[]----XXXXXX-[]---X-X-----X--------------X----X---------[]---[]-------XXX----------------------[]---[]-
XXXXXXXXXXXXXXXXXXXXXXXXXXXXXXXXXXXXXXXXXXXXXXXXXXXXXX-X-X-----X--------------X----X---------[]---XXX------XXX---------------XXXXXXXXXXXXXXX