---------------XXXXXX-----------------------------------------------------------------------------------------------------------------------
XXXXXXXXXXXXXXXX-XXX-XXXXXXXXXXXXXXXXXXXXXXXXXXX--------------------------------------------------------------------------------------XX----
SSSSSSSSSSSSSSSS-----SSSSSSSSSSSSSSSSSSSSSSSSSSS-------------------------------------------------------------------------------------XX-X---
---------------------SSSSSSSSSSSSSSSS-----------------------------------------------------------------------------------------------XX---X--
---------------------SSSSSSSSSSSSSSSS-------------------------------------------------XXXXX--------------------------------------XXXX-----X-
---------------------SSSSSSSSSSSSSSSS-----E-------------------------SSSSS---?-------XXX--X-X------------------------------------XX-<>------X
---------------------S-------------------<>----------------------------------------XX-E--X--X----------------------------------XX--[]-------
---------------------S-------------------[]---------------------------------------XX--XX-X---X--------------------------------XX---[]-------
----E-----------------?oooooooooo--------[]--------------------------------------XX---XX-X----X-----------------------------XXX----[]-------
E--<>-----------------??SSSSSSSSS----XX--[]--------------XXX-----S---E---------XXX----XX-X-----X-------------------XXXX----XX<>----[]-------
b--[]----------XX-------------------XXX--[]---SS--------XXX-X-------------E---XX<>----XX-X------X-------------------------XX-[]----[]-------
o--[]---------XXXXXX---------------XXXX--[]---SS------EXX-X--X---------------XX-[]----XX-X-------XXX---------XXX---XXX---XX--[]----[]-------
o--[]--------XXXX------------EE---XXXXX--[]---SSXXXXXXXX--X---XXXXXXXXXXXXXXXX--[]E---XX-X-------XX-XXXXXXXXXX--XXXX--XXXX---[]----[]-------
XXXXX--XXXXXXXXX-----XXXXXXXXXXXXXXXXXXXXXXX--XXXXXXXXXX--XXXXXXXXXXXXXXXXXXXXXXXXXXXXXX-XXXXXXXXXXXXXXXXXXXXX--XXXX--XXXXEXXXX----XXXXXXX--