-XXX----------------------------------------------------------------------------------------------------------------------------------------
XX--X-----------------------------------------XXXXXXXXXXXXXXXXXXXXXXXXX---------------------------------------------------------------------
X----X---------SSSSSSSSSSSSSSSSSSSSSS--------XXSSSSSSSSSSSSSSSSSSSSSSS-X---SSSSSSSS----SSSS--XXXX------------------SSSSSSS-----SS-SSSSSSSSSS
S-----X--------SSSSSSSSSSSSS----------------XX--------------------------X-------------------XX---X---------------------------------------[]-
-------X-------SSSSSSSSSSSSS-----------XXX-XX----------------------------X---------XXX-----XX-----XXX---XXX------E-----------------------[]-
--------X------SSSSSSSSSSSSS--QQ------XXXX-XSSS-----------E---------------X---?XXXXX--XXXXXX------SSSXXXX--X-----------------------------[]-
---------X---------------------------XX---XX-------------<>----------------XXXSSSSSS--SSSSSS------SSSSSSS---X-E--------------------------<>-
----------X----------------XXX-XXX--XX-----XS------------[]----------------SSSSSSSS--------------------------X-----------------X------------
-----------X--XXXXXXXXXXXXXX--XX--XXX------S-S-----------[]----------------SSSSSSS----------------------------X---------------XX----X-------
------------XX?SSSSSSSSSSSSS--QQ--QQQ---------S-----E--SS[]--------------E-SSSSSS------------------------------X--------------XSSSSSX-------
E------E-----XSSSSSS---SSSSS-----------------------<>----[]---<>-----E--<>---------------------------------S----X---------------------------
E-----<>-----SSSSSSS---SSSSS-----------------------[]----[]---[]----<>--[]---------------------------------------X-------XXXX---XXX-----XXX-
?-----[]------------oooSSSSS-----------------------[]-E--[]---[]----[]--[]----------------------------------------XXXXXXXX---XXXX--XXXXXX--X
XXX-XX[]XXXXXXXXXXXXXXXXXXXXXXXXXXXXX------XXXXXXXXXXXXXXXXX--XX--XXXXXXXXXXXXXXXXX-------------------------------XXXXXXXX---XXXX--XXXXXX--X