--------------------------------------------------------------------------------------------------------------------------------------------
---------------------------------------------------XXXXX-XXXXX------------------------------------XX----------------------------------------
-------SSSSSSSSSSSSSSSS-------------SSS--<>SSSSSSSSSSSSSSSS---X----------------------------------XX-X---------------------------------------
XXXXX--SSSS------------------------------[]SSSSSSSSSSSSSSSS----XX-------------------------------XX---X----XXXXX---XXXX----------------------
E----X-SSSS------------------------------[]SSSSSSSSSSSSSSSS------X-XXXX-----o-------------------------XXXXX----X-XX---X---------------------
X-----XSSSS--------X----XX--XXXXX--------[]SSSSSSSSSSSSSSSS-------XX---X-----------------------SS-----SSSSS-----XX-----X--------------S-----
Q------X---------------XX-XXX----X-------[]SSSSSSSSSSSSSSSS-------XX----X---------------------------------------<>------X-------------------
o-------X-------------XX--XXX-----X------[]SSSSSSSSSSSSSSSS--------------X------------------XXXXXX--------------[]-------X------------------
Q-------oXXX------XXXXX------------X-------SSSSSSSSSSSSSSSS---------------XXXXX-----------XXX---X------SS-------[]--------X---ooo-----------
b------S?SS-X----XX-XXX-------------XXXXX-QSSSSSSSSSSSSSSSS---------------XXXX-XSSS------XX<>---S---------ES----[]S--------XXX--------S-----
Q------SSS---X--XX-----------SSS-S--SSSSSSSSSSSSSSSSSSSSSSS---------------------X-------XX-[]------------<>-----[]---------<>-X-------------
Q------SS-----XXX------------SSS-S--SSSSSSSSSSSSSSSSSSSSSSS--<>------------------X-----XX--[]------<>----[]--<>-[]---------[]--X------------
o--------E-EE--XX------------SSS-S--SSSSSSSSSSSSSSSSSSSSSSS--[]---------o---------XXXXXX---[]------[]----[]--[]-[]---------[]---XXXXXXXXXXXX
XXXXXXXXX-XXXXXXX---------XXXSSS-S--XXXXXXXXXXXXXXXXXXXXXXX--[]---------X-------XXXXXXXXXXXXXXXXXXXXXXXXXXXXXXXXXXXXXXXXXXXXXXXXXXXXXXXXXXXX