--------------------------------------------------------------------------------------------------------------------------------------------
--------------------------------------------------------------------------------------------------------------------------------------------
--------------------------------------------------------------------------------------------------------------------------------------------
--------------------------------------------------------------------------------------------------------------------------------------------
-----------------------oo-------------------------------------------------------------------------------------------------------------------
--------------------------------------------------------------------------------------------------------------------------------------------
-----------------------------------<>-----------E-------------------------------------------------------------------------------------------
----------------------------<>-----[]-------------------------------------------------------------------------------------------------------
---SSS--------------?--SSS---SSS?--[]--E---------------oo---------------------------------Q--------------SSSSSS-----------------------------
-----------------------------------[]-------------------------------------------------------------------------------------------------------
-------------------------------S---[]------------------------------------------E------------------------------------------------------------
--------------------------------------------------------------------------------------------------------------------------------------------
--------------------------------------------------------------------------------------------------------------------------------------------
XXXXXXXXXXXXXXXXXXXXXXXXXXXXXXXXXXXXXXXXXXXXXXXXXXXXXXXXXXXXXXXXXXXXXXXXXXXXXXXXXXXXXXXXXXXXXXXXXXXXXXXXXXXXXXXXXXXXXXXXXXXXXXXXXXXXXXXXXXXX