--------------------------------------------------------------------------------------------------------------------------------------------
--------------------------------------------------------------------------------------------------------------------------------------------
--------------------------------------------------------------------------------------------------------------------------------------------
-----------------------------------------------ooo------------------------------------------------------------------------------------------
--------------------------------------------ooo---------------------------------------------------------------------------------------------
------------SSSSS---------------------------o-----------------------------------------------------------------------------------------------
------------SSSSS-------<>------------------o------------------------------------------------------------------------------------------B----
------------SSSSS-------[]------------------------------??----------------------------------------------------------------------------------
-----------------------------------------------<>-------<>----------------------------------------------------------------------------------
-----------------------------------------------[]-------[]----------------------------------------------------------------------------------
-----------------------------------------------[]-------b-----------------------------------------------------------------------------------
-----------------------------------------------[]-------b-----------------------------------------------------------------------------------
XXXXXXXXXXXXXXXXXXXXXXXXXXXXXXXXXXXXXXXXXXXXXXXXXXXXXXXXXXXXXXXXXXXXXXXXXXXXXXXXXXXXXXXXXXXXXXXXXXXXXXXXXXXXXXXXXXXXXXXXXXXXXXXXXXXXXXXX----
XXXXXXXXXXXXXXXXXXXXXXXXXXXXXXXXXXXXXXXXXXXXXXXXXXXXXXXXXXXXXXXXXXXXXXXXXXXXXXXXXXXXXXXXXXXXXXXXXXXXXXXXXXXXXXXXXXXXXXXXXXXXXXXXXXXXXXXX----