--------------------------------------------------------------------------------------------------------------------------------------------
--------------------------------------------------------------------------------------------------------------------------------------------
--------------------------------------------------------------------------------------------------------------------------------------------
---------------------------E--------------------ooo-----------------------------------------------------------------------------------------
------------------B-------------------------------------------------------------------------------------------------------------------------
----------SSS-------------SSSSS-------------------------------------------------------------------------------------------------------------
----------SSS------?-?--E------------------------<>----E------------------------------------------------------------------------------------
-----------------------------------------------<>-------------------------------------------------------------------------------------------
-----------------------------------------------[]-------------------------------------------------------------------------------------------
------------------b-------------------------------E-----------------------------------------------------------------------------------------
------------------b-------------------------------------------------------------------------------------------------------------------------
------------------b-------------------------------------------------------------------------------------------------------------------------
XXXXXXXXXXXXXXXXXXXXXXXXXXXXXXXXXXXXXXXXXXXXXXXXXXXXXXXXXXXXXXXXXXXXXXXXXXXXXXXXXXXXXXXXXXXXXXXXXXXXXXXXXXXXXXXXXXXXXXXXXXXXXXXXXXXXXXXX----
XXXXXXXXXXXXXXXXXXXXXXXXXXXXXXXXXXXXXXXXXXXXXXXXXXXXXXXXXXXXXXXXXXXXXXXXXXXXXXXXXXXXXXXXXXXXXXXXXXXXXXXXXXXXXXXXXXXXXXXXXXXXXXXXXXXXXXXX----