--------------------------------------------------------------------------------------------------------------------------------------------
--------------------------------------------------------------------------------------------------------------------------------------------
-------------------------------------------------------------------------------------o------------------------------------------------------
--------------------------------------------------------------------------------------------------------------------------------------------
------------------------------------------------------------------------------o-------------------------------------------------------------
--------------------------------------------------------------------------------------------------------------------------------------------
--------------------------------------B-----------------------------------------------------------------------------------------------------
--------------------------------------b----------------------------------------E------------------------------------------------------------
--------------------------------------------------------------------------------------------------------------------------------------------
---------------S------S-----S--------------------------------------------------------------------------------SSS----------------------------
------------------SSSS-----SS?SS----------------S---Q----------------------------------------E------------SSSSS-----------------------------
------------------------------------------------QQQQQ-S----S----?-SSS----------------------SS-??S-------------------------------------------
--------------------------------------------------------------------------------------------------------------------------------------------
XXXXXXXXXXXXXXXXXXXXXXXXXXXXXXXXXXXXXXXXXXXXXXXXXXXXXXXXXXXXXXXXXXXXXXXXXXXXXXXXXXXXXXXXXXXXXXXXXXXXXXXXXXXXXXXXXXXXXXXXXXXXXXXXXXXXXXXXXXXX