--------------------------------------------------------------------------------------------------------------------------------------------
---------------oo---------------------------------------------------------------------------------------------------------------------------
-----------------------------------------------o--------------------------------------------------------------------------------------------
--------------------------------------------------------------------------------------------------------------------------------------------
--------------------------------------------------SSSSSSSS----------------------------------------------------------------------------------
--------------------------------------------------?SSS?-------------------------------------------------------------------------------------
--------------------------------------------------------------------------------------------------------------------------------------------
-------------------------<>-----------o---------------------------------------------SSSS----------------------------------------------------
-------------------------[]--------------------------E--------------------------------------------------------------------------------------
--------------------------------------------------------------------------------------------------------------------------------------------
---------------------------------------B----------------------------------------------------------------------------------------------------
---------------------------------------b----------------------------------------------------------------------------------------------------
--------------------------------------------------------------------------------------------------------------------------------------------
XXXXXXXXXXXXXXXXXXXXXXXXXXXXXXXXXXXXXXXXXXXXXXXXXXXXXXXXXXXXXXXXXXXXXXXXXXXXXXXXXXXXXXXXXXXXXXXXXXXXXXXXXXXXXXXXXXXXXXXXXXXXXXXXXXXXXXXXXXX-