--------------------------------------------------------------------------------------------------------------------------------------------
--------------------------------------------------------------------------------------------------------------------------------------------
---------o-------------o---------------------------------------------------------------------------------------o----------------------------
---------------------------------------------------------------------o----------------------------------------------------o-----------------
-----------------------------------------------------E----------------------------------------------------o---------------------------------
-------------------SS-------?---------------SS----------------E---------------E----------------E------E-------------------------------------
-------------------------------------------------SS----------E--------E---E------------------------------------------------------------E----
-----------?--------------------o--------------------------------------------oo------------------------------------------------------o--E---
------------------------------------------------SS---?-----------SS-----------------------------------------------SS-----------SS-------E---
------------------------------------------------SS-----------SSSSSS--------E----------------E-----------------------------------------------
-------------------------------------XX-----------SS----------SS---------------------------<>SS-------SS--------SS----------SS----------B---
-----------------------------------------------<>-------------<>------------------------------------------------------------------------<>--
-----------------------------------------------b-----------b--------------------------------------------------------------------------------
XXXXXXXXXXXXXXXXXXXXXXXXXXXXXXXXXXXXXXXXXXXXXXXXXXXXXXXXXXXXXXXXXXXXXXXXX---XX--XXXXXXXXXXXXXXXXX---XXXXXXXXXXXXXXXXXXXXXXXXXXXXXXXXXXXXXXXX