--------------------------------------------------------------------------------------------------------------------------------------------
--------------------------------------------------------------------------------------------------------------------------------------------
--------------------------------------------------------------------------------------------------------------------------------------------
--------------------------------------------------------------------------------------------------------------------------------------------
-------------------------------------------------------E--------------------------------------------E---------------------------------------
----?-----------------------------------------------E-SSSSS---------------------------------------------SS----------------------------------
-------------------------------------------------------E--------------------------------------------E---------------------------------------
----------------------------------QQQ-------------------------SSSSS---------------------------------------------SS--------------------------
--------<>----------------------------------------------------------------------------------------------------------------------------------
--------[]----------------------------------------------------------------------------------------------------------------------------------
-------------------B------------------------------------------------------------------------------------------------------------------------
-------------------b------------------------------------------------------------------------------------------------------------------------
-------------------X------------------------------------------------------------------------------------------------------------------------
XXXXXXXXXXXXXXXXXXXXXXXXXXXXXXXXXXXXXXXXXXXXXXXXXXXXXXXXXXXXXXXXXXXXXXXXXXXXXXXXXXXXXXXXXXXXXXXXXXXXXXXXXXXXXXXXXXXXXXXXXXXXXXXXXXXXXXXXXXXX