--------------------------------------------------------------------------------------------------------------------------------------------
--------------------------------------------------------------------------------------------------------------------------------------------
--------------------------------------------------------------------------------------------------------------------------------------------
-----------------------------------------------------E-----------------------------------E--------------------------------------------------
-------------------------------------E---------------X-----------------------------------X-------E------------------------------------------
-------------------------------------X-------------------------------------------------------------X----------------------------------------
------------S-----------?------------Q-------------------------------------------------------------Q----------------------------------------
------------S-----------?------------S-------------------------------------------------------------S----------------------------------------
------------S-----------?------------?-------------------------------------------------------------S----------------------------------------
------------S-----------?------------S---SSS-------------------------------------------------------?----------------------------------------
------------S-----------?------------S----S--------------------------------------------------------S----------------------------------------
------------S-----------?------------S----S------------------------------------------------S-------S----------------------------------------
XXXXXXXXXXXXXXXXXXXXXXXXXXXXXXXXXXXXXXXXXXXXXXXXXXXXXXXXXXXXXXXXXXXXXXXXXXXXXXXXXXXXXXXXXXXXXXXXXXXXXXXXXXXXXXXXXXXXXXXXXXXXXXXXXXXXXXXXXXXX
XXXXXXXXXXXXXXXXXXXXXXXXXXXXXXXXXXXXXXXXXXXXXXXXXXXXXXXXXXXXXXXXXXXXXXXXXXXXXXXXXXXXXXXXXXXXXXXXXXXXXXXXXXXXXXXXXXXXXXXXXXXXXXXXXXXXXXXXXXXX