--------------------------------------------------------------------------------------------------------------------------------------------
--------------------------------------------------------------------------------------------------------------------------------------------
--------------------------------------------------------------------------------------------------------------------------------------------
--------------------------------------------------------------------------------------------------------------------------------------------
--------------------------------------------------------------------------------------------------------------------------------------------
--------------------------------------------------------------------------------------------------------------------------------------------
--------------------------------------------------------------------------------------------------------------------------------------------
--------------------------------------------------------------------------------------------------------------------------------------------
-----------------------------------------------<>------------------------------------------------B-----------------------<>-----------------
-----?-------Q----?-----Q--E-?----Q-------------<>-----------------------------------------------<>----------------------[]-----------------
-------------------------<>---------------------B-------------------<>---------------------------[]----E-----------------[]-----------------
-------------------------[]---------------------b--------------------<>---------------------------<>----------------------<>----------------
-------------------------[]---------------------b--------------------[]--------------------------------E------------------E-----------------
XXXXXXXXXXXXXXXXXXXXXXXXXXXXXXXXXXXXXXXXXXXXXXXXXXXXXXXXXXXXXXXXXXXXXXXXXXXXXXXXXXXXXXXXXXXXXXXXXXXXXXXXXXXXXXXXXXXXXXXXXXXXXXXXXXXXXXXXXXXX