--------------------------------------------------------------------------------------------------------------------------------------------
--------------------------------------------------------------------------------------------------------------------------------------------
-----------S---------------------------------------------------S-----S----------------------------------------------------------------------
-----------S--B---------------------------------SSSS-----Q-QQ-SS---SS-----------------------------------------------------------------------
-----------b---------SSSS--<>--SSSSS----------SSSS---S?SQS--SSSS--S----Q-Q-Q------SS----<>--------------------------------------------------
-----------b-----E------<>-------------------------------------------------------------------------------------<>---------------------------
-----------b------------[]--E---o----------------------------------------------------------------------o---o----<>--------------------------
-------------------------<>----------------------------------------------------------------------------------<>-----------------------------
--------------------------------------------------------------------------------------------------------------------------------------------
--------------------------------------------------------------------------------------------------------------------------------------------
--------------------------------------------------------------------------------------------------------------------------------------------
--------------------------------------------------------------------------------------------------------------------------------------------
--------------------------------------------------------------------------------------------------------------------------------------------
XXXXXXXXXXXXXXXXXXXXXXXXXXXXXXXXXXXXXXXXXXXXXXXXXXXXXXXXXXXXXXXXXXXXXXXXXXXXXXXXXXXXXXXXXXXXXXXXXXXXXXXXXXXXXXXXXXXXXXXXXXXXXXXXXXXXXXXXXXXX