--------------------------------------------------------------------------------------------------------------------------------------------
--------------------------------------------------------------------------------------------------------------------------------------------
-------?--------------------------E---------------------------------------------------------------------------------------------------------
-------S-------------------------XXXXXXX---------SS-------------------------------------------------------------------E---------------------
-------S-------E-----o-----------SSSSSSS---S-----Q------S----------------E----------------------?Q---E-----SSSSS---------oo-----------------
-------S------XXXXXX-----------SSSSSSSSSS------------SSSSS--------------------------------SSSSSSS----------------SSSSSSSSSSS--------SSSSSSSS
--------E--------------------SSSSSSSSSSSSS----------------SSSSSSSSSS--SSSS--------------------------------------------------------------SSSS
-------SS-------------------SSSSSSSSSSSSSS?-----------oo--------------SSSS------<>-----------------------------------SS------------------SSS
--<>----------------<>Q----------S----E--------------SSSSSSSS?SSSSSSSSSSSS-----<>-------------------------SSSSSSSSSSSS-------------S-----SSS
--[]---oo------------SSSSS-----SSS----X--------------S----------SSSSSSSSSSSS---[]---------------------SSSSSSS-----SSSSS------------S--------
E<><>--SSSSSS-------SSSSS---SSSSSS----XSXX---------SSS-------------------------[]oooo----------------SSSSS----------------------S-----------
XXX--XXXXXXXXX-----SSSSS-SSSSSSSSSS--XXXXXX-------SXSS-----------------------SSS<>------------<>----SSSSSSS--------------------S------------
XXXXXXXXXXXXXXXXXXXXXXXXXXXXXXXXXXXX----XXXXXXXXXXXXXXXXXXXXXXXXXXXX-----XXXXXXXXXXXXXXXXXXXXXXXXXXXXXX---SSSSSSSSSS--------XXXXXXXXXXXXXXXX
XXXXXXXXXXXXXXXXXXXXXXXXXXXXXXXXXXXXXXXXXXXXXXXXXXXXXXXXXXXXXXXXXXXXXXXXXXXXXXXXXXXXXXXXXXXXXXXXXXXXXXXXXXXXXXXXXXXXXXXXXXXXXXXXXXXXXXXXXXXX