--------------------------------------------------------------------------------------------------------------------------------------------
--------------------------------------------------------------------------------------------------------------------------------------------
---------------------------------------o----------------------------------------------------------------------------------------------------
--------------------o------------------E----------------------------------------------------------------------------------------------------
--------------------------------------------------------------------------------------------------------------------------------------------
------------------------------------------------<>------------------------------------------------------------------------------------------
-----------------------------------------------<>-------B-----------------------------------------------------------------------------------
----------------------E------SSSS--------------[]-------b-----------------------------------------------------------------------------------
------------E---------------SSSSSS-------------SS-----SS------------------------------------------------------------------------------------
-------------------------SSXXXXXXXXXXXXXXXXXXXXXX-----------?-------------------------------------------------------------------------------
XXXXXXXXX?XXXXXXX<>XXXXXXSSXXXXXXXXXXXXXXXXXXXXXXXXX-----XXXXXXXXXXXXXX---------------------------------------------------------------------
XXXXXXXXXXXXXXXXXXXXXXXX<>XXXXXXXXXXXXXXXXXXXXXXXXXXXXXXXXXXXXXXXXXXXXXXXXXXXXXXXXXXXXXXXXXXXXXXXXXXXXXXXXXXXXXXXXXXXXXXXXXXXXXXXXXXXXXXXXXX
XXXXXXXXXXXXXXXXXXXXXXXXXXXXXXXXXXXXXXXXXXXXXXXXXXXXXXXXXXXXXX----XXXXXXXXXXXXXXXXXXXXXXXXXXXXXXXXXXXXXXXXXXXXXXXXXXXXXXXXXXXXXXXXXXXXXXXXXX
--------------------------------------------------------------------------------------------------------------------------------------------