--------------------------------------------------------------------------------------------------------------------------------------------
--------------------------------------------------------------------------------------------------------------------------------------------
--------------------------------------------------------------------------------------------------------------------------------------------
--------------------------------------------------------------------------------------------------------------------------------------------
--------------------------------------------------------------------------------------------------------------------------------------------
-----------------------------------------------------------------------E-----SSSSSS---------------------------------------------------------
-------------------------------------------------------------o-oo-----E-----------SSSSSS----------------------------------------------------
---------------------------------------------------------------------------------SS?SS------------------------------------------------------
---------------------------------------------<>---------------------------------------------------------------------------------------------
---------------------------------------------[]---------------------------------------------------------------------------------------------
---------------------------------------------[]---o-----------------------------------------------------------------------------------------
--------------------B----o-----------------------------------------------------------------------------------------------E------------------
--------------------b----o------------------------------------------------------------------------------------------------------------------
XXXXXXXXXXXXXXXXXXXXXXXXXXXXXXXXXXXXXXXXXXXXXXXXXXXXXXXXXXXXXXXXXXXXXXXXXXXXXXXXXXXXXXXXXXXXXXXXXXXXXXXXXXXXXXXXXXXXXXXXXXXXXXXXXXXXXXXXXXXX