--------------------------------------------------------------------------------------------------------------------------------------------
--------------------------------------------------------------------------------------------------------------------------------------------
---------------------------------------------------SSSS-------------------------------------------------------------------------------------
--------------------------------SSSSSSS----------------------------------------------------------------SSSSSSS------------------------------
-------------------------------------------------------<>-----------------------------------------------------------<>----------------------
-------------------------------------------------------[]-----------------------------------------------------------[]----------------------
-------------------------------------------------------[]-----------------------------------------------------------[]----------------------
-------------------------------------------------------[]-----------------------------------------------------------[]----------------------
-------------------------------------------------------[]-----------------------------------------------------------[]----------------------
-------------------------------------------------------[]-----------------------------------------------------------[]----------------------
-------------------------------------------------------[]-----------------------------------------------------------[]----------------------
-------------------------------------------------------[]-----------------------------------------------------------[]----------------------
-------------------------------------------------------[]-----------------------------------------------------------[]----------------------
XXXXXXXXXXXXXXXXXXXXXXXXXXXXXXXXXXXXXXXXXXXXXXXXXXXXXXXXXXXXXXXXXXXXXXXXXXXXXXXXXXXXXXXXXXXXXXXXXXXXXXXXXXXXXXXXXXXXXXXXXXXXXXXXXXXXXXXXXXXX