--------------------------------------------------------------------------------------------------------------------------------------------
---o----------------------------------------------------------------------------------------------------------------------------------------
---------------------------------------------------------------------------------oo---------------------------------------------------------
------------------E----------------------------------------------------------------------------------------------------oo-------------------
--------------------------------------------------------------------------------------------------------------------------------------------
------------------------------------------<>----<>----------------------------------B-------------------------------------------------------
------------------------------------------[]----[]----------------------------------b-------------------------------------------------------
-------------------------------------------------------------------E------------------------------------------------------------------------
--------------------------------------------------------------------------------------------------------------------------------------------
--------------------------------------------------------------------------------------------------------------------------------------------
----------------SSSSSSSSSSSSSSSSSSSSSSS-----------------------------------------------------------------------------------------------------
--------------------------------------------------------------------------------------------------------------------------------------------
--------------------------------------------------------------------------------------------------------------------------------------------
XXXXXXXXXXXXXXXXXXXXXXXXXXXXXXXXXXXXXXXXXXXXXXXXXXXXXXXXXXXXXXXXXXXXXXXXXXXXXXXXXXXXXXXXXXXXXXXXXXXXXXXXXXXXXXXXXXXXXXXXXXXXXXXXXXXXXXXXXXXX