--------------------------------------------------------------------------------------------------------------------------------------------
--------------------------------------------------------------------------------------------------------------------------------------------
---------------o--------------------------------------------------------------------ooo-----------------------------------------------------
---------------------------------------E-------o---------------------------------------------------------------------E----------------------
------------------E---SSS----?---------XXXXXXXXXXX----S-----S-----SS----------S-------?S--------------S?-----------SSSS----SQQS-------------
--------------------------------------XXXXXXXXXXXXXXXX-----------------------SSSSS----------------------------------------------------------
------------------------------<>OO<>---XX--------XX-------------------------------------------------------------<>--------------------------
------------------------------[]--[]---XX--------XX----------------------EE--SSSQQSS------------------S-----------<>------------------------
---------------------------------------XX--------XX----S------E-----------SSSSSSSSSS---------------------------E-----------------XX---------
---------Q-------------------SSSS-------------------------SSS------------SSSS----------------------------------SSSS--------------XXX--------
------Q----------------------+---+---------------------SS---SS--------Q-------------------S?S------------------SSSS--------------XXXX-------
---E------------------------<>---<>-------------------------------<>--------E-------------SSS---------<>-------<>----------------XXXXX------
XXXXXXXXXXXXXXXXXXXXXXXXXXXXX------XX----X----XXXXXXXXXXXXXXXXXXXXXXXXXXXXX<>-------------E-----------[]-------[]----------------XXXXXX-----
XXXXXXXXXXXXXXXXXXXXXXXXXXXXXXXXXXXXXXXXXXXXXXXXXXXXXXXXXXXXXXXXXXXXXXXXXXXXX-----------S-------XXXXXXXXXXXX--XX--XXXXXXXXXXXXXXXXXXXXXXXXXX