--------------------------------------------------------------------------------------------------------------------------------------------
--------------------------------------------------------------------------------------------------------------------------------------------
-------------------o------------------------------------------------------------------o-----------------------------------------------------
--------------------o--o-----------------------------------------------------o-----o--------------------------------------------------------
-------------------o----?-----------------------------------------------------------------------------------------Q-------------------------
-----------------------------------------S-----S?---S--S----------------??o-------------------------------???-------------------------------
-----------------------------------------S-----S----S--S----------------Q-o-------------------------------Q---------------------------------
-----------------------------------------S-----S----S--S--E---------B-E---------------------------------------------------------------------
-----------------------------------------S-----S?---S--S----------Q?-----?------------------Q---?-------Q-----------------------------------
-----------------------------------------S-----S----S--S----------?-----?-------------------------------------------------------------------
-----------------------------------------S-----S----S--S--<>------------------------------------------------------------------------------<>
-------------------------------------------------------------------<>--------------------------------------------------------------------<>-
-------------------------------------------------------------------[]--------------------------------------------------------------------[]-
XXXXXXXXXXXXXXXXXXXXXXXXXXXXXXXXXXXXXXXXXXXXXXXXXXXXXXXXXXXXXXXXXXXXXXXXXXXXXXXXXXXXXXXXXXXXXXXXXXXXXXXXXXXXXXXXXXXXXXXXXXXXXXXXXXXXXXXX----