--------------------------------------------------------------------------------------------------------------------------------------------
--------------------------------------------------------------------------------------------------------------------------------------------
--------------------------------------------------------------------------------------------------------------------------------------------
--------------------------------------------------------------------------------------------------------------------------------------------
--------------------------------------------------------------------------------------------------------------------------------------------
----------------------------------------------------------------------------------------------------------------SS--------------------------
---------------------------------E-------------------E------------------E------------------------------E-----------------E-------SS---------
---------------------------------X-------------------X------------------X------------------------------X-----------------X-------SS---------
-----------------------------------BB---------------BB---------------BB-----------B-------------------BB---------------BB-----------SS------
-----------------------------------bb---------------bb---------------bb-----------b-------------------bb---------------bb-------------------
-----------------------------------bb---------------bb---------------bb-----------b-------------------bb---------------bb-------------------
-----------------------------------bb---------------bb---------------bb-----------b-------------------bb---------------bb-------------------
XXXXXXXXXXXXXXXXXXXXXXXXXXXXXXXXXXXXXXXXXXXXXXXXXXXXXXXXXXXXXXXXXXXXXXXXXXXXXXXXXXXXXXXXXXXXXXXXXXXXXXXXXXXXXXXXXXXXXXXXXXXXXXXXXXXXXXXXXXXX
XXXXXXXXXXXXXXXXXXXXXXXXXXXXXXXXXXXXXXXXXXXXXXXXXXXXXXXXXXXXXXXXXXXXXXXXXXXXXXXXXXXXXXXXXXXXXXXXXXXXXXXXXXXXXXXXXXXXXXXXXXXXXXXXXXXXXXXXXXXX