--------------------------------------------------------------------------------------------------------------------------------------------
--------------------------------------------------------------------------------------------------------------------------------------------
-------------------?-----?----------------------------------------------------------?------?------------------------------------------------
----------------------------------SSSSS-------------------------------------------------------------------------------------------SSSSS-----
-------------------------Q------------------------------------------------X------------------------Q----------------------------------------
--------------------SSSSS-------------------------?-------------------------SSSSS------------------------------------?----------------------
--------------------------------E----------------------------------------------------E------------------------------------------------------
---------------------------------------E-----------------------E-----------------------E----------------------------------------------------
-------------------------------------------<>-----------------------------------------------------------------------------<>----------------
---------------------------------XXXXXXX---[]-----------<>---------XXXXXXX-------Q--------------XXX-----------------------------------------
XXXXXXXXXXXXXXXXXXXXXXXXXXXXXXXXXX<>XXXXXXXXXXXXXXXXXXXXXXXXXXXXXXXXXXXXXXX=========================XXXXXXXXXXXXXXXXXXXXXXXXXXXXXXXXXXXXXXXX
XXXXXXXXXXXXXXXXXXXXXXXXXXXXXXXXXX[]XXXXXXXXXXXXXXXXXXXXXXXXXXXXXXXXXXXXXXX=========================XXXXXXXXXXXXXXXXXXXXXXXXXXXXXXXXXXXXXXXX
--------------------------------------------------------------------------------------------------------------------------------------------
--------------------------------------------------------------------------------------------------------------------------------------------