--------------------------------------------------------------------------------------------------------------------------------------------
--------------------------------------------------------------------------------------------------------------------------------------------
--------------------------------------------------------------------------------------------------------------------------------------------
------------------------------------------------o--------------------------------------------------QQQ---------------<>---------------------
------------------------------------------------E-------------------------------------------------------------------------------------------
-----------------------------?--------------------------------------------------------------------------------------------------------------
--------------------------------------------------------------------------------------------------------------------------------------------
----------------------------QQQQQ-------------------------<>---------------------<>-----------------------------<>--------------------------
----------------------E---------------------------------------------------------------------------------------------------------------------
------------------B-------------------------------------------------------------------------------------------------------------------------
------------------b---------SSSS-------------------------<>---------------------<>-----------------------------<>---------------------------
------------------b------------------XXXXXXXXXXXXXXXXXXXXXXX-------------SSSSSS-----------SSSSSS--------<>-----------<>---------------------
-----------------------XXXXXXXXXXXXXXXXXXXXXXXXXXXXXXXXXXXXX---XXXXXXXXXXXXXXXXXX----XXXXXXXXXXXXXXXXXXXXXXXXXXXXXXXXXX---------------------
XXXXXXXXXXXXXXXXXXXXXXXXXXXXXXXXXXXXXXXXXXXXXXXXXXXXXXXXXXXXXXXXXXXXXXXXXXXXXXXXXXXXXXXXXXXXXXXXXXXXXXXXXXXXXXXXXXXXXXXXXXXXXXXXXXXXXXXXXXXX