--------------------------------------------------------------------------------------------------------------------------------------------
--------------------------------------------------------------------------------------------------------------------------------------------
-----------o--------------------------------------------------------------------------------------------------------------------------------
--------------------------------------------------------------------------------------------------------------------------------------------
---------------------------------E---o------------------------------------------------------------------------------------------------------
--------------------------------------------------------------------------------------------------------------------------------------------
----------------------------------------------B-------------------o-------------------------------------------------------------------------
----------------------------------------------b------------------------o--------------------------------------------------------------------
--------------------------------------------------------------------------------------------------------------------------------------------
------SS-------------------------------------------------------------------------------------S------S---S-----------------------------------
------SSS------?SS------SSS---------------------SS?---------SS?-----S----------------SSS-------SSSS------SSS----------------------SS--------
-------------------SS-----SS------------------SSS-S--------------S-------------------------?S-------------------------------------------E---
--------------------------------------------------------------------------------------------------------------------------------------------
XXXXXXXXXXXXXXXXXXXXXXXXXXXXXXXXXXXXXXXXXXXXXXXXXXXXXXXXXXXXXXXXXXXXXXXXXXXXXXXXXXXXXXXXXXXXXXXXXXXXXXXXXXXXXXXXXXXXXXXXXXXXXXXXXXXXXXXXXXXX