--------------------------------------------------------------------------------------------------------------------------------------------
--------------------------------------------------------------------------------------------------------------------------------------------
---------------------------------------------------------------------------o----------------------------------------------------------------
---------------------------------------------------------------------------E----------------------------------------------------------------
-----------------------------------------------------------------------X---X----------------------------------------------------------------
-----------------------------------------------------------------------X---X----------------------------------------------------------------
-------------E---------o----o----o------------------------------------E---E-----------------------------------------------------------------
--------------------------------------------------------------------------------------------------------------------------------------------
--------------------------------------------------------------------------------------------------------------------------------------------
------------------------------B-------------------B---E-------------------------------------------------------------------------------------
------------------------------b-------------------b---b-------------------------------------------------------------------------------------
------------------------------b-------------------b---b-------------------------------------------------------------------------------------
------------------------------b-------------------b---b-------------------------------------------------------------------------------------
XXXXXXXXXXXXXXXXXXXXXXXXXXXXXXXXXXXXXXXXXXXXXXXXXXXXXXXXXXXXXXXXXXXXXXXXXXXXXXXXXXXXXXXXXXXXXXXXXXXXXXXXXXXXXXXXXXXXXXXXXXXXXXXXXXXXXXXXXXXX