--------------------------------------------------------------------------------------------------------------------------------------------
--------------------------------------------------------------------------------------------------------------------------------------------
--------------------------------------------------------------------------------------------------------------------------------------------
--------------------------------------------------------------------------------------------------------------------------------------------
-----------------------------------------------------SSSSSSS--------------------------------------------------------------------------------
--------------------------------------------------------Q-----------------------------------------------------------------------------------
--------------------------------------------------------------------------------------------------------------------------------------------
--------------------------[]----------------------------------------------------------------------------------------------------------------
--------------------------<>----------------------------------------------------------------------------------------------------------------
-----------------------------------------------------SSSSSSS--------------------------------------------------------------------------------
-------------B------------------------------------------------------------------------------------------------------------------------------
-------------b------------------------------------------------------------------------------------------------------------------------------
-------------------------------------------------------------------E----------------------------------o-------------------------------------
XXXXXXXXXXXXXXXXXXXXXXXXXXXXXXXXXXXXXXXXXXXXXXXXXXXXXXXXXXXXXXXXXXXXXXXXXXXXXXXXXXXXXXXXXXXXXXXXXXXXXXXXXXXXXXXXXXXXXXXXXXXXXXXXXXXXXXXXXXXX