--------------------------------------------------------------------------------------------------------------------------------------------
--------------------------------------------------------------------------------------------------------------------------------------------
--------------------------------------------------------------------------------------------------------------------------------------------
--------------------------------------------------------------------------------------------------------------------------------------------
-------------------------------------------------o---o------------------------------------------------------------------------o---o---------
--------------------------------------------------------------------------------------------------------------------------------------------
--------------------------------------------------------------------------------------------------------------------------------------------
--------------------------SS-------------------------SSSSSSSS---------------------------------------------SSSSSSSS--------------------------
--------------------------SS-------------------------SSSSSSSS---------------------------------------------SSSSSSSS--------------------------
----------------------Q---SS----Q--------------------SSSSSSSS--Q----------Q----------------Q---------------SSSSSSSS-------------------------
-------------------------------------------<>-----------------------------------------------------------------------------<>----------------
-------------------------------------------[]----B------------------------------------------------------------------------[]----------------
-------------------------------------------[]----b------------------------------------------------------------------------[]----------------
XXXXXXXXXXXXXXXXXXXXXXXXXXXXXXXXXXXXXXXXXXXXXXXXXXXXXXXXXXXXXXXXXXXXXXXXXXXXXXXXXXXXXXXXXXXXXXXXXXXXXXXXXXXXXXXXXXXXXXXXXXXXXXXXXXXXXXXXXXX-