--------------------------------------------------------------------------------------------------------------------------------------------
--------------------------------------------------------------------------------------------------------------------------------------------
--------------------------------------------------------------------------------------------------------------------------------------------
--------------------------------------------------------------------------------------------------------------------------------------------
--------------------------------------SSS-----??-------------------------------------------------------------------Q------------------------
------------------------------------B-------------------------------------------------------------------------------------------------------
------------------------------------b-------------------------------------------------------------------------------------------------------
------------------------------------b-------------------------------------------------------------------------------------------------------
--------------------------------------------------------------------------------------------------------------------------------------------
-----------------------------------------------------------------------------------------------------------------------------------E--------
----------------------------------------------------------------------------------<>--------------------------------------------------------
----------------------------------------------------------------------------------[]--------------------------------------------------------
----------------------------------------------------------------------------------[]--------------------------------------------------------
XXXXXXXXXXXXXXXXXXXXXXXXXXXXXXXXXXXXXXXXXXXXXXXXXXXXXXXXXXXXXXXXXXXXXXXXXXXXXXXXXXXXXXXXXXXXXXXXXXXXXXXXXXXXXXXXXXXXXXXXXXXXXXXXXXXXXXXXXXXX