--------------------------------------------------------------------------------------------------------------------------------------------
--------------------------------------------------------------------------------------------------------------------------------------------
--------------------------------------------------------------------------------------------------------------------------------------------
--------------------------------------------------------------------------------------------------------------------------------------------
-------------?------------------?-----------------?---------------------------?-------------------------------------------------------------
-------------?------------------?-----------------?---------------------------?-------------------------------------------------------------
----------------------SSSSSSSSSSSSSSSSSS----------------------------------------------------------------------------------------------------
----------------------SSSSSSSSSSSSSSSSSS----------------------------------------------------------------------------------------------------
-----------------------------<>-----------------------------<>------------------------------------------------------------------------------
-----------------------------[]-----------------------------[]------------------------------------------------------------------------------
-----------------------------[]-----------------------------[]------------------B-----------------------------------------------------------
-----------------------------[]-----------------------------[]------------------b-----------------------------------------------------------
XXXXXXXXXXXXXXXXXXXXXXXXXXXXXXXXXXXXXXXXXXXXXXXXXXXXXXXXXXXXXXXXXXXXXXXXXXXXXXXXXXXXXXXXXXXXXXXXXXXXXXXXXXXXXXXXXXXXXXXXXXXXXXXXXXXXXXXXXX--
XXXXXXXXXXXXXXXXXXXXXXXXXXXXXXXXXXXXXXXXXXXXXXXXXXXXXXXXXXXXXXXXXXXXXXXXXXXXXXXXXXXXXXXXXXXXXXXXXXXXXXXXXXXXXXXXXXXXXXXXXXXXXXXXXXXXXXXXXX--