--------------------------------------------------------------------------------------------------------------------------------------------
--------------------------------------------------------------------------------------------------------------------------------------------
--------------------------------------------------------------------------------------------------------------------------------------------
--------------------------------------------------------------------------------------------------------------------------------------------
--------------------------------------------------------------------------------------------------------------------------------------------
--------------------------------------------------------------------------------------------------------------------------------------------
--------------------------------------------------------------------------------------------------------------------------------------------
--------------------------------------------------------------------------------------------o-----------------------------------------------
--------------------------------------------------------------------------------------------------------------------------------------------
-----------------------------SSSSSSSSSSS---------------------------------Q---<>-------------------------------------------------------------
-----------------------------SSSSSSSSSSS-----------------------------------<>[]-------------------------------------------------------------
-----------------------------SSSSSSSSSSS-----------------------------------[][]----------------E--------------------------------------------
-----------------------------SSSSSSSSSSS--------------------------------------B-------------------------------------------------------------
XXXXXXXXXXXXXXXXXXXXXXXXXXXXXXXXXXXXXXXXXXXXXXXXXXXXXXXXXXXXXXXXXXXXXXXXXXXXXXXXXXXXXXXXXXXXXXXXXXXXXXXXXXXXXXXXXXXXXXXXXXXXXXXXXXXXXXXXXXXX