--------------------------------------------------------------------------------------------------------------------------------------------
--------------------------------------------------------------------------------------------------------------------------------------------
--------------------------------------------------------------------------------------------------------------------------------------------
--------------------------------------------------------------------------------------------------------------------------------------------
--------------------------------------------------------------------------------------------------------------------------------------------
--------------------------------------------------------------------------------------------------------------------------------------------
--------------------------------------------------------------------------------------------------------------------------------------------
-----------------------------------------------------------o--------------------------------------------------------------------------------
-------------------------------------------------------------------S?--S--------------------------------------------------------------------
-------------------------------------------------------------------SSSSS?---------------------------------o---------------------------------
-------------------------------------------------------------------<>-----------------------------------------------------------------------
-------------------------------------------------------------------[]---B------------------E------------------------------------------------
-------------------------------------------------------------------b------------------------------------------------------------------------
XXXXXXXXXXXXXX--XXXXXXXXXXXXXXXXXXXXXXXXXXXXXXXXXXXXXXXXXXXXXXXXXXXXXXXXXXXXXXXXXXXXXXXXXXXXXXXXXXXXXXXXXXXXXXXXXXXXXXXXXXXXXXXXXXXXXXXXXXX-