--------------------------------------------------------------------------------------------------------------------------------------------
--------------------------------------------------------------------------------------------------------------------------------------------
--------------------------------------------------------------------------------------------------------------------------------------------
--------------------------------------------------------------------------------------------------------------------------------------------
--------------------------------------------------------------------------------------------------------------------------------------------
--------------------------------------SSS---------------------------------------------------------------------------------------------------
--------------------------------------SSS-------?----E----S---------------------------------------------------------------------------------
--------------------------------------------------------------------------------------------------------------------------------------------
--------------------------------------<>----------------------------------------------------------------------------------------------------
--------------------------------------[]----------------------------------------------------------------------------------------------------
--------------------------------------B-----------------------------------------------------------------------------------------------------
--------------------------------------b------------------------------------XXXXXXXXXXXXXXXXXXXXXXXXXXXXXXX----------------------------------
------------------------------------------------------XXXXXXXXXXXXXXXXXXXXXXXXXXXXXXX-------------------------------------------------------
XXXXXXXXXXXXXXXXXXXXXXXXXXXXXXXXXXXXXXXXXXXXXXXXXXXXXXXXXXXXXXXXXXXXXXXXXXXXXXXXXXXXXXXXXXXXXXXXXXXXXXXXXXXXXXXXXXXXXXXXXXXXXXXXXXXXXXXXXXXX