--------------------------------------------------------------------------------------------------------------------------------------------
--------------------------------------------------------------------------------------------------------------------------------------------
---------------------------------------o------------------------o---------------------------------------------------------------------------
--------------------------------------------------------------------------------------------------------------------------------------------
----------------------------E------------------------E--------------------------------------------------------------------------------------
---------------------------XXX---------------------XXXXXX-----------------------------------------------------------------------------------
--------------------------------------------------------------------------------------------------------------------------------------------
----------------------------------------------------------------------------------------S---------------------------------------------------
-----------------------------------------<>----------------------<>-----------------------------------------------------------<>------------
-----------------------------------------[]----------------------[]-----------------------------------------------------------[]------------
-----------------------------B--------------------------------------------------------------------------------------------------------------
-----------------------------b--------------------------------------------------------------------------------------------------------------
XXXXXXXXXXXXXXXXXXXXXXXXXXXXXXXXXXXXXXXXXXXXXXXXXXXXXXXXXXXXXXXXXXXX-----------------------------------------XXXXXXXXXXXXXXXXXXXXXXXXXXXXXXX
XXXXXXXXXXXXXXXXXXXXXXXXXXXXXXXXXXXXXXXXXXXXXXXXXXXXXXXXXXXXXXXXXXXX-----------------------------------------XXXXXXXXXXXXXXXXXXXXXXXXXXXXXXX