--------------------------------------------------------------------------------------------------------------------------------------------
--------------------------------------------------------------------------------------------------------------------------------------------
--?---------------<>---------<>------------o---o--------------------------------------------------------------------------------------------
------------------[]---------[]--------------E----------------------------------------------------------------------------------------------
------------------[]---------[]--------------E----------------------------------------------------------------------------------------------
------------------[]---------[]--------------E-----------SSS--------------------------------------------------------------------------------
------------------[]---------[]--------------E-----------SSS--------------------------------------------------------------------------------
------------------[]---------[]--------------E-----------SSS--------------------------------------------------------------------------------
------------------[]---------[]--------------E-----------SSS--------------------------------------------------------------------------------
------------------[]---------[]--------------E-----------SSS--------------------------------------------------------------------------------
------------------[]---------[]--------------E-----------SSS--------------------------------------------------------------------------------
------------------[]---------[]--------------E-----------SSS--------------------------------------------------------------------------------
XXXXXXXXXXXXXXXXXXXXXXXXXXXXXXXXXXXXXXXXXXXXXXXXXXXXXXXXXXXXXXXXXXXXXXXXXXXXXXXXXXXXXXXXXXXXXXXXXXXXXXXXXXXXXXXXXXXXXXXXXXXXXXXXXXXXXXXXXXXX
XXXXXXXXXXXXXXXXXXXXXXXXXXXXXXXXXXXXXXXXXXXXXXXXXXXXXXXXXXXXXXXXXXXXXXXXXXXXXXXXXXXXXXXXXXXXXXXXXXXXXXXXXXXXXXXXXXXXXXXXXXXXXXXXXXXXXXXXXXXX