--------------------------------------------------------------------------------------------------------------------------------------------
--------------------------------------------------------------------------------------------------------------------------------------------
--------------------------------------------------------------------------------------------------------------------------------------------
--------------------------------SSSSSSSSSS-------------------------------------------------------------------------SSSSSSSSSSS--------------
------------------------------------?-----------------------------------------------------------------------------------?-------------------
--------------------------------------------------------------------------------------------------------------------------------------------
----------------------------------------<>----------------------------------------------------------------<>--------------------------------
----------------------------------------[]----E------------------------------------------------------------<>-------------------------------
----------------------------------------o---------------------------------------------------------------o-----------------------------------
--------------------------------------------------------------------------------------------------------------------------------------------
--------------------------------------------------------------------------------------------------------------------------------------------
----------------------------B---------------------------------------------------------B-----------------------------------------------------
----------------------------b---------------------------------------------------------b-----------------------------------------------------
XXXXXXXXXXXXXXXXXXXXXXXXXXXXXXXXXXXXXXXXXXXXXXXXXXXXXXXXXXXXXXXXXXXXXXXXXXXXXXXXXXXXXXXXXXXXXXXXXXXXXXXXXXXXXXXXXXXXXXXXXXXXXXXXXXXXXXXXXXXX