--------------------------------------------------------------------------------------------------------------------------------------------
--------------------------------------------------------------------------------------------------------------------------------------------
--------------------------------------------------------------------------------------------------------------------------------------------
--------------------------------------------------------------------------------------------------------------------------------------------
--------------------------------------------------------------------------------------------------------------------------------------------
---------------------SSSSS----?-------------------------------------------------------------------------------------------------------------
--------------------------------<>----------------------------------------------------------------------------------------------------------
--------------------------------[]----------------------------------------------------------------------------------------------------------
--------------------------------[]----------------------------------------------------------------------------------------------------------
--------------------------------[]----------------------------------------------------------------------------------------------------------
--------------------------------[]----------------------------------------------------------------------------------------------------------
--------------------------------[]----------------------------------------------------------------------------------------------------------
--------------------------------[]-B----------------------o---------------------------------------------------------------------------------
XXXXXXXXXXXXXXXXXXXXXXXXXXXXXXXXXXXXXXXXXXXXXXXXXXXXXXXXXXXXXXXXXXXXXXXXXXXXXXXXXXXXXXXXXXXXXXXXXX--E---------------------------------------