--------------------------------------------------------------------------------------------------------------------------------------------
--------------------------------------------------------------------------------------------------------------------------------------------
--------------------------------------------------------------------------------------------------------------------------------------------
--------o-----------------------------------------------------------------------------------------------------------------------------------
--------o-----------------------------------------------------------------------------------------------------------------------------------
-----------------???????-----???????--------------------------------------------------------------------------------------------------------
------------------------SSSSS------SSSSSS---------------------------------------------------------------------------------------------------
------------------------SSSSS------SSSSSS---------------------------------------------------------------------------------------------------
--------------------------<>----------<>--------------E-------------------------------------------------------------------------------------
--------------------------[]----------[]--------------E-------------------------------------------------------------------------------------
--------------------------[]----------[]----------------B-----------------------------------------------------------------------------------
--------------------------[]----------[]----------------b-----------------------------------------------------------------------------------
XXXXXXXXXXXXXXXXXXXXXXXXXXXXXXXXXXXXXXXXXXXXXXXXXXXXXXXXXXXXXXXXXXXXXXXXXXXXXXXXXXXXXXXXXXXXXXXXXXXXXXXXXXXXXXXXXXXXXXXXXXXXXXXXXXXXXXXXXX--
XXXXXXXXXXXXXXXXXXXXXXXXXXXXXXXXXXXXXXXXXXXXXXXXXXXXXXXXXXXXXXXXXXXXXXXXXXXXXXXXXXXXXXXXXXXXXXXXXXXXXXXXXXXXXXXXXXXXXXXXXXXXXXXXXXXXXXXXXX--