--------------------------------------------------------------------------------------------------------------------------------------------
--------------------------------------------------------------------------------------------------------------------------------------------
--------------------------------------------------------------------------------------------------------------------------------------------
---------------------------------------E----------------------------------------------------------------------------------------------------
--------------------------------------o?SSSS------------------------------------------------------------------------------------------------
------------------------------------ooSSSSSSSSS---------------------------------------------------------------------------------------------
--------------------------------------ooSS?SS-----------------------------------------------------------------------------------------------
--------------------------------------------------------------------------------------------------------------------------------------------
----------------------E-------------<>------------------------------------------------------------------------------------------------------
------------------------------E[]-----------------------------------------------------------------------------------------------------------
------------------------------[]------------------------------------------------------------------------------------------------------------
------------------------------B-------------------------------------------------------------------------------------------------------------
------------------------------b-------------------------------------------------------------------------------------------------------------
XXXXXXXXXXXXXXXXXXXXXXXXXXXXXXXXXXXXXXXXXXXXXXXXXXXXXXXXXXXXXXXXXXXXXXXXXXXXXXXXXXXXXXXXXXXXXXXXXXXXXXXXXXXXXXXXXXXXXXXXXXXXXXXXXXXXXXXXXXXX