--------------------------------------------------------------------------------------------------------------------------------------------
--------------------------------------------------------------------------------------------------------------------------------------------
--------------------------------------------------------------------------------------------------------------------------------------------
-------------E--------------------------------------------------B---------------------------------------------------------------------------
-------------------------------------------------<>-----------------------------------------------------------------------------------------
-Q-----SSSS--------------S-----------------------E-------------<>>--------------------------------------------------------------------------
-------------------------------------------------[]-----------------------------------------------------------------------------------------
---------------------o-------------------------------------------------------------------------------------E--------------------------E-----
----------------------------------o----------------------------------------------------------------------------------------o----------------
------------------?-----------------B----------------S--------E--------------------------Q-------Q------Q------SSSS--SSSSSSSS----SS----SX---
----------E-------------------E----[]--------------<>---------S--------------------<>------<>----------------<>>-----<>-----<>--<>--<>-XX---
XXXXXXXXXXXXXXXXXXXXXXXXXXXXXXXXXXXXXXXXXXXXXXXXXXXXXXXXXXXXXXXXXXXXXXXXXXXXXXXXXXXXXXXXXXXXXXXXXXXXXXXXXXXXXXXXXXXXXXXXXXXXXXXXXXXXXXXXXXXX
XXXXXXXXXXXXXXXXXXXXXXXXXXXXXXXXXXXXXXXXXXXXXXXXXXXXXXXXXXXXXXXXXXXXXXXXXXXXXXXXXXXXXXXXXXXXXXXXXXXXXXXXXXXXXXXXXXXXXXXXXXXXXXXXXXXXXXXXXXXX
XXXXXXXXXXXXXXXXXXXXXXXXXXXXXXXXXXXXXXXXXXXXXXXXXXXXXXXXXXXXXXXXXXXXXXXXXXXXXXXXXXXXXXXXXXXXXXXXXXXXXXXXXXXXXXXXXXXXXXXXXXXXXXXXXXXXXXXXXXXX