--------------------------------------------------------------------------------------------------------------------------------------------
------------------------------------------------------------------o-------------------------------------------------------------------------
--------------------------------------------------------------------------------------------------------------------------------------------
--------------------------------------------------------------------------------------------------------------------------------------------
-------------------------------------------------o---------------------------------------------------o--------------------------------------
--------------------------------------------------------------------------------------------------------------o-----------------------------
--------------------------------------------------------------------------------------------------------------------------------------------
-------------------------------SS-----------------------------------SS--------------E--------------------o----------------------------------
---------------------------SS--SS--------QQQ------SS--SS------------------------SS----------------------------------------------------------
------------------E--------SS--SS-----------------SS--SS---------------<>-------SS------------------------------------------<>--------------
-----------------------------------------SS------SS--SS---------------[]----------------E---------------------<>----[]----------------------
-------------------------------------------XXXXXXXXXXXXXXX--XXXXXXXXXXXXXXXXXXXXXXXXXXXXXXXXXXXXXXXXXXXXXXXXXXXXXXXXXXXXXXXXXXXXXXXXXXXX----
XXXXXXXXXXXXXXXXXXXXXXXXXXXXXXXXXXXXXXXXXXXXXXXXXXXXXXXXXXXXXXXXXXXXXXXXXXXXXXXXXXXXXXXXXXXXXXXXXXXXXXXXXXXXXXXXXXXXXXXXXXXXXXXXXXXXXXXXXX--
XXXXXXXXXXXXXXXXXXXXXXXXXXXXXXXXXXXXXXXXXXXXXXXXXXXXXXXXXXXXXXXXXXXXXXXXXXXXXXXXXXXXXXXXXXXXXXXXXXXXXXXXXXXXXXXXXXXXXXXXXXXXXXXXXXXXXXXXXX--