--------------------------------------------------------------------------------------------------------------------------------------------
--------------------------------------------------------------------------------------------------------------------------------------------
--------------------------------------------------------------------------------------------------------------------------------------------
--------------------------------------------------------------------------------------------------------------------------------------------
--------------------------------------------------------------------------------------------------------------------------------------------
--------------------------------------------------------------------------------------------------------------------------------------------
----------------------------------------------------------------?---S-------Q---------------------------------------------------------------
----------------------------<>---------------------------------SS---S-------S---------------------------------------------------------------
----------------------------[]---------------------------------SS---S-------S---------------------------------------------------------------
----------------------------[]---------------------------------SS---S-------S---------------------------------------------------------------
----------------------------[]---------------------------------SS---S-------S---------------------------------------------------------------
----------------------------[]--o-----------------------------SS---S-------S----------------------------------------------------------------
----------------------------[]---------------------------------SS---S-------S---------------------------------------------------------------
XXXXXXXXXXXXXXXXXXXXXXXXXXXXXXXXXXXXXXXXXXXXXXXXXXXXXXXXXXXXXXXXXXXXXXXXXXXXXXXXXXXXXXXXXXXXXXXXXXXXXXXXXXXXXXXXXXXXXXXXXXXXXXXXXXXXXXXX----