--------------------------------------------------------------------------------------------------------------------------------------------
--------------------------------------------------------------------------------------------------------------------------------------------
--------------------------------------------------------------------------------------------------------------------------------------------
--------------------------------------------------o-----------------------------------------------------------------------------------------
--------------------------------------------------------------------------------------------------------------------------------------------
-------------------------SS------------------------------------------------------------------------------S----------------------------------
------------------------QQQ---B--E-------------------------------------------------------------------Q?Q?Q----------------------------------
----------------------------b---------------------------------------------------------------------------------------------------------------
----------------------------------------<>------------------------E-------------------------------------------------------------------------
-----------------------------------------Q?Q?-----------------------oo------Q?Q?------------------------------------------------------------
------------------------------------------------SS-----------------------------SS-----------------------------------------------------------
----------------------------------------[]------------E------------------------------------------------------[]-----------------------------
--------------------------------------------------------------------------------------------------------------------------------------------
XXXXXXXXXXXXXXXXXXXXXXXXXXXXXXXXXXXXXXXXXXXXXXXXXXXXXXXXXXXXXXXXXXXXXXXXXXXXXXXXXXXXXXXXXXXXXXXXXXXXXXXXXXXXXXXXXXXXXXXXXXXXXXXXXXXXXXXXXXX-