--------------------------------------o-----------------------------------------------------------------------------------------------------
------------------o------------------oo-----------------------------------------------------------------------------------------------------
---------o--------------------------oooo----------------------------------------------------------------------------------------------------
------------------o----------------oooooooo-------------------------------------------------------------------o-----------------------------
---------------------E------------ooooooooooo-----------------------------------------------------------------------------------------------
-----------o--------o-------------oooooooooo------------------------------------------------------------------------------------------------
---------------------o------------oo--------------------------------------------------------------------------------------o-----------------
-----ooooooooo--------------------ooooo----------------------------------------------------------------------------------o------------------
-------------------------<>--<>-----SSSS-----------------------------------------------------------------------B------oo--------------------
-------------------------[]--[]---<?SSSSS---------------------------------------------------------------------b-----------------------------
-----------------------E[]--[]-----SSSSSS---------------------------------------------------------------------------------------------------
-----------------------E---------SSSSSSS-----?----------------------------------------------------------------------------------------------
--------------------------------XXXXXXXXXXXXXXXXXXXXXXXXXXXXXXXXXXXXXXXXXXXXXXXXXXXXXXXXXXXXXXXXXXXXXXXXXXXXXXXXXXXXXXXXXXXXXXXX------------
XXXXXXXXXXXXXXXXXXXXXXXXXXXXXXXXXXXXXXXXXXXXXXXXXXXXXXXXXXXXXXXXXXXXXXXXXXXXXXXXXXXXXXXXXXXXXXXXXXXXXXXXXXXXXXXXXXXXXXXXXXXXXXXXXXXXXXXXXXXX