--------------------------------------------------------------------------------------------------------------------------------------------
---E----------------------------------------------------------------------------------------------------------------------------------------
--------------------ooo---------------------------------------------------------------------------------------------------------------------
--------SS---SS---SS-------------------------------<>---------------------------------------------------------------------------------------
---------------Q-----------------------------------[]---------------------------------------------------------------------------------------
--------------------------------------------------------------------------------------------------------------------------------------------
--------------------------------------------------------------------------------------------------------------------------------------------
--------------------------------------------------------------------------------------------------------------------------------------------
--------------------------------------------------------------------------------------------------------------------------------------------
--------------------------------------------------------------------------------------------------------------------------------------------
----------B---------------------------------------------------------------------------------------------------------------------------------
----------b--------------------------------------------------------------E------------------------------------------------------------------
----------------------X----------------------------------------------X----------------------------------------------------------------------
XXXXXXXXXXXXXXXXXXXXXXXXXXXXXXXXXXXXXXXXXXXXXXXXXXXXXXXXXXXXXXXXXXXXXXXXXXXXXXXXXXXXXXXXXXXXXXXXXXXXXXXXXXXXXXXXXXXXXXXXXXXXXXXXXXXXXXXXXXXX