--------------------------------------------------------------------------------------------------------------------------------------------
--------------------------------------------------------------------------------------------------------------------------------------------
-----------------SSS--------------------------SSS-------------------------------------------------------------------------------------------
---------------SSSSS------------------------SSS---SS----------------------------------------------------------------------------------------
------------------------------SS------------------------------------SSS---------------------------------------------------------------------
--------SSSS----?-----Q------------------------------------------------------?--------------------------------------------------------------
--------------------------------------------------------------------------------------------------------------------------------------------
------------------------<>-----------------------------------------------------------------------------------------<>-----------------------
------------------------[]-----------------------------------------------------------------------------------------[]-----------------------
------------------------[]-----E-o---------------------------------------------------------------------------------[]-----------------------
--------------------------------------------------------------------------------------------------------------------------------------------
--------------------------------------------------------------------------------------------------------------------------------------------
--------------------------------------------------------------------------------------------------------------------------------------------
XXXXXXXXXXXXXXXXXXXXXXXXXXXXXXXXXXXXXXXXXXXXXXXXXXXXXXXXXXXXXXXXXXXXXXXXXXXXXXXXXXXXXXXXXXXXXXXXXXXXXXXXXXXXXXXXXXXXXXXXXXXXXXXXXXXXXXXXXXXX