--------------------------------------------------------------------------------------------------------------------------------------------
--------------------------------------------------------------------------------------------------------------------------------------------
--------------------------------------------------------------------------------------------------------------------------------------------
------------------------------------------------E-------------------------------------------------------------------------------------------
---------------------------------------------------S-S-S----------------------------------------------------------------------S-------------
----------------------------------------????---------------------B-----------------------------------o--------------------------------------
-------o------------------------------------------------------------------------------------------------------------------------------------
-------------------------------------------------------<>---------------o---------------------------------------------------------<>--------
------------------------------------------------------E--[]------------------------------------------------------------[]-------------------
--------------------------------------------------------------------[]------------------------------------------------------------[]--------
------------??????----------------------------------------------S-S-S-S------------------------------------------------------------E--------
--------------------------------------------------------------------------------------------------------------------------------------------
--------------------------------------------------------------------------------------------------------------------------------------------
XXXXXXXXXXXXXXXXXXXXXXXXXXXXXXXXXXXXXXXXXXXXXXXXXXXXXXXXXXXXXXXXXXXXXXXXXXXXXXXXXXXXXXXXXXXXXXXXXXXXXXXXXXXXXXXXXXXXXXXXXXXXXXXXXXXXXXXXXXXX