--------------------------------------------------------------------------------------------------------------------------------------------
--------------------------------------------------------------------------------------------------------------------------------------------
--------------------------------------------------------------------------------------------------------------------------------------------
--------------------------o-----------------------------------------------------------------------------------------------------------------
----------E--------------------E-------------SSSSSSSSS---?-----------------------------?---------------------SSSSSSSSSSS------S-------------
SSSSSS-----XXXX-------------XXXX--oooooooo---SSSSSSSSSS--------------------------------SSSSSSSS---SSSSSS-----SSSSSSSSSSSS------Q------------
XXXXXXXXXXXXXXXXX--------XXXXXX---SSSSSSSS---SSSSSSSSSSSS-------------------SSSS-------SSSSSSSS---SSSSSSS>>---SSSSS----SSSSS---E------------
XXXXXXXXXXXXXX-----------SSSSSS--XXX--SSS-----XXXXSSSSSSSS----------------<>SSSSS>>----SSSSSSSS---SSSSSS][]---SSSSSS>>[]SSSS---Q------------
---------SSSSSS---------[][]SSSSSSSS[[][]]---SSSSSSSSSSSSS----------<E-----[]SSSS[]----SSSSSSSS---SSSSSS[]----SSSSSS[]-[][][]---Q-----------
XXXXXXXXXXXXXXXXXXXXXXXXXXXXX[]--XX[[]]--XXXXSSSSSSSSSSSS--------E-[]------[]SSSS[]----SSSSSSSS---SSSSSS[]----SSSSSS[]-[]--[]---Q-----------
XXXXXXXXXXXXXXXXXXXXXXXXXXXXXXXXXX[[]]XXXXXXXXXXXXXXXXXXXXXXXXXXXXXXXXXXXX---------XXXXXXXXXXXXXXXXXXXXXXXXXXXX-[][]---[][][]---XXXXXXXXXXXX
--------------------------------------------------------------------------------------------------------------------------------------------
--------------------------------------------------------------------------------------------------------------------------------------------
--------------------------------------------------------------------------------------------------------------------------------------------