--------------------------------------------------------------------------------------------------------------------------------------------
--------------------------------------------------------------------------------------------------------------------------------------------
--------------------------------------------------------------------------------------------------------------------------------------------
--------------------------------------------------------------------------------------------------------------------------------------------
------Q?Q?Q-----------------------------------------------------------------------------------o---------------------------------------------
----------------------------SS-------------------------------------------------------------------------SS-----------------------------------
---------------------------------------SSSS-----------------Q?Q?---------------------------------------Q?Q?Q--------------------------------
--------------------------------------------------------------------------------------------------------------------------------------------
-------------------------------Q?Q?Q--------------------------------------------------------------------------------------------------------
-------------------------------<>-----------------B-----------------------------------------------------------------------------------------
-----------------------------------------------------------------------<>-------------------------------------------------------------------
---------------------------------------------------------SSS--E---SSS--[]----------------------------------SSS------------------------------
----------------------------------E------------------------[]----------------------------------b--------------------------------------------
XXXXXXXXXXXXXXXXXXXXXXXXXXXXXXXXXXXXXXXXXXXXXXXXXXXXXXXXXXXXXXXXXXXXXXXXXXXXXXXXXXXXXXXXXXXXXXXXXXXXXXXXXXXXXXXXXXXXXXXXXXXXXXXXXXXXXXXXXXX-