--------------------------------------------------------------------------------------------------------------------------------------------
--------------------------------------------------------------------------------------------------------------------------------------------
--------------------------------------------------------------------------------------------------------------------------------------------
--------------------------------------------------------------------------------------------------------------------------------------------
---------------E--<>-----------------E--<>-------------------<>---------------------------------------------------------------------------o-
------------------[]----------------------[]-------------------[]-----------------------------------------------------------------------o---
-------o------------------------------------------------------------------------------------------------------------------------------------
--------------------------------------<>---------------------------------------------------------------<>----------------------o------------
--------------------------------------------------------------------------------BE----------------------[]----------------------------------
--------------------------------------[]-----------------------b---------------------------------------[]-----------------------------------
--------------------------------------[]-----------------------b---------------------------------------[]-----------------------------------
--------------------------------------[]-----------------------b---------------------------------------[]------------------------EE---------
--------------------------------------------------------------------------------------------------------------------------------------------
XXXXXXXXXXXXXXXXXXXXXXXXXXXXXXXXXXXXXXXXXXXXXXXXXXXXXXXXXXXXXXXXXXXXXXXXXXXXXXXXXXXXXXXXXXX---XXXXXXXXXXXXXXXXXXXXXXXXXXXXXXXXXXXXXXXXXXXXXX