--------------------------------------------------------------------------------------------------------------------------------------------
--------------------------------------------------------------------------------------------------------------------------------------------
--------------------------------------------------------------------------------------------------------------------------------------------
--------S-----------S-----------S-----------S-----------S-----------S-----------S-----------S-----------S-----------S-----------S-----------
----?-------Q-------?-------Q-------?-------Q-------?-------Q-------?-------Q-------?-------Q-----------------------------------------------
---------------o------------o------------o------------o------------o------------o------------o------------o-------------o-------------------
------------------E-----------------------------------E--------------------------------------E----------------------------------------------
------------------------------------------<>------------------------------------------<>----------------------------------------------------
--------------------------------------------------------------------------<>----------------------------------------------------------------
--------------------------------------------------------------------------[]----------------------------------------------------------------
--------------------------------------------------------------------------[]----------------------------------------------------------------
--------------------------------------------------------------------------[]----------------------B-----------------------------------------
--------------------------------------------------------------------------[]----------------------b-----------------------------------------
XXXXXXXXXXXXXXXXXXXXXXXXXXXXXXXXXXXXXXXXXXXXXXXXXXXXXXXXXXXXXXXXXXXXXXXXXXXXXXXXXXXXXXXXXXXXXXXXXXXXXXXXXXXXXXXXXXXXXXXXXXXXXXXXXXXXXXXXXXXX