--------------------------------------------------------------------------------------------------------------------------------------------
--------------------------------------------------------------------------------------------------------------------------------------------
--------------------------------------------------------------------------------------------------------------------------------------------
--------------------------------------------------------------------------------------------------------------------------------------------
----------------------------------------------SSSS------------------------------------------------------------------------------------------
-----?-------------------------------------------------------------------------------?------------------------------------------------------
---------------------SS------------------E----------------------E---------------------------------------------------------------------------
----------------------------------------------<>--------------------------------------------------------------------------------------------
----------------------------------------------[]--------------------------------------------------------------------------------------------
------------------------------B--------------------E---------------------E------------------------------------------------------------------
------------------------------b-------------------------------------------------------------------------------------------------------------
--------------------------------------------------------------------------------------------------------------------------------------------
----------------------------X---------------------------------------------------------------------------------------------------------------
XXXXXXXXXXXXXXXXXXXXXXXXXXXXXXXXXXXXXXXXXXXXXXXXXXXXXXXXXXXXXXXXXXXXXXXXXXXXXXXXXXXXXXXXXXXXXXXXXXXXXXXXXXXXXXXXXXXXXXXXXXXXXXXXXXXXXXXXXXXX