--------------------------------------------------------------------------------------------------------------------------------------------
----o---------------------------------------------------------------------------------------------------------------------------------------
---------------------------------------------------------------------o----------------------------------------------------------------------
--------------------------------------------------------------------------------------------------------------------------------------------
--------------------------------------------------------------------------------------------------------------------------------------------
--------------------------------------------------------o---------------------???-----------------------------------------------------------
--------------------------------------------------------------------------------------------------------------------------------------------
--------SSS----------------??????????--------------------???--------------------------------------------------------------------------------
-------------------------SS-----------------------------------------------------------------------------------------------------------------
-----------<>---------XXXXXXXXXX--------------------------------------------------------------------------B---------------------------------
-----------<>---------XXXXXXXXXX--------------------------------------------------------------------------B---------------------------------
-----------[]------XXXXXXXXXX--------------------------------------------------------------------------b------------------------------------
XX--X--E---E--XX--E---XX--E---XX--E---XX---XXXXXXXXXX---------XXXXXXXXXXXXXXXXXXXXXXXXXXXXXXXXXXXXXXXXXXXXXXXXXXXXXXXXXXXXXXXXXXXXXXXXXXXXXX
XXXXXXXXXXXXXXXXXXXXXXXXXXXXXXXXXXXXXXXXXXXXXXXXXXXXXXXXXXXXXXXXXXXXXXXXXXXXXXXXXXXXXXXXXXXXXXXXXXXXXXXXXXXXXXXXXXXXXXXXXXXXXXXXXXXXXXXXXXXX