--------------------------------------------------------------------------------------------------------------------------------------------
--------------------------------------------------------------------------------------------------------------------------------------------
--------------------------------------------------------------------------------------------------------------------------------------------
---------SSS------------------------------------------Q--------------------------S----------------------------------------------------------
------------------------------------------Q----------X---------------------------S--E-------------------------------------------------------
-------SSSSSS--S-----------------------S---B----------X--E----------------------<>----------------------------------------------------------
----------<>---------------------------<>-[]---------<>-------------------------<>>---------------------------------------------------------
----------[]---------------------------[]-[]---------[]-------------------------[]----------------------------------------------------------
----------[]-------------------X-------[]-[]---------[]-------------------------[]----------------------------------------------------------
----------[]-------S-----------X-------------SSS---E----------------------------[]----------------------------------------------------------
----------[]---SSSSS-----------X--SS---------SSSS--------------------------------[]----------------------------------------X---E------------
XXXXXXXXXXXXXXXXXXXXXXXXXXXXXXXXXXXXXXXXXXXXXXXXXXXXXXXXXXXXXXXXXXXXXXXXXXXXXXXXXXXXXXXXXXXXXXXXXXXXXXXXXXXXXXXXXXXXXXXXXXXXXXXXXXXXXXXX----
XXXXXXXXXXXXXXXXXXXXXXXXXXXXXXXXXXXXXXXXXXXXXXXXXXXXXXXXXXXXXXXXXXXXXXXXXXXXXXXXXXXXXXXXXXXXXXXXXXXXXXXXXXXXXXXXXXXXXXXXXXXXXXXXXXXXXXXX----
XXXXXXXXXXXXXXXXXXXXXXXXXXXXXXXXXXXXXXXXXXXXXXXXXXXXXXXXXXXXXXXXXXXXXXXXXXXXXXXXXXXXXXXXXXXXXXXXXXXXXXXXXXXXXXXXXXXXXXXXXXXXXXXXXXXXXXXX----