--------------------------------------------------------------------------------------------------------------------------------------------
--------------------------------------------------------------------------------------------------------------------------------------------
--------------------------------------------SSSSS-----SSSSQ---------------------------------------------------------------------------------
--------------------------------------------SSSSS-----SSSS----------------------------------------------------------------------------------
--------------------------------------------SSSSS-----SSSSQ------------------------------------E--------------------------------------------
--------------------------------------------SSSSS-----SSSS------------------------------------------------------------------Q---------------
--------------------------------------------------<>-----------------------------------------------------B----------------------------------
--------------------------------------------------[]-----------------------------------------------------b----------------------------------
--------------------------------------------------[]-----------------------------------------------------b----------------------------------
--------o-------------------------------------------o----------------------------------------o----------------------------------------------
--------------------------------------------------------------------------------------------------------------------------------------------
--------------------------------------------------------------------------------------------------------------------------------------------
XXXXXXXXXXXXXXXXXXXXXXXXXXXXXXXXXXXXXXXXXXXXXXXXXXXXXXXXXXXXXXXXXXXXXXXXXXXXXXXXXXXXXXXXXXXXXXXXXXXXXXXXXXXXXXXXXXXXXXXXXXXXXXXXXXXXXXXXXXXX
XXXXXXXXXXXXXXXXXXXXXXXXXXXXXXXXXXXXXXXXXXXXXXXXXXXXXXXXXXXXXXXXXXXXXXXXXXXXXXXXXXXXXXXXXXXXXXXXXXXXXXXXXXXXXXXXXXXXXXXXXXXXXXXXXXXXXXXXXXXX