--------------------------------------------------------------------------------------------------------------------------------------------
--------------------------------------------------------------------------------------------------------------------------------------------
---------------------------------------------------------<>---------------------------------------------------------------------------------
---------------------------------------------------------[]---------------------------------------------------------------------------------
---------------------------------------------------------[]---------------------------------------------------------------------------------
-------------------S-----------SS-----S--------------------------------------S---S-------S---S---S--BBBBBB----------------------------------
----------------------------------------------Q-------Q-------Q----o------------Q-----------------------------------------------------------
---------------------------------------------------------[]---------------------------------------------------------------------------------
---------------------------------------------------------[]---------------------------------------------------------------------------------
---------------------------------------------------------[]---------------------------------------------------------------------------------
---------------------------------------------------------[]---------------------------------------------------------------------------------
---------------------------------------------------------[]---------------------------------------------------------------------------------
---------------------------------------------------------[]---------------------------------------------------------------------------------
XXXXXXXXXXXXXXXXXXXXXXXXXXXXX--E---E---X--E----E--E----X--E--E---X--E----E----E------------XXXXXXXXXXXXXXXXXXXXXXXXXXXXXXXXXXXXXX-----------