--------------------------------------------------------------------------------------------------------------------------------------------
--------------------------------------------------------------------------------------------------------------------------------------------
--------------------------------------------------------------------------------------------------------------------------------------------
--------o--E----------o---------------------------------------------------------------------------------------------------------------------
------------------------------S-S-S---------------------------------------------------------------------------------------------------------
----------------------------???-?-???----------------------------------------B--------------------------------------------------------------
--------------------------------------------------------------------------------------------------------------------------------------------
--------------------------------------------------------------------------------------------------------------------------------------------
-------------------------------<>----------------------------------------------------------<>-----------------------------------------------
--------------------------------[]-----------------------------------------------------------[]---------------------------------------------
--------------------------------[]-----------------------------------------------------------[]---------------------------------------------
-------------------------------------------------------S---------???o---------------------------------b-------------------------------------
-------------------------------------------------------------S-S-S-S-S-S-----------------------------b-------------------------------E------
XXXXXXXXXXXXXXXXXXXXXXXXXXXXXXXXXXXXXXXXXXXXXXXXXXXXXXXXXXXXXXXXXXXXXXXXXXXXXXXXXXXXXXXXXXXXXXXXXXXXXXXXXXXXXXXXXXXXXXXXXXXXXXXXXXXXXXXXXXXX