--------------------------------------------------------------------------------------------------------------------------------------------
--------------------------------------------------------------------------------------------------------------------------------------------
--------------------------------------------------------------------------------------------------------------------------------------------
---------------------------------Q----------------------------------------------------------------------------------------------------------
--------SSSSSSSSS-------------------------?-----------------Q-------------------------------------------------------------------------------
--------------------------------------------------------------------------------------------------------------------------------------------
------------------------B-----------------B-----------------E-------------------------------------------------------------------------------
------------------------b-----------------b-----------------E-------------------------------------------------------------------------------
--------------------<>--------------------S-----------------E-------------------------------------------------------------------------------
-------------------[]-----------------------------------------------------------------------------S-----------------------------------------
-------------------[]-----------------------------------------------------------------------------S-----------------------------------------
-------------------[]-----------------------------------------------------------------------------S-----------------------------------------
-------------------[]-----------------------------------------------------------------------------S-----------------------------------------
XXXXXXXXXXXXXXXXXXXXXXXXXXXXXXXXXXXXXXXXXXXXXXXXXXXXXXXXXXXXXXXXXXXXXXXXXXXXXXXXXXXXXXXXXXXXXXXXXXXXXXXXXXXXXXXXXXXXXXXXXXXXXXXXXXXXXXXXXXXX