------------------E------------------------E----------------------E-------------------------------------------------------------------------
--------------------------------------------------E-----------------------------------------------------------------------------------------
------------SSSSSSSS-----------o------------------------------------------------------------------------------------------------------------
--------------------------------------------------------------------------------------------------------------------------------------------
--------------------------------------------------------------<->---------------------------------------------------------------------------
-------??Q--------------------------E-Q------------------------------------------------------[]---------------------------------------------
-----------------------S------------Q---?------------------------??-------------------[]----------------------------------------------------
-----------------------SSS-----------------SSSSSS-------SSSSSS-------------------S--------S-------------------B------------S----------------
-----------------------SSSSS--------SSSSS----------S-------------------SSSSSS------SS---------SS----------------------SSS-------------------
--------------------------------------------------------------------------------------------------------------------------------------------
--------------------------------------------------------------------------------------------------------------------------------------------
--------------------------------------------------------------------------------------------------------------------------------------------
-------------------XXXX--------------------------------------XXXX--------------------XXXX----------------XXXX-------------------------------
XXXXXXXXXXXXXXXXXXXXXXXXXXXXXXXXXXXXXXXXXXXXXXXXXXXXXXXXXXXXXXXXXXXXXXXXXXXXXXXXXXXXXX--XXXXXXXXXXXXXXXXXXXXXXXXXXXXXXXXXXXXXXXXXXXXXXXXXXXX