--------------------------------------------------------------------------------------------------------------------------------------------
-----------oo---------------------------------------------------------oo--------------------------------------------------------------------
--------------------------------------------------------------------------------------------------------------------------------------------
--------------------------------------------------------------------------------------------------------------------------------------------
--------------------------------------------------------------------------------------------------------------------------------------------
--------------------------------------------------------------------------------------------------------------------------------------------
--------------------------------------------------------------------------------------------------------------------------------------------
--------------------------------------------------------------------------------------------------------------------------------------------
-------------------SSS-------------<>-------SSSSS----?----------SSSS------------------------------------------------------------------------
-------------------[]-----------------------------------------------------------------------------------------------------------------------
-------------------B------------------------------------------------------------------------------------------------------------------------
-------------------b------------------------------------------------------------------------------------------------------------------------
-------------------E------------------------------------------------------------------------------------------------------------------------
XXXXXXXXXXXXXXXXXXXXXXXXXXXXXXXXXXXXXXXXXXXXXXXXXXXXXXXXXXXXXXXXXXXXXXXXXXXXXXXXXXXXXXXXXXXXXXXXXXXXXXXXXXXXXXXXXXXXXXXXXXXXXXXXXXXXXXXXXXX-