--------------------------------------------------------------------------------------------------------------------------------------------
--------------------------------------------------------------------------------------------------------------------------------------------
---------------SS------SSSSSSSSSSSSSS---------------------------------------------------------------------------------------SS--------------
B--------------------SSS--SSSSSS----SSSSS--------------------------------------------------------------------------------------SS-----------
b----------SSSS-------SS-SSS----SSSS--S---S--------------------------------SSS--------------------------------------------------------------
b---------------------------------------------?----------------------?----------------------------------------------?-----------------------
b-------------------------<>-----------------------------------------------------------------------------------<>---------------------------
---------------------------[]-----------------------------------------------------------------------------------[]--------------------------
---------------------------[]-----------------------------------E-----------------------------------------------[]--------------------------
--------------------------------------------------------------------------------------------------------------------------------------------
--------------------------------------------------------------------------------------------------------------------------------------------
--------------------------------------------------------------------------------------------------------------------------------------------
--------------------------------------------------------------------------------------------------------------------------------------------
XXXXXXXXXXXXXXXXXXXXXXXXXXXXXXXXXXXXXXXXXXXXXXXXXXXXXXXXXXXXXXXXXXXXXXXXXXXXXXXXXXXXXXXXXXXXXXXXXXXXXXXXXXXXXXXXXXXXXXXXXXXXXXXXXXXXXXXXXXXX