-----------------E-----------------------------------E---------------------E----------------------------------------------------------------
--------------------------------------------------------------------------------------------------------------------------------------------
------------SSSSSSSS-------------------------------------o----------------------------------------------------------------------------------
--------------------------------------------------------------------------------------------------------------------------------------------
--------------------------------------------------------------<->---------------------------------------------------------------------------
-------??Q---------------------------Q------------------------------------------------------[]----------------------------------------------
-----------------------S------------Q---?----E---------------??-------------------[            ]--------------------------------------------
-----------------------SSS----------B------SSSSS-------SSSSSS-------------------S--------S---------------------------------S----------------
-----------------------SSSSS--------SSSSS----------S-------------------SSSSSS------SS---------SS----------------------SSS-------------------
--------------------------------------------------------------------------------------------------------------------------------------------
--------------------------------------------------------------------------------------------------------------------------------------------
--------------------------------------------------------------------------------------------------------------------------------------------
-------------------XXXX--------------------------------------XXXX--------------------XXXX----------------XXXX-------------------------------
XXXXXXXXXXXXXXXXXXXXXXXXXXXXXXXXXXXXXXXXXXXXXXXXXXXXXXXXXXXXXXXXXXXXXXXXXXXXXXXXXXXXXX--XXXXXXXXXXXXXXXXXXXXXXXXXXXXXXXXXXXXXXXXXXXXXXXXXXXX