--------------------------------------------------------------------------------------------------------------------------------------------
--------------------------------------------------------------------------------------------------------------------------------------------
--------------------------------------------------------------------------------------------------------------------------------------------
--------------------------------------------------------------------------------------------------------------------------------------------
--------------------------------------------------------------------------------------------------------------------------------------------
----------------------------SSSSSSSS--------------------------------SSS---------QX------------------------------------------------------SSSS
--------------------------------------------------------------------------------------------------------------------------------------------
--------------------------------------------------------------------------------------------------------------------------------------------
--------------------------------------------------------------------------------------------------------------------------------------------
-----------------XX-----------------------X----X------<>Q--Q--Q--S-S--------S?SQSSSQ-SS----<>--------XX------------Q---S?S----SS----S---S---
--------<>------XXX-----------------------XX---XX-----XX-----------------------------------[]-------XXX------<>-----------------------------
X-------[]------XXX----------------------------XXX----<>----------------------------X------[]-------XXX------[]-----------------------------
E-EE----[]-----XXXX----------------E--EE---X---XXXX---XX----------------E----E------E------[]------XXXX------[]--------------------------E-E
XXXXXXXXXXXXXXXXXXXXXXXXXXXXXXXXXXXXXXXXXXXXX--XXXXXXXXXXXXXXXXXXXXXXXXXXXXXXXXXXXXXXXXXXXXXXXXXXXXXXXXXXXXXXXXXXXXXXXXXXXXXXXXXXXXXXXXXXXXX