--------------------------------------------------------------------------------------------------------------------------------------------
--------------------------------------------------------------------------------------------------------------------------------------------
--------------------------------------------------------------------------------------------------------------------------------------------
--------------------------------------------------------------------------------------------------------------------------------------------
----E---------------------------------------------------------------------------------------------------------------E-----------------------
SSSSSSSS--SSSS-----------SSS---------------------------------------------------------------------------------------SSQ----------------------
--------------------------------------------------------------------------------------------------------------------------------------------
--------------------------------------------------------------------------------------------------------------------------------------------
--------------------------------------------------------------------------------------------------------------------------------------------
--------------S-------S-----S--Q--Q--Q--QS----S--Q--Q--QS-SSS----S?S-S----S--Q--Q---------------QS------------------------------------------
--------------------------------------------------------------------------------------------------------------------------------------------
-------------------X---------------------------------------------------------------------------------------------------------------X------<>
---------------E---XX-----------------------E-E--E--------------------E-E-E--E------------------E-----E-------E-----------E--------XXX----[]
XXXXXXX--XXXXXXXXXXXXXXXXXXXXXXXXXXXXXXXXXXXXXXXXXXXXXXXXXXXXXXXXXXXXXXXXXXXXXXXXXXXXXXXXXXXXXXXXXXXXXXXXXXXXXXX------XXX-----------X------X