--------------------------------------------------------------------------------------------------------------------------------------------
--------------------------------------------------------------------------------------------------------------------------------------------
--------------------------------------------------------------------------------------------------------------------------------------------
--------------------------------------------------------------------------------------------------------------------------------------------
--------------------------------------------------------------------------------------------------------------------------------------------
----------------------------SS--SSSS--------SSSS------------------------SSQS---------------------------------------------------?-------SSS--
--------------------------------------------------------------------------------------------------------------------------------------------
--------------------------------------------------------------------------------------------------------------------------------------------
--------------------------------------------------------------------------------------------------------------------------------------------
------------QS-------SS------------Q------S?----------<>--------------S---------------SS-------------<>--------S------------QS-------Q------
------------------------------------------------------[]------------------------------------<>-------[]-------------------------------------
------------------------------------------------------[]---------------------------oX-------[]-------[]-------------------------------------
---------------------------------------E------------E-[]---------------------------SE-E-----[]-------[]-------------------------------------
XXXX---XXXX-XXXXXXX--XXXXXXXXXXXXXXXXXXXXXXXXXXXXXXXXXXXXXXXXXXX---XXXXXXX----XXXXXXXXXXXXXXXXXXXXXXXXXXXXXXXXXXXXXX----XXXXXXXXXXX--XXXXXXX