--------------------------------------------------------------------------------------------------------------------------------------------
--------------------------------------------------------------------------------------------------------------------------------------------
--------------------------------------------------------------------------------------------------------------------------------------------
--------------------------------------------------------------------------------------------------------------------------------------------
--------------------------------------------------------------------------------------------------------------------------------------------
S----------SSSQ----Q-----SSS--------------SQ-------SSSQ-----------------------------SSSS------------------------SSSSSSSS---------S-S--------
--------------------------------------------------------------------------------------------------------------------------------------------
--------------------------------------------------------------------------------------------------------------------------------------------
--------------------------------------------------------------------------------------------------------------------------------------------
?--Q---S?S----SS---SS---SSS-X--Q--Q--Q---S?S----S---------------------------------<>-------<>-------X--XX---------------------SS------------
--------------------------------------------------------------------------XX------[]-------[]-----XXX--XXX----------------------------------
---------------------------------------------------------------<>-X------XXXXX----[]-------[]-----XXX--XXXX----<>--------------------------o
---------------E----E--E-----------------------------E-E-------[]-X-----XXXXXXX-E-[]-------[]-E--XXXXX-XXXXX---X-----------E---------------E
XXXXXXXXXXXXXXXXXXXXXXXXXXXXXXXXXXXXXXXXXXXXXXXXXXXXXXXXXXXXXXXXXXXX--XXXXXXXXXXXXXXXXXXXXXXXXXXXXXXXX-XXXXXXXXXXXXXXXXX-XXXXXXXXXXXXXXXXXXX