--------------------------------------------------------------------------------------------------------------------------------------------
--------------------------------------------------------------------------------------------------------------------------------------------
--------------------------------------------------------------------------------------------------------------------------------------------
--------------------------------------------------------------------------------------------------------------------------------------------
--------------------------------------------------------------------------------------------------------------------------------------------
------------------------------------------------------------------------------------SSQ---?S--SSSSQ---SSS---SSSS----------------------------
-------------------------------------------------------------------------XX-----------------------------------------------------------------
-------------------------------------------------------------------------XXX-----------------E----------------------------------------------
-------------------------------------------------------------------------XX-X---------------------------------------------------------------
-----------------------------SS----<>-------X--X---------------<>-------XXXXX--------------S?S----S?---SS----------------------------SS-----
-----------------------------------[]------XX--XX--------------[]------XXX-XXX--------------------------------------------------------------
-----------------<>----------------[]-----XXX--XXX----S<>------[]-----XXXXXXXX---------------------------------<>-<>------------------------
--E---------E----[]-------E------E-[]-E---XXX--XXXX---<>E-EE---[]----XXXXXXXXXX--------------------E----E------[]-[]------------------------
XXXXXXXXXXXXXXXXXXXXXXXXXXXXXXXXXXXXXXXXXXXXXXXXXXXXXXXXXXXXXXXXXXXXXXXXXXXXXXXXXXXXXXXXXXXXXXXXXXXXXXXXXXXXXXXXXXXXXXXXXXX-XX---XXXXXXXXXXX