--------------------------------------------------------------------------------------------------------------------------------------------
--------------------------------------------------------------------------------------------------------------------------------------------
--------------------------------------------------------------------------------------------------------------------------------------------
--------------------------------------------------------------------------------------------------------------------------------------------
--------------------------------------------------------------------------------------------------------------------------------------------
-------------------------------------SSQQ------Q------XS-----------------------SSSQS--------------------------------------------------------
--------------------------------------------------------------------------------------------------------------------------------------------
------------------------------------------------------------------------------E-------------------------------------------------------------
-----------------------------------------------------------------------------------------------------XX-------------------------------------
-------------S---<>--------S-QS-Q--?S-Q--------S---XX---Q--Q--Q--Q----SS----S?SQS----SS--------------XX---------------------QS-------S------
-----------------[]-------------------------X------XX--------------------------------------<>-------XXXX------------------------------------
-----------------[]-----------------------XXXX---XXXX-------------------------------X------[]------XXXXX----------<>------------------------
--E---------E----[]-------E--E---E-------XXXXE--XXXXX-------------------------------<>-E---[]-----XXXXXXX---------[]------------------------
XXXXXXXXXXXXXXXXXXXXXXXXXXXXXXXXXXXXXXXXXXXXXXXXXXXXXXXXXXXXXXXXXXXXXXXXXXXXXXXXXXXXXXXXXXXXXXXXXXXXXXXXXXXXXXXXXXXXXXXXXXXXXXXXXXXXXXXXXXXX