--------------------------------------------------------------------------------------------------------------------------------------------
--------------------------------------------------------------------------------------------------------------------------------------------
--------------------------------------------------------------------------------------------------------------------------------------------
--------------------------------------------------------------------------------------------------------------------------------------------
--------------------------------------------------------------------------------------------------------------------------------------------
----S-----------------------------------SSS---------SS--------------------------------S?-------------------------------------QS-------------
--------------------------------------------------------------------------------------------------------------------------------------------
---------------------------------------------------------------------------------------------------------------------------EE---------------
--------------------------------------------------------------------------------------------------------------------------------------------
--------------------------------S--S-S----------S---------<>-------S?S---<>-----------------------X----X----------<>-----S?S------S--Q--Q--Q
-------------------------------------------------------------------------[]--------------------X--X----XX---------[]------------------------
-------------------XXX----<>---------------------------------------------------------------<>-X----X---XXX-----<>-[]------------------------
-------------------XXXX---[]----------------E-----------E-E---------E-E--<>------EE--------[]XXX----X-XXXXX----[]-[]----------E-E-E--E------
----XXX-------------X------XXXXXXXXXXXXXXXXXXXXXXXXXXXXXXXXXXXXXXXXXXXXXXXXXXXXXXXXX---XXXXXXXXX----XXXXXXXXXXXXXXXXXXXXXXXXXXXXXXXXXXXXXXXX