--------------------------------------------------------------------------------------------------------------------------------------------
--------------------------------------------------------------------------------------------------------------------------------------------
--------------------------------------------------------------------------------------------------------------------------------------------
--------------------------------------------------------------------------------------------------------------------------------------------
--------------------------------E-----------------------------------------------------------------------------------------------------------
-------------------------------SSQ------------------------------------------------------------------------------------------------------?---
--------------------------------------------------------------------------------------------------------------------------------------------
--------------------------------------------------------------------------------------------------------------------------------------------
--------------------------------------------------------------------------------------------------------------------------------------------
------------QS------------S----------------------------------------------------------SS----<>-------XXX--------------------S?S-------Q-----Q
-------------------------------------------------------------------------------------------[]------XXX--------------------------------------
------------------------------------------------------<>-----------------<>----------------[]------XXXX--------------------------<>---------
------------------------------------------------EX----[]-----------------[]-------E----E-E-[]-----XXXXX-----------E---------E----[]---------
XXXXXXXXXXXXXXXXXXXXXXXXXXXX------X--------------------XXXXXXXXXXXXXXXXXXXXXXXXXXXXXXXXXXXXXXXXXXXXXXXXXXXXXXXXXXXXXXXXXXXXXXXXXXXXXXXXXXXXX