--------------------------------------------------------------------------------------------------------------------------------------------
--------------------------------------------------------------------------------------------------------------------------------------------
--------------------------------------------------------------------------------------------------------------------------------------------
--------------------------------------------------------------------------------------------------------------------------------------------
--------------------------------------------------------------------------------------------------------------------------------------------
--------------------------------------------------------------------SQS-------------------------SQ------------------------------------------
--------------------------------------------------------------------------------------------------------------------------------------------
-------------------------------------------------------------------E------------------------------------------------------------------------
--------------------------------------------------S-----------------------------------------------------------------------------------------
Q--Q--Q-----QS-------Q--Q--------------------XX-----------<>-----S-S------S--QSQSSSS--SSS---<>-------XXS-----S----S-----<>-------<>---------
------------------------------------<>-------XX------------o--------------------------------[]--------------------------[]-------[]---------
----------------------------X-------[]-------XX---------------------------------------------[]-----X------------X-------[]-------[]------<>-
----------------------------E-E---E-[]------XXX-------E----E----------E-E-E--E------EE-E--E-[]----XXXE-----E----E-EE----[]-------[]------[]-
XXXXXXXXXXXXXXXXXXXXXXXXXXXXXXXXXXXXXXXXXXXXXXXXXXXXXXXXXXXXXXXXXXXXXXXXXXXXXXXXXXXXXXXXXXXXXXXXXXXXXXXXXXXXXXXXXXXXXXXXXXXXXXXXXXXXXXXXXXXX