--------------------------------------------------------------------------------------------------------------------------------------------
--------------------------------------------------------------------------------------------------------------------------------------------
--------------------------------------------------------------------------------------------------------------------------------------------
--------------------------------------------------------------------------------------------------------------------------------------------
--------------------------------------------------------------------------------------------------------------------------------------------
------------------------------Q--SSS---SSSSSS-------SSSS--SSSQ------------------------------------------------------------------------------
--------------------------------------------------------------------------------------------------------------------------------------------
--------------------------------------------------------------------------------------------------------------------------------------------
--------------------------------------------------------------------------------------------------------------------------------------------
--S-----<>-------XX---------X--Q--Q--Q----SS----S?S?S-----------------------------<>-------------------X--------------------QS----Q--Q--Q--S
--------[]------XX-------XX-------------------------------------------------------[]------------------XXX-----------------------------------
--------[]-----XXXX-----XXX-------------------------------------------------------[]-------<>-X-------XXXX----<>----------------------------
E-EE----[]----XXXXX----XXXXX----------------------------------------------------E-[]-------[]XX-----X-XXXXX---[]------------------E---------
XXXXXXXXXXXXXXXXXXXXXXXXXXXXXXXXXXX--XXXXXXXXXXXXXXXXXXX-XXX-----------------XXXXXXX-XXXXXXXXXXX---XX-XXXXXXXXXXXXXXXXXXXXXXXXXXXXXXXXXXXXXX