--------------------------------------------------------------------------------------------------------------------------------------------
--------------------------------------------------------------------------------------------------------------------------------------------
--------------------------------------------------------------------------------------------------------------------------------------------
--------------------------------------------------------------------------------------------------------------------------------------------
--------------------------------------------------------------------------------------------------------------------------------------------
-----SS------SSSSSSSS--SSSQS------------SSS---------SSSS--------------------------------------------------------S-----?S--SSQS----SQS-----XX
-------------------------------------------------------------------------------------------------------------------------------------------X
----------------------E-----------------------------------------------------------------------------------------------------------------X---
----------------------------------------------------------------------------------------------------------S----------------------------XXX--
X-------------SS----S-------X--Q--Q--Q----SS----S---S------------------------------------------------<>----------------SS----------S---XX-XX
--------------------------------------------------------------------------------------------<>-------[]-------------------------------XXX-XX
------------------------------------------------------------------------------------X-------[]-------[]------------------------------XXXX--X
---------------------------E---------------------------E----------------------------E-EE----[]-------[]-------E------------E-E-E-E--EXXXXX-X
XXXXXXX--XXXXXXXXXX--XXXXXXXXXXXXXXXXXXXXXXXXXXXXXXXXXXXXXXXXXXXXXXXXXXXXXXXXXXXXXXXXXXXXXXXXXXXXXXXXXXXXXXXXXXXXXXXXXXXXXXXXXXXXXXXXXXXXXXX