--------------------------------------------------------------------------------------------------------------------------------------------
--------------------------------------------------------------------------------------------------------------------------------------------
--------------------------------------------------------------------------------------------------------------------------------------------
--------------------------------------------------------------------------------------------------------------------------------------------
--------------------------------------------------------------------------------------------------------------------E-----------------------
------------SSSQ-------SQSQ----------------SSS-----SSSSS-------------Q------------------------------------------SSSSSSSS--------SSQSS-------
--------------------------------------------------------------------------------------------------------------------------------------------
-----------E--------------------------------------------------------------------------------------------------------------------------------
--------------------------------------------------------------------------------------------------------------------------------------------
Q-<>-----S?S--------S?S-S--Q--------------QS------------------------------S---------X-----------QS----------------------------S-----------<>
--[]--------------------------------------------------------------------------------------------------------------------------------------[]
--[]--------------------------------------------------------------------------------------------------------------------------------------[]
---E------------E----E----------------------------------------------E-E-E-E-------E-------------------------------------------------E-----[]
XXXXXXXXXXXXXXXXXXXXXXXXXXXXXXXXXXXXXXXXXXXXXXX-XXXXXXXXXXXXXXXXXXXXXXXXXXXXXXXXXXXX---X-----X---X--XXX---XXXXXX-XXXXXX---XXXXXX----XXXXXXXX