--------------------------------------------------------------------------------------------------------------------------------------------
--------------------------------------------------------------------------------------------------------------------------------------------
--------------------------------------------------------------------------------------------------------------------------------------------
--------------------------------------------------------------------------------------------------------------------------------------------
--------------------------------------------------------------------------------------------------------------------------------------------
--S----------------------------------------------------------------------------------------------------------------SSSSS--------------------
---------------------------------------------X----------------------------------------------------------------------------------------------
---------------------------------------------X-X--------------------------------------------------------------------------------------------
---------------------------------------------XX---S---------------------------S-------------------------------------------------------------
----------------------X---XX-------<>--------XX--------------------------XX----------SQ---------------b--------S----------Q---X----X------<>
---------------X-----XX---<>-------[]-------XXX----------------<>-------XXX------------------------------------------------X--XX---XX-----[]
-------<>-----XXX---XXX--XXX-------[]------XXXXX--------X------[]-------XXX--------------------------<>----------------<>-XX--XXX--XXX----[]
-------[]-E---XXX--XXXX-X-XX<>-E-E-[]-----XXXXX-----------EE---[]------XXXXX--------------------E----[]----------------[]-EX--XXX--XXXX---[]
XXXXXXXXXXXXXXXXXX-XXXXXXXXXXXXXXXXXXXXXXXXXXXXXXXXXXXXXXXXXXXXXXXXXXXXXXXXXXXXXXXXXXXXXXXXXXXXXXXXXXXXXXXXXXXXX--XXXXXXXXXXXXXXX--XXXXXXXXX