--------------------------------------------------------------------------------------------------------------------------------------------
--------------------------------------------------------------------------------------------------------------------------------------------
--------------------------------------------------------------------------------------------------------------------------------------------
--------------------------------------------------------------------------------------------------------------------------------------------
--------------------------------------------------------------------------------------------------------------------------------------------
-----------SSSQ----------SSS----------SSSQQ--------------------------------------------------------------------------------SSSS---SQS---S---
--------------------------------------------------------------------------------------------------------------------------------------------
------------------------E-------------------------------------------------------------------------------------------------------------------
--------------------------------------------------------------------------------------------------------------------------------------------
Q--Q-----S----------S?SQS------SS----S--------SS-----SS------------------------------------------------------------Q-----S-----S---SS-------
--------------------------------------------------------------------------X---------X-----------------XX------------------------------------
-------------------------------------------------------------------------XX------X<>X------<>--------XXX------------------------------------
---E-----------EE------------E------------E-E-E----E--------------------XXXX------[]X-E----[]XX-----XXXXX-----------------------E------E-E-E
XXXXXXXXXXXXXXXXXXXXXXXXXXXXXXXXXXXXXXXXXXXXXXXXXXXXXXXXXXXX--XXXX----XXXXXXXXXXXXXXXXXXXXXXXXXX--XXXXXXXXXXXXXXXXXXXXXXXXXXXXXXXXXXXXXXXXXX