--------------------------------------------------------------------------------------------------------------------------------------------
--------------------------------------------------------------------------------------------------------------------------------------------
--------------------------------------------------------------------------------------------------------------------------------------------
--------------------------------------------------------------------------------------------------------------------------------------------
----E-----------------------------------------------------E---------------------------------------------------------------------------------
SSSSSSSS------------------------------------------------SSQ---?S-SSSQS----SQ------XX------------SSS---SSS---SSSSSSSSSSSS--------------------
---------------------------------------------------------------------------------XXX--------------------------------------------------------
-------------------------------------------------------------------------------XXXXX--------------------------------------------------------
------------------------------------------------------------S------------------XXXXX--------------------------------------------------------
------------------------------------<>-------X--------------Q--SS-Q-----------XXXXXXQ--Q--Q--Q----SS----S---------------------QS------------
------------------------------------[]------XX---XX--XX-----------------------XXXXXX--------------------------------------------------------
-----------------------------------<>------XXX---XXXXXXX---------------------XXXXXXX------------------------------------------------------<>
-------------------------------E---X<>----XXXX--XXXXXXXX-------------E-E-E--XXXXXXXX---E-----------------------E--------------------------[]
----------------------------XXXXXXXXXXXXXXXXXXXXXXXXXXXXXXXXXXXXXXXXXXXXXXXXXXXXXXXXXXXXXXXXXXXXXXXXXXXXXXXXXXXXXXXXX-------XXXXXX----XXX--X