--------------------------------------------------------------------------------------------------------------------------------------------
--------------------------------------------------------------------------------------------------------------------------------------------
--------------------------------------------------------------------------------------------------------------------------------------------
--------------------------------------------------------------------------------------------------------------------------------------------
--------------------------------------------------------------------------------------------------------------------------------------------
-----------------------------Q----------SSSQ-------SSSQ-------------------------------------------S--------SSSQS----------------------------
--------------------------------------------------------------------------------------------------------------------------------------------
-------------------------------------------------------------------------X--------------------------------E---------------------------------
-------------------------------------------------------------------------X------------------------------------------------------------------
-SSS---------S----S------------------Q----------S---------------<>------XX--X-------Q--Q--Q--Q----SS----S------------------S?S--------------
-----------------------------------------------------------b----[]-----XXX--XX--------------------------------------------------------------
----------------------------------------------------------<>----[]----XXXX--XXXX---<>--------------------------------------------<>------<>-
--------------E-E-E----E-EE-----------------E--------E-EE-EE----[]---XXXXX-XXXXX---[]--------------------------E------------E----[]------[]-
XXXXXXXXXXXXXXXXXXXXXXXXXXXXXXXXXXXXXXXXXXXXXXXXXXXXXXXXXXXXXXXXXXXXXXXXXXXXXXXXXXXXXXXXXXXXXXXXXXXXXXXXXXXXXXXXXXXX--XXXXXXXXXXXXXXXXXXXXXX