--------------------------------------------------------------------------------------------------------------------------------------------
--------------------------------------------------------------------------------------------------------------------------------------------
--------------------------------------------------------------------------------------------------------------------------------------------
--------------------------------------------------------------------------------------------------------------------------------------------
--------------------------------------------------------------------------------------------------------------------------------------------
S---------SSSSQ---SQ----SSSS------------------------SSSS---SSSSS--------SSSSS----------------?-------------------------------SSQ-------SQS--
--------------------------------------------------------------------------------------------------------------------------------------------
---------E--------------E-------------------------------------------------------------------------------------------------------------------
--------------------------------------------------------------------------------------------------------------------------------------------
----S--S?S---------SS---S-S-------------------------------------------X----X---------SS----<>-Q-----XX--XX---XX-Q--Q--Q--Q----------SQ--Q--Q
----------------------------------------------------------------------XX---XX--------------[]------XXX--XXX--XXX----------------------------
----------------------------------------------------------------------XXX--XXX-----<>------[]-----XXXX--XXXXXXXX----------------------------
----------------E---E--E---------------------------------------EE-EE-XXXX--XXXX----[]E---E-[]----XXXXX--XXXXXXXX---E------------E----E------
XXXXXXXXXXXXXXXXXXXXXXXXXXXXXXXXXX----XXXXX--XX---XXXXXXXXXXXXXXXXXXXXXXXXXXXXXXXXXXXXXXXXXXXXXXXXXXXXXXXXXXXXXXXXXXXXXXXXXXXXXXXXXXXXXXXXXX