--------------------------------------------------------------------------------------------------------------------------------------------
--------------------------------------------------------------------------------------------------------------------------------------------
--------------------------------------------------------------------------------------------------------------------------------------------
--------------------------------------------------------------------------------------------------------------------------------------------
--------------------------------------------------------------------------------------------------------------------------------------------
----------------------------------------SSSQSQS----SSSQS---------------------------------SSS--------SSSSS---SSSS-----------SSS-----Q--------
-------------------------------------------------------------------------------------------------------------------------------------------X
--------------------------------------------------E----------------------------------------------------------------------------------------X
-----------------------------------------------------------------------------------------------------------------------------------------XXX
----------------------------S--Q-----S----------S?-------SSSS---SS---------S--------X-------------S?-------------------S?S---------S-----XXX
--------------------------------------------------------------------------------------------------------------------------------------XXXXXX
--<>-----------------------------------------------------------------------------------------------------------<>----------------------XXXXX
--[]-----------E----------------------------E------------E-----------EEEE------E-E-----------------------------[]------------E-EEE--E-XXXXXX
XXXXXXXXXXXXXXXXXXXXXXXXXXXXXXXXXXXXXXXXXXXXXXXXXXXXXXXXXXXXXXXXXXXXXXXXXXXXXXXXXXXXXXXXXX----XXXXXXXXX--XXXXXXXXXXXXXXXXXXXXXXXXXXXXXXXXXXX