--------------------------------------------------------------------------------------------------------------------------------------------
--------------------------------------------------------------------------------------------------------------------------------------------
--------------------------------------------------------------------------------------------------------------------------------------------
--------------------------------------------------------------------------------------------------------------------------------------------
--------------------------------------------------------------------------------------------------------------------------------------------
--------------?--------SQS--SSQ-------SSSS------------SS-------------------------------------SSSQS---SSQ-------X----------------------------
--------------------------------------------------------------------------------------------------------------XX----------------------------
--------------------------------------------------------------------------------------------------------------XX----------------------------
----------------------------------------------------------------------------------------S--------------------XXX----------------------------
Q--Q--Q-----QSQS-----SSQ----------------------------S--------------------------------Q--Q--SS-Q--------S-----XXX--------------X----X------<>
----------------------------------------------------------------------------------------------------------XXXXXX-----------X--XX---XX-----[]
-------------------------------------------------------------------------XXX------------------------------XXXXXX-------<>-X---XXX--XXX----[]
---E---------------------------------------E-----------------------------XXX---------E-----------E-E-E--E-XXXXXX-------[]-XX---XX--XXXX---[]
XXXXXXXXXXXXXXXXXXXXXXXXXXXXXXXXXXXXXXXXXXXXXXXXXXXXXXXXXXXXXXXXXX----XXXXXXXXXXXXXXXXXXXXXXXXXXXXXXXXXXXXXXXXXXXXXXXXXXXXXX--XXX--XXXXXXXXX