--------------------------------------------------------------------------------------------------------------------------------------------
--------------------------------------------------------------------------------------------------------------------------------------------
--------------------------------------------------------------------------------------------------------------------------------------------
--------------------------------------------------------------------------------------------------------------------------------------------
--------------------------------E-----------------------------------------------------------------------------------------------------------
------?S--SSQS-----Q-----SSSSSSSSSSS--------S-------SSSS------------------------------------------------------------------------------------
--------------------------------------------------------------------------------------------------------------------------------------------
------------------------E-------------------------------------------------------------------------------------------------------------------
--------------------------------------------------------------------------------------------------------------------------------------------
-------SS-----------S-S?S---X-------------SS-----SS------------------------------------S-------------<>-------------------------------XX---X
--------------------------------------------------------------------------------------------<>-------[]-------------------------------XX--XX
------------------------------------------------------------------------------------X-------[]-------[]------<>---<>----------------XXXX--XX
-----------E-E-E--------------------------------------------------------------------E-E-----[]----E--[]----E-[]---[]---E---E-E-E----XXXXX-XX
XXXXXXXXXXXXXXXXXXXXXXXXXXXXXXXXXX-----XXXX--XX---XXXXXXXXXXXXXXX--------XX----X--XXXXXXXXXXXXXXXXXXXXXXXXXXXXXXXXXXXXXXXXXXXXXXX--XXXXXXXXX