--------------------------------------------------------------------------------------------------------------------------------------------
--------------------------------------------------------------------------------------------------------------------------------------------
--------------------------------------------------------------------------------------------------------------------------------------------
--------------------------------------------------------------------------------------------------------------------------------------------
--------------------------------------------------------------------------------------------------------------------------------------------
------------------------------------------------------SS------SS---S?SSSSSSSS-----SS--------------------------------------------------------
--------------------------------------------------------------------------------------------------------------------------------------------
----------------------------------------------------E---------------------------------------------------------------------------------------
--------------------------------------------------------------------------------------------------------------------------------------------
--------------------------<>-----------------------?--------------------------------Q--Q---SSS----S----SS-------------------QS------------X-
---------------------XX---XS-------------------------------------------------------------------------------------------------------------<>o
-------<>--------XX--X---XXX--------<>-----------X---------------------------X-----<>----------------------------------------------------XXX
--E----[]-------XXXX-XX-XXXX--------[]-----E-E--EXXX-------E----------------EXX----[]----------E-E-E-------E-E-E------------------------XXXX
XXXXXXXXXX--XXXXXXXXXXXXXXXXXXXXXXXXXXXXXXXXXXXXXXXXXXXXXXXXXXXXXXXXXXXXXXXXXXXXXXXXXXXXXXXXXXXXXXXXXXXXXXXXXXXXXXXXXXXXXXXXXXXXXXXXXXXXXXXX