--------------------------------------------------------------------------------------------------------------------------------------------
--------------------------------------------------------------------------------------------------------------------------------------------
--------------------------------------------------------------------------------------------------------------------------------------------
--------------------------------------------------------------------------------------------------------------------------------------------
------------------------------------------------------------------------------------------------------------------E-E-----------------------
-----------------------------------------Q-----------------------SS--Q------------------------------------------SSSSSSSS--------SSQS--------
--------------------------------------------------------------------------------------------------------------------------------------------
-----------------------------------------------------------------------------------------------------X--------------------------------------
-----------------------------------------------------------------------------------------------------X--------------------------------------
--------------S---------------SS-----S-S------S----------SS-S--SSS----------SQ--Q--Q-------<>-------X--XX---------------------S-----------<>
-------------------------------------------------------------------------------------------[]------XXX-XXX---------------------------------?
-------------------------------------------------------------------------------------------[]-----XXXX-XXXX----<>--------------------X----<>
----------------------------EEE-----------E-E-E------EE--E------------E-E----E---------E---[]XX--XXXXX-XXXX----[]-------------------EX----[]
XXXXXXXXXXXXXXXXXXXXXXXXXXXXXXXXXXXXXXXXXXXXXXXXXXXXXXXXXXXXXXXXXXXXXXXXXXXXXXXXXXXX--XXXXXXXXXXXXXXXXXXXXXXXXXX--XXXXX-----XXX--------X---X