--------------------------------------------------------------------------------------------------------------------------------------------
--------------------------------------------------------------------------------------------------------------------------------------------
--------------------------------------------------------------------------------------------------------------------------------------------
--------------------------------------------------------------------------------------------------------------------------------------------
--------------------------------------------------------------------------------------------------------------------------------------------
-------------------------------------S?Q---------------X------------SSSQ-------SSSQS-------------SSSS-------S----------------Q--------------
------------------------------------------------------XX------------------------------------------------------------------------------------
----------------------------------------------------XXXX----------------------E-------------------------------------------------------------
----------------------------------------------------XXXX------------------------------------------------------------------------------------
-------------------------XX--SS-Q--?S-Q--------S----XXX--------S-S----SS----S?S-S---------------------------------<>-------S------S---------
-------------------------XX----------------XX-----XXXXX----------------------------------------------------------------------------------<>-
------------------------X<>---------------XXXX---XXXXXX----------------------------------------------------------------------------------[]-
----------------E-E----XXXX--E---E-------XXXXX--XXXXXX-X----------------------------------------E-----E-----------E---------E-E-E-E-----XXX-
XXXXXXXXXXXXXXXXXXXXXXXXXXXXXXXXXXXXXXXXXXXXXXXXXXXXXXX-XXXXXXXXXXXXXXXXXXXXXXXXXXXXXXXXXXXXXXXXXXXXXXXXXXXXXXXXXXXXXXXXXXXXXXXXXXXXXXXXXXXX