[
    74968588,
    20487350,
    18999608,
    17846405,
    17015980,
    16879131,
    17024605,
    16835035,
    16962896,
    17022458,
    16840075,
    16644018,
    16812969,
    16583052,
    17313676,
    16855202,
    17072030,
    16748452,
    16802670,
    16778691,
    16795477,
    17173925,
    16987351,
    16868194,
    16339995,
    16390489,
    16860790,
    16704955,
    15791998,
    12805928,
    13427088,
    13522863,
    13171179,
    13039021,
    13409839,
    12801742,
    13594222,
    13320272,
    12166524,
    12351273,
    13468096,
    13261157,
    12639441,
    13353305,
    13353381,
    13674760,
    13695970,
    13820978,
    12938528,
    13144205,
    13530970,
    13197226,
    13034469,
    12781766,
    12911622,
    13040678,
    13568021,
    13200576,
    13352917,
    13082005,
    13753612,
    13475929,
    13421852,
    13040007,
    13357696,
    12989424,
    13531911,
    13597457,
    12764854,
    17663347,
    13852061,
    13462220,
    12896604,
    13131828,
    13115416,
    13158232,
    13177518,
    13438779,
    12772257,
    13397839,
    13053925,
    13193902,
    13223133,
    12517913,
    12991228,
    13538305,
    13143280,
    12775413,
    13301757,
    13045389,
    13279431,
    13131568,
    13210044,
    13108282,
    13365527,
    13079035,
    13454094,
    12970376,
    13554823,
    13010059,
    13125622,
    13046608,
    12569093,
    12544605,
    13325107,
    13375944,
    12862980,
    13655708,
    13375779,
    13708371,
    12975160,
    13405748,
    13078003,
    13513411,
    13915737,
    13668359,
    13087653,
    12626558,
    12647870,
    13227868,
    13324080,
    12886609,
    13249952,
    13158615,
    13344027,
    13030471,
    13290626,
    12915249,
    13497832,
    12785736,
    13069514,
    14036129,
    12730731,
    12406996,
    14094815,
    13195435,
    13089735,
    13006429,
    13073804,
    13220836,
    13459075,
    13828873,
    13639191,
    12772765,
    13520982,
    13089954,
    13315655,
    13095441,
    12862040,
    13278450,
    12780268,
    13420714,
    12706547,
    13404914,
    13982733,
    13440975,
    13247108,
    13664628,
    13096579,
    13469168,
    14099055,
    13312114,
    13199135,
    13486888,
    12599259,
    13034120,
    13163485,
    12843316,
    13495833,
    12840606,
    13149538,
    13617881,
    13060653,
    13313022,
    13198941,
    13608665,
    13901115,
    13540121,
    12440097,
    12467307,
    13084288,
    13878470,
    13116235,
    13349297,
    13083174,
    13363342,
    13111097,
    13935658,
    13985775,
    13786668,
    13535235,
    13252720,
    13459413,
    12802144,
    12474439,
    13704033,
    13657103,
    12901160,
    14150189,
    13246325
]