--------------------------------------------------------------------------------------------------------------------------------------------
--------------------------------------------------------------------------------------------------------------------------------------------
--------------------------------------------------------------------------------------------------------------------------------------------
--------------------------------------------------------------------------------------------------------------------------------------------
--------------------------------------------------------------------------------------------------------------------------------------------
------?S--SSQS--SSSSS---SSSSSSSSSSS----------------------------------------------------?----------------------------------------------------
-------------------------------------------------------------------------X------------------------------------------------------------------
--------------------------------------------------------------------------XX----------------------------------------------------------------
-------------------------------------------------------------------------XXX----------------------------------------------------------------
----Q--SS-Q---S-------------------------------------------------<>-------XX-XX--------------------------------------------------------------
--------------------------------------------------X---XX--------[]------XXX-XXX---------------------------------------------------X---------
---------------------------X--------------------XXX---XXX-------[]-----XXXX-XXXX-X----------------------------<>-------<---------XXX--------
---------------E---------E-E---------------E----XXX---XXE-EE--E-[]----XXXXX-XXXXXX----------------------------[]--------]--------XXX--------
XXXXXXXXXXXXXXXXXXXXXXXXXXXXXXXXXXXXXXXXXXXXX--XXXXXXXXXXXXXXXXXXXXXXXXXXXXXXXXXXXXXXXX-----XX------------XXXXXX------XXX--------XXXXX----XX