--------------------------------------------------------------------------------------------------------------------------------------------
--------------------------------------------------------------------------------------------------------------------------------------------
--------------------------------------------------------------------------------------------------------------------------------------------
--------------------------------------------------------------------------------------------------------------------------------------------
--------------------------------------------------------------------------------------------------------------------------------------------
----------------------------SSSSSSSS--------------------------------------------------------------SQ-------SQSQS----------------------------
-------------------------------------------------------X------------------------------------------------------------------------------------
-------------------------------------------------------X--------------------------------------------------E---------------------------------
--------------------------------------------------------------------------------------------------------------------------------------S-----
---------------------SS---------------------------XX--XX----------------------------S--Q--Q--Q---S------S?S-Q--Q-----------------XX---------
------------------------------------------X------XXX--XX----------------------------------------------------------------<>------XXX---------
--<>--------------------------------------------XXXX--XX-------<>-----------------------------------------------X-------[]------XXX---------
--[-----------------------------------EE---X---XXXX-X-XX-------[]-----------------------------------E-----------E-EE--E-[]-----XXXX---------
XXXX-XXXX--------XX---XX--XXXXXXXXXXXXXX--XXX--XXXXXXXXXXXXXXXXXXX-----XXXX-XXXXXXXXXXXXXXXXXXXXXXXXXXXXXXXXXXXXXXXXXXXXXXXXXXXXXXXXXXXXXXXX