--------------------------------------------------------------------------------------------------------------------------------------------
--------------------------------------------------------------------------------------------------------------------------------------------
--------------------------------------------------------------------------------------------------------------------------------------------
--------------------------------------------------------------------------------------------------------------------------------------------
--------------------------------------------------------------------------------------------------------------------------------------------
-------------------------------------?------------------------------------------------SSS---------------------------------------------------
---------------------------------------------X----------------------------------------------------------------------------------------------
---------------------------------------------XXX--------------------------------------------------------------------------------------------
---------------------------------------------XX---------------------------------------------------------------------------------------------
-----------------------------------<>--------XX-XX------------------QS----------------------------X----X--------------------QS-------Q-----S
-----------------------------------[]-------XXX-XXX--X-----------------------------------------X--XX---XX-----------------------------------
----------------------------X------[]------XXXX-XXXX-XX---<>-------------------------------<>-XX--XXX--XXX----------------------------------
----------------------------E--E-E-[]-----XXXXX-XXXXXXX---[]---------------------EEE-------[]-XX--XXX--XXX------------------E-----E---------
XXXXXX-----------XX----XX-XXXXXXXXXXXXXXXXXXXXXXXXXXXXXXXXXXXXXXXXXXXXXXXXXXXXXXXXXX--XXXXXXXXXX--XXXXXXXXXXXXXXXXXXXXXXXXXXXXXXXXXXXXXXXXXX