--------------------------------------------------------------------------------------------------------------------------------------------
--------------------------------------------------------------------------------------------------------------------------------------------
--------------------------------------------------------------------------------------------------------------------------------------------
--------------------------------------------------------------------------------------------------------------------------------------------
--------------------------------------------------------------------------------------------------------------------------------------------
--------------------------------------------------------------------------------------------------------------------------------------------
-----------------------------------------------------------------------------------------------------X--------------------------------------
-----------------------------------------------------------------------------------------------------XXX------------------------------------
-----------------------------------------------------------------------------------------------------XX-------------------------------------
------------------------------------<--------XX----------------------------X--S------------<>-------XXXXXX------X-----------QSQ------SS-----
-----------------------------------<>-------XXX------<>--------------------X---------------[]------XXX--XX----------------------------------
-----------------<>-----XX--X------[]------XXXX------[]---<>----------XX---XX--------------[]-----XXXXX-XXXX--------------------------------
-----------------[]----XXXX-E-EE---[[------XXXX-----E[]---[]----------XX---XX-------E--E-E-[]----XXXXX-XXXXX--------------------------------
XXXXXXXXXXXXXXXXXXXXXXXXXXXXXXXXXXXXXXXXXXXXXXXXXXXXXXXXXXXXXXXXXXXXXXXXXXXXXXXXXXXXXXXXXXXXXXXXXXXXXXXXXXXXXXXXXXXX----XXXXXXX-XXX--XXXXXXX