--------------------------------------------------------------------------------------------------------------------------------------------
--------------------------------------------------------------------------------------------------------------------------------------------
--------------------------------------------------------------------------------------------------------------------------------------------
--------------------------------------------------------------------------------------------------------------------------------------------
----------------------------------------------------------------------------------------E---------------------------------------------------
-------------Q--------------------------SSS-----------S-----------------------------SSSSSSSS--------SSQSS----------?------------------------
--------------------------------------------------------------------------------------------------------------------------------------------
--------------------------------------------------------------------------------------------------------------------------------------------
--------------------------------------------------------------------------------------------------------------------------------------------
---S-----S-S------S--SSQS--QQ--Q--Q--S-----S----S---S----SQ---------QS----Q-----------------------S-----------------------------------------
---------------------------------------------------------------------------------------------------------------]----------------------------
---------------------------------------------------------------------------------------------------------X----[]-----------------<>------<>-
E-E------]----E-E-E------------E------------E-----------------------------E------EE------------E--------XXX---[]------------E----[]------[]-
XXXXXXXXXXXXXXXXXXXXXXXXXXXXXXXXXXXXXXXXXXXXXXXXXXXXXXXXXXXXXXXXXXXXXXXXXXXXXXXXXXXX--XXXXX---XXXXX-------XXXXXXXXXX---XXXX--XXXXXXXXXXXXXXX