--------------------------------------------------------------------------------------------------------------------------------------------
--------------------------------------------------------------------------------------------------------------------------------------------
--------------------------------------------------------------------------------------------------------------------------------------------
--------------------------------------------------------------------------------------------------------------------------------------------
----E---------------------------------------------------------------------------------------------------------------------------------------
---SSQS---------S-----------SS-------SSSSSQ---SQ--------SSSSSSSS--------SSSSS------------------SSSSQ-------SQSQS----------------------------
--------------------------------------------------------------------------------------------------------------------------------------------
-------------------------------------------------------X------------------------------------------------------------------------------------
--------------------------------------------------------------------------------------------------------------------------------------------
-----------------------------------SS----------S-----XXXX-------------S----------------Q-----S---------SS---SSS---<>-------S?S----S--Q--Q--Q
----------------------------------------------------XXXX---------------------------]------------------------------[]------------------------
---------------------------------------------------XXXXX--------------------------[]------------------------------[]------------------------
------------------------------------------EEE---E-XXXXXX----------EE---E----X-----[]----------------E----E---E----[]--------E---E-E--E------
---------------------------XXXXXXXXXXXXXXXXXXXXXXXXXXXXXXXXXXXXX--XXXXXXX--XXXXXXXXXXXXXXXXXXXXXXXXXXXXXXXXXXXXXXXXXXXXXXXXXXXXXXXXXXXXXXXXX