--------------------------------------------------------------------------------------------------------------------------------------------
--------------------------------------------------------------------------------------------------------------------------------------------
--------------------------------------------------------------------------------------------------------------------------------------------
--------------------------------------------------------------------------------------------------------------------------------------------
----------------------------------------------------------------------------------------E---------------------------------------------------
------------SSSSSSSSS---SSSS--------------------------SS--SSSSS---------------------SSSSSSSS--------SS--------------------------------------
---------------------------------------------------------------------------------------------------------------------------------X----------
---------------------------------------------------------------------------------------------------------------------------------XX--------X
---------------------------------------------------------------------------------------------------------------------------------X----------
---Q----------------S-----------------------------SQS-----------------Q-------S-------------------S--------------SS----<>-------XX--XXXX--XX
---------------------------------------------------------------------------------------------------------------]-------[]------XXX--XXX--XXX
--------------------------------------------------------------------------------------------------------XX----[<-------[]-----XXXXX-XXXX-XXX
----------------E--------E-----E---------------------------------------------------------------E--------XXX---X[---E-E-[]----XXXXXXXXXXXXXXX
XXXXXXXXXXXXXXXXXXXXXXXXXXXXXXXXXXXXXXXXXXXXXXXXXXXXXXXXXXXXXX---XXXXX---XX---XXXXXXXXXXXXX---XXXXXX---XXXXXXXXXXXXXXXXXXXXXXXXXXXXXXXXXXXXX