--------------------------------------------------------------------------------------------------------------------------------------------
--------------------------------------------------------------------------------------------------------------------------------------------
--------------------------------------------------------------------------------------------------------------------------------------------
--------------------------------------------------------------------------------------------------------------------------------------------
--------------------------------------------------------------------------------------------------------------------------------------------
-----------------------------QS?--------------------------------------------------------------------------------SSQ---------S---------------
--------------------------------------------------------------------------------------------------------------------------------------------
--------------------------------------------------------------------------------------------------------------------------------------------
--------------------------------------------------------------------------------------------------------------------------------------------
-SS----<>--------XX-XXX--X-----------------------XX------SS--------------<>-----------------------------------------S--SSS---------S-----S--
-------[]-------XXX--XX--XX-------------------X--XX---X------------------[]---------------------------XX--------------------------------X---
X------[]------XXXX--XXXXXX------------------X>--XX--XXX--------[>-------[]----------------<>--------XXX-------------------------------XX---
[------[]------XXXX--XXXXXXX-----------------[]X-XX-XXXX[-------[]-------[]-----------E----[]XX-----XXXX----------------------EEEE--E--XXE--
XXXXXXXXXXXXXXXXXXXXXXXXXXXXXXXX--XXXXX---XXXXXXXXXXXXXXXXXXXXXXXXXXXXXXXXXXXXXXXXXXXXXXXXXXXXXX---XXXXXXXXXXXXXXXXXXXXXXXXXXXXXXXXXXXXXXXXX