--------------------------------------------------------------------------------------------------------------------------------------------
--------------------------------------------------------------------------------------------------------------------------------------------
--------------------------------------------------------------------------------------------------------------------------------------------
--------------------------------------------------------------------------------------------------------------------------------------------
--------------------------------------------------------------------------------------------------------------------------------------------
--------------------------------?-----------------------------------------------------S-----------------------------------------------------
-------------------------------------------------------------------------XX-----------------------------------------------------------------
-------------------------------------------------------------------------XXX----------------------------------------------------------------
-------------------------------------------------------------------------XXXX---------------------------------------------------------------
--------------QS------------------------------------------------>-------XXXXX-----------------------------------------------------X---------
---------------------------------------------------------------<>------XXXXXX-------------------------------------------<>------XXX---------
--<>----------------------------------------------------X------[]-----XXXXXXX-----------------------------------X-<>----[]------XXXX--------
--[]----------------------------------------------------E-EE---[]----XXXXXXXX-----------------------------------]-[]----[]-----XXXXX--------
XXXXXXXXXXXXXXXXXXXXXXXXXXXX---X---------X-------------XXXXXXXXXXXXXXXXXXXXXXXXXXXXXXXXX----XX--XXXXXXX--XXXXXXXXXXXXXXXXXXXX-XXXXXXXXXXXXXX