--------------------------------------------------------------------------------------------------------------------------------------------
--------------------------------------------------------------------------------------------------------------------------------------------
--------------------------------------------------------------------------------------------------------------------------------------------
--------------------------------------------------------------------------------------------------------------------------------------------
--------------------------------------------------------------------------------------------------------------------------------------------
---?---------------------------------Q------------------------------------------------------------------------------------------------------
--------------------------------------------------------------------------------------------------------------------------------------------
--------------------------------------------------------------------------------------------------------------------------------------------
--------------------------------------------------------------------------------------------------------------------------------------------
-------------------X---------SS----<>-Q-----XX--X----------------------------SS--------S-------------<>--------S-SSS----<>--------S--Q-----S
-----------X------XX---------------[]------XXX--XX---------------------------------------------------[]------------------]------------------
-------<>-X-------XXX-----<>-------[]-----XXXX--XXXX------------<--------XX---------X-------<>-------[]---------X-------[]------------------
-------[]XXX----X-XXXX----[]-E-E-E-[]----XXXXX--XXXX------E-----[-------XXXX--------E-E-----[]--E----[]-------E-[-------[]----E---E---------
--XXXXXXXXXX---XXXXXXXXXXXXXXXXXXXXXXXXXXXXXXXXXXXXXXXXXXXXXXXXXXXXXX-XXXXXXXXXXXXXXXXXXXXXXXXXXXXXXXXXXXXXXXXXXXXXXXXXXXXXXXXXXXXXXXXXXXXXX