--------------------------------------------------------------------------------------------------------------------------------------------
--------------------------------------------------------------------------------------------------------------------------------------------
--------------------------------------------------------------------------------------------------------------------------------------------
--------------------------------------------------------------------------------------------------------------------------------------------
----------------------------------------------------------------------------------------E---------------------------------------------------
---------------------------------------------------------------------------------------SSSSS--------SSSSS---------------------SQ-------SS---
--------------------------------------------------------------------------------------------------------------------------------------------
-------------------------------------------------------------------------X------------------------------------------------------------------
-------------------------------------------------------------------------X------------------------------------------------------------------
---------------------SS----------------------<>--SSQ-----------<>-------XX--X--X------------------S-------------S--Q--Q--S?---------S-------
---------------------------------------------[]----------------<>------XXX--XX--------------------------------------------------------------
--<>----<>-------<>-----------------<>-------[]---------X------[]-----XXXX--XXXX-------------------------------<----------------------------
--[]----[]-------[]-----------------[]-------[]---------E-EE---[]----XXXXX-XXXXX-------------------------------[----------------E--------EEE
XXXXXXXXXXXXXXXXXXXXXXXXXXXXXXXXXXXXXXXXXXXXXXXXXXXXXXXXXXXXXXXXXXXXXXXXXXXXXXXXXXXXXXXXXXX---XXXXXXXX--XXXXXXXXXXXXXXXXXXXXXXXXXXXXXXXXXXXX