--------------------------------------------------------------------------------------------------------------------------------------------
--------------------------------------------------------------------------------------------------------------------------------------------
--------------------------------------------------------------------------------------------------------------------------------------------
--------------------------------------------------------------------------------------------------------------------------------------------
--------------------------------------------------------------------------------------------------------------------------------------------
----------------------------------------SSSQ-------SSSQS---------------------------------------------------SSSS-----------------------------
--------------------------------------------------------------------------------------------------------------------------------------------
--------------------------------------------------E-----------------------------------------------------------------------------------------
--------------------------------------------------------------------------------------------------------------------------------------------
-----------------XX---------Q--Q--Q--Q-----S----S?S-S-----<>-------SQS----S--Q--Q--Q--------------QS-----SS-------------<>-------XX-XX------
----------------XXX---------------------------------------[]------------------------------------------------------------[]------XX--XXX-XX--
-------[]-------XXX---------------------------------------[]----------------------------------------------------X-------[]-----XXXX--XXXXXX-
-------[]------XXXXX-----------E------------E-------------[]------------E-E--E----------------------------------E-EE--E-[]----XXXXX-XXXXXX--
XXXXXXXXXXXXXXXXXXXXXXXXXXXXXXXXXXXXXXXXXXXXXXXXXXXXXXXXXXXXXXXXXXXXXXXXXXXXXXXXXXXX------------XXX--XX---XXXXXXXXXXXXXXXXXXXXXXXXXXXXXXXXXX