--------------------------------------------------------------------------------------------------------------------------------------------
--------------------------------------------------------------------------------------------------------------------------------------------
--------------------------------------------------------------------------------------------------------------------------------------------
--------------------------------------------------------------------------------------------------------------------------------------------
--------------------------------------------------------------------------------------------------------------------------------------------
---?S----------------------------------SQS-----Q-----------------Q----------------------------SSSQQ-------------SSS----S--------------------
-------------------------------------------------------------------------X------------------------------------------------------------------
-------------------------------------------------------------------------X------------------------------------------------------------------
-------------------------------------------------------------------------XX-----------------------------------------------------------------
-----------------------------------------------S---X-----SS----<>-------XX-XX----------SS--S?S---------SS----SS-----------------------------
--------------------------------------------------XX-----------[]------XXX--XX--------------------------------------------------------------
--------------------------<>---------------------XX----<-------[]-----XXXX--XX------------------------------------------------------XX----<X
--------------------------[]-------------E-E----EXXX---[[--E-E-[]----XXXXX--XXXX-----------------EEEE------E-E----------------------XXX---[]
XXXX---X-------------XXXXXXXXXXXXXXXXXXXXXXXXXXXXXXXXXXXXXXXXXXXXXXXXXXXXXXXXXXXXXXXXXXXXXXXXXXXXXXXXXXXXXXXXXXX---XXXXX------X-----XXXXXXXX