--------------------------------------------------------------------------------------------------------------------------------------------
--------------------------------------------------------------------------------------------------------------------------------------------
--------------------------------------------------------------------------------------------------------------------------------------------
--------------------------------------------------------------------------------------------------------------------------------------------
--------------------------------------------------------------------------------------------------------------------E-----------------------
-------------Q----------------------------S?-------SSS------------------------------------------------------------SSSS----------------------
--------------------------------------------------------------------------------------------------------------------------------------------
--------------------------------------------------E-----------------------------------------------------------------------------------------
--------------------------------------------------------------------------------------------------------------------------------------------
-SSSS------S------S---------Q--Q--Q--Q--QSQS----S?--Q-------------------------------------------------------------------------------------<>
-------------------------------------------------------------------------------------------------------------------------------------XX---[]
----------------------------------------------------------<>----<>-------<>--------------------------<>------<>---------------------XXX---[]
EEE---------E-E-E-E--E---EE----E--------------------------[]----[]-------[]---------------------E----[]------[]--------------------XXXX---[]
XXXXXXXXXXXXXXXXXXXXXXXXXXXXXXXXXXXXXXXXXXXXXXXXXXXXXXXXXXXXXXXXXXXXXXXXXXXXXXXXXXXXXXXX---XX----XXXXXXXXXXXXXXX-XXX----------------XXXXXXXX