--------------------------------------------------------------------------------------------------------------------------------------------
--------------------------------------------------------------------------------------------------------------------------------------------
--------------------------------------------------------------------------------------------------------------------------------------------
--------------------------------------------------------------------------------------------------------------------------------------------
--------------------------------E-----------------------------------------------------------------------------------------------------------
------------------------------SSSSSS----------------------SSSSSS--------SSS---------------------------------------------------------X-------
---------------------------------------------------------------------------------------------------------------------------------XX---------
---------------------------------------------------------------------------------------------------------------------------------XXXX-------
---------------------------------------------------------------------------------------------------------------------------------XXXX-S-----
---------------------SS-------------------------------<>--------------------------------------------------SQ-----SS----<>--------XXXX-------
------------------------------------------------------[]---------------------X-----------------------------------------[]-------XXXXX-------
--<>----<>--------------------------------------XX----[]--------------------XXX----<----------------------------X------[]------XXXXXXX------
--[]----[]--------------------------------------XXX---[]-----------E---E---XXXXX---[----------------------------E--E---[]-----XXXXXXXXX-----
XXXXXXXXXXXXX---XXXXXXXXXXXX------X-------------XXXXXXXXXXXXXXXXXXXXXXXXX--XXXXXXXXXXXXXXXXXXXXXXXXXXXXXXXXXXXXXXXXXXXXXXXXXXXXXXXXXXXXXXXXX