--------------------------------------------------------------------------------------------------------------------------------------------
--------------------------------------------------------------------------------------------------------------------------------------------
--------------------------------------------------------------------------------------------------------------------------------------------
--------------------------------------------------------------------------------------------------------------------------------------------
--------------------------------------------------------------------------------------------------------------------E-----------------------
--------------------------------------------------------------------------------------------------S---------Q---SSSSSSSS--------SS----------
--------------------------------------------------------------------------------------------------------------------------------------------
--------------------------------------------------------------------------------------------------------------------------------------------
--------------------------------------------------------------------------------------------------------------------------------------------
---------------------------------------------XX------------------------------SSQS-----<>-------SQS----S--QS-Q--Q--------------------------<>
-----------------------------------<>--------XX------<>---[>--------------------------[]--------------------------------------------------[]
----------------------------X------[]-------XXX------[]---[]----<>-------<------------[]--------------------------------------------XX----[]
----------------------------[-EE---[[]------XXX------[]---[]----[]-------[]-----------[]------------E-E--E--------------------------XXX---[]
------------------X----X--XXXXXXXXXXXXXXXXXXXXXXXXXXXXXXXXXXXXXXXXXXXXXXXXXXXXXXXXXXXXXXXXXXXXXXXXXXXXXXXXXXXXXX--------------------XXXXXXXX