--------------------------------------------------------------------------------------------------------------------------------------------
--------------------------------------------------------------------------------------------------------------------------------------------
--------------------------------------------------------------------------------------------------------------------------------------------
--------------------------------------------------------------------------------------------------------------------------------------------
------------------------------------------------------E-------------------------------------------------------------------------------------
--------------------------------------SSSSQ----Q-----SSS-Q-----------Q---------------Q----------------------------------------S?-------SSS--
--------------------------------------------------------------------------------------------------------------------------------------------
-------------------------------------E--------------E---------------------------------------------------------------------------------------
--------------------------------------------------------------------------------------------------------------------------------------------
------------QS------S?SQS-------S--S?S---------SS--?S-S----S-----S?S-S----SS------------------------------------X--Q--Q--Q--QSQS------------
--------------------------------------------------------------------------------------------------------------------------------------------
--------------------------------------------------------------------------------XX----------------------------------------------------------
----------------E------------E-----------EEE-E--E--E------------------E-E-E----E[XX---------------E-E]]----------------------------------E-E
XXXXXXXXXXXXXXXXXXXXXXXXXXXXXXXXXXXXXXXXXXXXXXXXXXXXXXXXXXXXXXXXXXXXXXXXXXXXXXXXXXXXXXXXXXXXXXXXXXXXXXXXXXXXXXXXXXXXXXXXXXXXXXXXXXX--XXXXXXX