--------------------------------------------------------------------------------------------------------------------------------------------
--------------------------------------------------------------------------------------------------------------------------------------------
--------------------------------------------------------------------------------------------------------------------------------------------
--------------------------------------------------------------------------------------------------------------------------------------------
----E---------------------------E-----------------------------------------------------------------------------------------------------------
-SSSSSSS---------Q------------SSSSSS--------SSQS--------------?-----SS--SSSQS---SSSS------S-------SSSSSS---SS-------------------------------
--------------------------------------------------------------------------------------------------------------------------------------------
--------------------------------------------------------------------------------------------------------------------------------------------
--------------------------------------------------------------------------------------------------------------------------------------------
--------------Q-----------<>--------------S-----------<>?--------Q----SS----S---------------------SS--------------------<--------X--X-------
--------------------------[]----------------------X---[X----------------------------------------------------------------[]-----XXX--XX------
--------------------------[]---------------------X----[]--------------------------------------------------------X-------[]----XXXXX-XX---XXX
--------------------------[]--------------------XXX---[]---------------E---------E-E-------------------------EEEE-EE--E-[]----XXXX-XXXX-XXXX
XXXXX-----X-XX---X----XXXXXXXXXXXXXX----XXXXX---XXXXXXXXXXXXXXXXXXXXXXXXXXXXXXXXXXXXXXXXXXXXXXXXXXXXXXXXXXXXXXXXXXXXXXXXXXXXXXXXXXXXXXXXXXXX