--------------------------------------------------------------------------------------------------------------------------------------------
--------------------------------------------------------------------------------------------------------------------------------------------
--------------------------------------------------------------------------------------------------------------------------------------------
--------------------------------------------------------------------------------------------------------------------------------------------
----------------------------------------------------------------------------------------E---------------------------------------------------
-------------------------------------SSQ-------------------SS-------------------------SSSSS---------SSQ-------------------------------------
--------------------------------------------------------------------------------------------------------------------------------------------
--------------------------------------------------------------------------------------------------------------------------------------------
--------------------------------------------------------------------------------------------------------------------------------------S-----
------------------------------S----?S-------------------------------------------------------------------------<>-----------------XX---------
--------------------------------------------------------------------------------------------------------------[]--------<>-------XX---------
-------------------------------------------X-X----------------------------------------------------------------[]X-------[]-------XX------<>-
-----------------------------E------------EEXE-----E-E--------------------------------------------------------[]]-E-----[]------XXX------[]-
-------XX--------XX--XXXX-XXXXXXXXXXXXXXXXXXXXXXXXXXXXXX--XX------------XXX---XXXXXX----------------------XXXXXXXXXXXXXXXXXXXXXXXXXXXXXXXXXX