--------------------------------------------------------------------------------------------------------------------------------------------
--------------------------------------------------------------------------------------------------------------------------------------------
--------------------------------------------------------------------------------------------------------------------------------------------
--------------------------------------------------------------------------------------------------------------------------------------------
--------------------------------------------------------------------------------------------------------------------------------------------
SSSSSSSS-----------------------------S?SQ-------------------------------------------------------------------------SSSSSS------SSSSSS--------
-----------------------------------------------------------------------------------------------------XX-------------------------------------
-----------------------------------------------------------------------------------------------------XXX------------------------------------
-----------------------------------------------------------------------------------------------------XXXX-----------------------------------
-------Q--Q---X-------XX--<>-Q--Q--QS-Q-------------------------------------------XX-------<>-------XXXXX-------X-------------SS------------
--------------XX----XXX---XX----------------XX--XX----------------------------X--XX--------[]------XXX-XXX----------------------------------
--------------XXX---XXX---XX---------------XXX--XXXX---------------------<>------XXXX------[]-----XXXXXXXX--------------------------------<>
----------EE--XXX--XXXX---XX-----E-E------XXXX--XXXXX-----------[--------[]---X-XXXX]-EE---[]----XXXXXXXXXX-------------------------------[]
XXXXXXXXXXXXXXXXX--XXXXXXXXXXXXXXXXXXXXXXXXXXXXXXXXXXXXXXXXXXXXXXXXX--XXXXXXXXXXXXXXXXXXXXXXXXXXXXXXXXXXXXXXXXXXXXXXXX---XXXXXXXXXX--XXXXXXX