--------------------------------------------------------------------------------------------------------------------------------------------
--------------------------------------------------------------------------------------------------------------------------------------------
--------------------------------------------------------------------------------------------------------------------------------------------
--------------------------------------------------------------------------------------------------------------------------------------------
--------------------------------------------------------------------------------------------------------------------------------------------
--------------------------------------SSSSQ----Q----SSSS------------------------------------------------------------------------------------
--------------------------------------------------------------------------------------------------------------------------------------------
-------------------------------------E--------------E---------------------------------------------------------------------------------------
--------------------------------------------------------------------------------------------------------------------------------------------
----------------------------?--Q---S?S---------SS-S?SSS---------<>---------------SS--SSS-------------<>------------------------------SS-----
----------------------------------------------------------->----[]-----------------------------------[]-------------------------------------
--<>---------------X--------------------------------------[]----[]-----XXX------------------->-------[]-------------------------------------
--[]---------------X---------------------E-EE---EE-E------[]----[]----XXXX-----E----E-E---------E-E--[]-------E----------------E------------
XXXXXXXXX------XXXXXXXXXXXXXXXXXXXXXXXXXXXXXXXXXXXXXXXXXXXXXXXXXXXXXXXXXXXXXXXXXXXXXXXXXXXXXXXXXXXXXXXXXXXXXXXXXXXXXXXXXXXXXXXXXXXXXXXXXXXXX