--------------------------------------------------------------------------------------------------------------------------------------------
--------------------------------------------------------------------------------------------------------------------------------------------
--------------------------------------------------------------------------------------------------------------------------------------------
--------------------------------------------------------------------------------------------------------------------------------------------
--E---------------------------------------------------------E-------------------------------------------------------------------------------
SSQ--SSS---S?S--SSSQS-----SS------------------------------SSSSS----------------------------------SSQ-------SSS--SSSSS-----------------------
--------------------------------------------------------------------------------------------------------------------------------------------
--------------------------------------------------------------------------------------------------------------------------------------------
--------------------------------------------------------------------------------------------------------------------------------------------
--------------S?-------X----Q--Q--Q--Q-SQS----S--Q--Q--Q----------------------------Q-<>--Q--S----------S--------------------------X--------
-----------------------X--XX----------------------------------------------------------[]-------------------------------------------XX-------
---------------------X-X---X----------------------------------------------------------[]-------------------------------------------XX-------
---------------E----EXXXX-X[---E------------E-E--E-------------------------------------E------------E--------E-E----------------X-XXXX------
XXXXXXX---XXXXXXXXXXXXXXXXXXXXXXXXXXXXXXXXXXXXXXXXXXXXXXXXXX----X---XX---X----XXXXXXXXXXXXXXXXXXXXXXXXXXXXXXXXXXXXXX--XXX--------XXXXXXXXXXX