--------------------------------------------------------------------------------------------------------------------------------------------
--------------------------------------------------------------------------------------------------------------------------------------------
--------------------------------------------------------------------------------------------------------------------------------------------
--------------------------------------------------------------------------------------------------------------------------------------------
----------------------------------------------------------------------------------------E---------------------------------------------------
--------------------X---------------------------------------------------------------SSSSSSSS------------------------------------------------
-----------------XX-------------------------------------------------------------------------------------------------------------------------
-----------------XXX------------------------------------------------------------------------------------------------------------------------
-----------------XXXX-S---------------------------------------------------------------------------------------------------------------------
-----------------XXXX------------------S-----------------SS----<>--------X---X----XX--------------X----X------<>----------------------------
-------<>-------XXXXX------------------------------------------[]------XXX---XX--XX---------------X----XX-----[]----------------------------
X------[]------XXXXX-----<>------------------<-----------------[]------XXX--XXXX-XXX-------------------XXX----[]----------------------------
[-EE---[]-----XXXXXXX----[]---E---------E-----E--------------E-[]-----XXXX-XXXXXXXXX----------EE-------XXXX---[]----------------------------
XXXXXXXXXXXXXXXXXXXXXXXXXXXXXXXXXXXXXXXXXXXXXXXXXXXXXXXXXXXXXXXXXXXXXXXXXXXXXXXXXXXX---X-XXX-----------XXXXXXXXXXXXXXXXXXXXXXXXXXXXXXXXXXXXX