--------------------------------------------------------------------------------------------------------------------------------------------
--------------------------------------------------------------------------------------------------------------------------------------------
--------------------------------------------------------------------------------------------------------------------------------------------
--------------------------------------------------------------------------------------------------------------------------------------------
--------------------------------------------------------------------------------------------------------------------------------------------
-------------------------------------SSSQQ----SQ-------X------------------------------------------------------------------------------------
------------------------------------------------------XX------------------------------------------------------------------------------------
-----------------------------------------------------XXX------------------------------------------------------------------------------------
----------------------------------------------------XXXX------------------------------------------------------------------------------------
--<>-----S?S--------S?S-Q--Q----Q--SS-Q--------S---XXXXX-SS-----<>-------<>----------SS-----<>-------<>---------X--Q--Q-----QSQS----S-------
--[]----------------------------------------------XXXXXX--------[]-------[]-----------------[]-------[]-------------------------------------
--[]---------------------------------------------XXXXXXX--------[]-------[]------<>---------[]-------[]-------------------------------------
--[]------------E----E-------E-----------EEE-E--XXXXXXXX[-----E-[]-------[]------[]-[E----E-[]-------[]-------------------------------------
XXXXXXXXXXXXXXXXXXXXXXXXXXXXXXXXXXXXXXXXXXXXXXXXXXXXXXXXXXXXXXXXXXXXXXXXXXXXXXXXXXXXXXXXXXXXXXXXXXXXXXXXXXXXXXXXXXXXXXXXXXXXXXXXXXXXXXXXXXXX