--------------------------------------------------------------------------------------------------------------------------------------------
--------------------------------------------------------------------------------------------------------------------------------------------
--------------------------------------------------------------------------------------------------------------------------------------------
--------------------------------------------------------------------------------------------------------------------------------------------
------------------------------------------------------------E-------------------------------------------------------------------------------
------------SSSQ-------SQSQS----------------------------SSSSSSSS--------SS-----------------------SSQS------SS-------------------------------
---------------------------------------------------------------------------------------------------------------------------------XX---------
---------------------------------------------------------------------------------------------------------------------------------XXX--------
---------------------------------------------------------------------------------------------------------------------------------XXXX-------
Q--Q--Q--Q----------S?S-S--Q--------------------------------------------------------------------QS---------------------<>-------XXXXX-------
----------------------------------------------X------------------------------------------------------------------------[>------XXXXXX-------
-----------------------------------<>--------XX------<>---------------------------<>--<>------------------------X------[]-----XXXXXXXX------
---E------------E----E-------------[]-------XXXX-----[]---------------------------[]--[]------------------------E-EE---[]----XXXXXXXXXX-----
XXXXXXXXXXXXXXXXXXXXXXXXXXXXXXXXXXXXXXXX--XXXXXXXXXXXXXX----------------------------XXXXXXXXXXXXXXXXXXXXXXXXXXXXXXXXXXXXXXXXXXXXXXXXXXXXXXXX