--------------------------------------------------------------------------------------------------------------------------------------------
--------------------------------------------------------------------------------------------------------------------------------------------
--------------------------------------------------------------------------------------------------------------------------------------------
--------------------------------------------------------------------------------------------------------------------------------------------
--------------------------------------------------------------------------------------------------------------------------------------------
----------------------------------SS--------SS-------------------S----------------SS---------S?----------------X--SSS-----------------------
--------------------------------------------------------------------------------------------------------------XX----------------------------
------------------------------------------------------------------------------------------------------------XXXX----------------------------
-----------------------------------------------------------------------------------------------------------XXXXX----------------------------
----------------------S-------------------S--------------SS----<>--------X------X----SS-Q--?S-Q------------XXXXX----------------------------
X-----------------XX-------------------------------------------[]-------XX--X----------------------XX----XXXXXXX----------------------------
X-<>---<>-X------XXX---------------------------X------<>--------]-----XXXX---XX-------------------XXX---XXXXXXXX----------------------------
--E]---[]XX-----XXXX------------------EE---E---XX-----[]-E---E-[]-----XXXX--XXXX-----E---E-------XXXXX--XXXXXXXX----------------------------
XXXXXXXXXXXX---XXXXXXXXXXXXXXXXXXXXXXXXXXXXXX--XXXXXXXXXXXXXXXXXXXXXXXXXXXXXXXXXXXXXXXXXXXXXXXXXXXXXXXXXXXXXXXXXXXXX---XX---XX--XX-----X--XX