[
    72640734,
    18795003,
    17438512,
    16486766,
    15611764,
    15578772,
    15583038,
    15482783,
    15529147,
    15621716,
    15486400,
    15380461,
    15389881,
    15105051,
    15891761,
    15390557,
    15680145,
    15347732,
    15396913,
    15353135,
    15425308,
    15873879,
    15521915,
    15494277,
    14931432,
    15057038,
    15453967,
    15325852,
    14798167,
    11784188,
    12271768,
    12495652,
    12180920,
    11902094,
    12340684,
    11717513,
    12503965,
    12284283,
    11070215,
    11201646,
    12487751,
    12254926,
    11652047,
    12261458,
    12248398,
    12628462,
    12565552,
    12711141,
    11880375,
    12118179,
    12487644,
    12127855,
    11970660,
    11481706,
    11871775,
    11964591,
    12577976,
    12021460,
    12283336,
    11933398,
    12667732,
    12445448,
    12381986,
    12032086,
    12362494,
    12038799,
    12397755,
    12401376,
    11652158,
    16685107,
    12790528,
    12303773,
    11907851,
    12124166,
    12158541,
    12180774,
    12095832,
    12395076,
    11664619,
    12268336,
    11950840,
    12170852,
    12008379,
    11311422,
    11984987,
    12495919,
    12123391,
    11754331,
    12301742,
    12050649,
    12265866,
    12069220,
    12200809,
    12005158,
    12362983,
    12021130,
    12427786,
    11863632,
    12497129,
    11969307,
    12114366,
    12088611,
    11308029,
    11358600,
    12147692,
    12262332,
    11666439,
    12556190,
    12262982,
    12677209,
    11874174,
    12340753,
    12061508,
    12499936,
    12853356,
    12632226,
    12040094,
    11539225,
    11612538,
    12189969,
    12211563,
    11832303,
    12274236,
    12092814,
    12328586,
    11964225,
    12237561,
    11919193,
    12395621,
    11699450,
    11988193,
    12869692,
    11492370,
    11391516,
    12923553,
    12228095,
    12017908,
    11991010,
    11894569,
    12167555,
    12342384,
    12833312,
    12527508,
    11781753,
    12435617,
    12068620,
    12260679,
    11896015,
    11840694,
    12006152,
    11670272,
    12303056,
    11709323,
    12370014,
    12940766,
    12433752,
    12101905,
    12573534,
    11986050,
    12429405,
    13115760,
    12270286,
    12150517,
    12154064,
    11443547,
    11913603,
    12167297,
    11817778,
    12443499,
    11840188,
    12098019,
    12632439,
    12080570,
    12287527,
    12166472,
    12492950,
    12830391,
    12364607,
    11318287,
    11333123,
    12025941,
    12791534,
    12128160,
    12348285,
    12008935,
    12242557,
    11967448,
    12796029,
    12815083,
    12688757,
    12429978,
    12090928,
    12353021,
    11623340,
    11492681,
    12626044,
    12583433,
    11892265,
    13026342,
    12258676
]