--------------------------------------------------------------------------------------------------------------------------------------------
--------------------------------------------------------------------------------------------------------------------------------------------
--------------------------------------------------------------------------------------------------------------------------------------------
--------------------------------------------------------------------------------------------------------------------------------------------
--------------------------------------------------------------------------------------------------------------------------------------------
-----------------------------QS---SS------------------------------------------------S---------SSSSQ----Q--------------------SSS--------SQS--
--------------------------------------------------------------------------------------------------------------------------------------------
---------------------------------------------------------------------------------------------E----------------------------------------------
--------------------------------------------------------------------------------------------------------------------------------------------
S--Q-------S?S----S--Q--Q--Q------------------------------------------------------------S--S?S---------SQ----XX-Q--Q--Q--S-----S----S?--SSSQ
-----------------------------------------------------------------------XXXXX--------------------------------XX------------------------------
------------------------------------------------XXXX-XX-X------<>------XXXXX-------------------------------XXX------------------------------
----------------E-E--E----------------EE---E----XXXXXXXXb-EE---[]XX----XXXXX---------------------EEEEE--E-EXXX------------------E----E------
XXXXXXXXXXXXXXXXXXXXXXXXXXXXXXXXXXXXXXXXXXXXXXXXXXXXXXXXXXXXXXXXXXXXXXXXXXXXXXXXXXXXXXXXXXXXXXXXXXXXXXXXXXXXXXXXXXXXXXXXXXXXXXXXXXXXXXXXXXXX