--------------------------------------------------------------------------------------------------------------------------------------------
--------------------------------------------------------------------------------------------------------------------------------------------
--------------------------------------------------------------------------------------------------------------------------------------------
--------------------------------------------------------------------------------------------------------------------------------------------
--------------------------------------------------------------------------------------------------------------------------------------------
----------------------------SSQ---?S--SSSS-----Q------SSSSS--------------------------------------------------------------SSSSSQ----Q--------
--------------------------------------------------------------------------------------------------------------------------------------------
-------------------------------------------------------------------------------------------------------------------------E------------------
-----------------------------------------------------------------------------------------------------X--------------------------------------
--------------QS-----SS------------SS-----S----S-------------------X--X-X--X---------------<>--------XXX------------S--S?S---------SS----SS-
-------------------------------------------------------------------X--XX---XX--------------[]-------XXXX------------------------------------
---------------------------------------------------------------<>-XX--XXX--XXX-------------[]------XXXXX-----<>-----------------------------
-----------------------------------------E-E----E--E-----------[]XEX-XXXX--XXXX--------E-E-[]-----XXXXXXX-----?--E-----------EEEEE--E--E-E--
XXXXXXXXXXXXXXXXXXXXXXXXXXXXXXXXXXXXXXXXXXXXXXXXXXXXXXXX--XXXXXXXXXX--XXXXXXXXXXXXXXXXXXXXXXXXXXXXXXXXXXXXXXXXXXXXXXXXXXXXXXXXXXXXXXXXXXXXXX