--------------------------------------------------------------------------------------------------------------------------------------------
--------------------------------------------------------------------------------------------------------------------------------------------
--------------------------------------------------------------------------------------------------------------------------------------------
--------------------------------------------------------------------------------------------------------------------------------------------
--------------------------------------------------------------------------------------------------------------------------------------------
----------------------------------------------------------------------S---------------------------------------------------------------------
-----------------------------------------------------------------------------------------------------X--------------------------------------
-----------------------------------------------------------------------------------------------------XXX------------------------------------
-----------------------------------------------------------------------------------------------------XXX------------------------------------
------------Q--------SS---------------------------------Q--Q--Q--S---------SS--------SS----<>--------XXXXX------------------QS--------------
-------------------------------------------------------------------------------------------[]-------XXX-XXX--XX-----------------------------
---------------------------------------------<>-------------------------------------X------[]------XXXX-XXX--XXX--------------------------<Q
---------------------------------------------[]------------E------------E--------E-E<>-E-E-[]-----XXXXXXXXXXXXXX--------------------------[]
XXXXXXXXXXXXXXXXXXXXXXXXXXXX-------XX-------XXX--XXXXXXXXXXXXXXXXXXXXXXXXXXXXXXXXXXXXXXXXXXXXXXXXXXXXXXXXXXXXXXXXXXX----XX---X--XX---XXXXXXX