--------------------------------------------------------------------------------------------------------------------------------------------
--------------------------------------------------------------------------------------------------------------------------------------------
--------------------------------------------------------------------------------------------------------------------------------------------
--------------------------------------------------------------------------------------------------------------------------------------------
----E---------------------------------------------------------------------------------------------------------------------------------------
SSSSSSSS--------SSSSS----------------------------------------------------------------------------SSQS------SSSQS-----------------S----------
--------------------------------------------------------------------------------------------------------------------------------------------
----------------------------------------------------------------------------------------------------------E---------------------------------
------------------------------------------------------------------------------S-------------------------------------------------------------
--------------S-------------------------Q--------------------------------XX---------X--Q--Q--Q----?S----S--------------<>-------X--X------<>
----------------------------------------------------------------<>------XXX--------------------------------------------[]------XX---------[]
--------------------X------<>-<>------------------------X-------[]-----XXXX--------------------------------------------[]-----XXX--XX-----[]
-----------E--------XX-----[]-[]--------E-----E-------E-E-EE--E-[]-----XXXX----------------------------------E-E---E---[]-E---XXX--XXXX---[]
---XXXX-------X----X-----XXXXXXXXXXXXXXXXXXXXXXXXXXXXXXXXXXXXXXXXXXXXXXXXXXXXXXXXXXXXXXXXXXXXXXXXXXXXXXXXXXXXXXXXXXXXXXXXXXXXXXXXXXXXXXXXXXX