--------------------------------------------------------------------------------------------------------------------------------------------
--------------------------------------------------------------------------------------------------------------------------------------------
--------------------------------------------------------------------------------------------------------------------------------------------
--------------------------------------------------------------------------------------------------------------------------------------------
--------------------------------------------------------------------------------------------------------------------------------------------
SSSSSSSS--------SSSSS------------------------------SS------------------------------------S?-----SSSQ-------SSSQS-------------QS-------------
--------------------------------------------------------------------------------------------------------------------------------------------
----------------------------------------------------------------------------------------------------------E---------------------------------
------------------------------------------------------------------------------S-------------------------------------------------------------
X-------------SS--------------------------------------------------------------------X--Q--Q--Q----SS----S?SQS---Q--Q--Q--Q-S------S---------
--------------------------------------------------------X----------------<>-----------------------------------------------------------------
---------------------------<>---------------------------X------<>--------XXX----------------------------------------------------------------
---------------------------[]---------------------------E-E----[]X------XXXX----------------------------------------------------E-E------EE-
XXXXXXX--XXXXXXXXXXXXXXXXXXX------------XX---X-----X--XXXXXX-XXXXXXX---XXXXXXXXXXXXXXXXXXXXXXXXXXXXXXXXXXXXXXXXXXXXXXXXXXXXXXXXXXXXXXXXXXXXX