--------------------------------------------------------------------------------------------------------------------------------------------
--------------------------------------------------------------------------------------------------------------------------------------------
--------------------------------------------------------------------------------------------------------------------------------------------
--------------------------------------------------------------------------------------------------------------------------------------------
--------------------------------------------------------------------------------------------------------------------------------------------
----------------------------------------SQ----------------------------S?S-----------------------------------------------------S-------------
--------------------------------------------------------------------------------------------------------------------------------------------
-----------------X----------------------------------E---------------------------------------------------------------------------------------
-----------------X--------------------------------------------------------------------------------------------------------------------------
-S-----<>-Q-----XX-XX----------X-----S----------S?SQSS--X--Q--Q-----QSQS-----------------------S?S----X--Q-----S--<>----------------S?SQS---
-------[]------XXX--XX--------------------------------------------------------------------------------------------[]------------------------
-------[]-----XXXX-XXXX---XX------------------------------------------------------<>-----------------<>-----------[]------------------------
-----E-[]----XXXXX-XXXXX--XX---E----------EEEE---E--------------------------------[]------------E----[]-----------[]------------E-----------
XXXXXXXXXXXXXXXXXXXXXXXXXXXXXXXXXXXXXXXXXXXXXXXXXXXXXXXXXXXXXX--XXXXXXXXXXXXXXXXXXXXXXXXXXXXXXXXXXXXXXXXXXXXXXXXXXXXXXXXXXXXXXXXXXXXXXXXXXXX