--------------------------------------------------------------------------------------------------------------------------------------------
--------------------------------------------------------------------------------------------------------------------------------------------
--------------------------------------------------------------------------------------------------------------------------------------------
--------------------------------------------------------------------------------------------------------------------------------------------
--------------------------------------------------------------------------------------------------------------------------------------------
-------------------------------?S-----------------------------------------------------S?S---------------------------------------------------
--------------------------------------------------------------------------------------------------------------------------------------------
--------------------------------------------------------------------------------------------------------------------------------------------
--------------------------------------------------------------------------------------------------------------------------------------------
--------------X----X--X---<>--------------------------------------------------S----------------------------------SSSS------S?S----S---------
-----------X--XX---XXXX---[]-------------------------------------------X--------------------------------------------------------------------
-------<>-X---XXX--XXXX---X?--------------------------<>---------------XXX-X-------------------------<>-------------------------------------
-------[]XXX--XXXXXXXXX---<>--------------------------[]-------E------XXXXXX-------------------------[]---------------------E-E---E------EE-
--XXXXXXXXXX--XXXXXXXXXXXXXX---------------------------XXXXXXXXXXXXXXXXXXXXXXXXXXXXXXXXXX-XXXXXXXXXXXXXXXXXXXXXXXXXXXXXXXXXXXXXXXXXXXXXXXXXX