--------------------------------------------------------------------------------------------------------------------------------------------
--------------------------------------------------------------------------------------------------------------------------------------------
--------------------------------------------------------------------------------------------------------------------------------------------
--------------------------------------------------------------------------------------------------------------------------------------------
----------------------------------------------------------------------------------------E---------------------------------------------------
SSS---SS---S?S-------------------------------------------------------Q--------------SSSSSSSS----?S--SSSSS-----------------------------------
--------------------------------------------------------------------------------------------------------------------------------------------
--------------------------------------------------------------------------------------------------------------------------------------------
--------------------------------------------------------------------------------------------------------------------------------------------
--------------SS--------------------------S------SSQ------<>-------S-----<>-----------------------S-------------------------------X---------
----------------------------------------------------------[]-----o-------[]-----------------------------------XX--------<>------XXX---------
--------------------------XX----------------------------X-[]----<>-------[]------------------------------X-----<>-------[]-----XXXXX--------
-----------------------XXXXX-----------E----------------E-[]----[]----E--[]-------E---------------------EXX---X[]-EE----[]-----XXXXX--------
XXXXXXXXXXXXXXXXXXXXXXXXXXXX--XXXXXX---XXXXX--XXXXXXXXXXXXXXXXXXXXXXXXXXXXXXXXXXXXXXXXXXXXX---XXXXXXX--XXXXXXXXXXXXXXXXXXXXXXXXXXXXXXXXXXXXX