--------------------------------------------------------------------------------------------------------------------------------------------
--------------------------------------------------------------------------------------------------------------------------------------------
--------------------------------------------------------------------------------------------------------------------------------------------
--------------------------------------------------------------------------------------------------------------------------------------------
----E---------------------------------------------------------------------------------------------------------------------------------------
SSSSSSSS------SSSSSSS--SSSSS------------------------------------------SSSSSSS--SS------?S--------------------------------S?QQ---------------
--------------------------------------------------------------------------------------------------------------------------------------------
--------------------------------------------------------------------------------------------------------------------------------------------
--------------------------------------------------------------------------------------------------------------------------------------------
X-------------SS------------------------QS-------SS----SX-------------QS-----------------------------------------------?S-Q-----X-----XX----
-------------------------------------------------------------------------------------------------------------------------------XXX--XXXX----
-------------------------------B-------------<>------------------------------------X------------------------------------------XXXX--XXXX--XX
------------------------------<>-------------[]----------------------------------E<>-----------------------------E---E-E-----XXXXX-XXXXXX-XX
XXXXXX---XXXXXXXXXX---XXXXXXXXXXXXXXXXXXXXXXXXXXXXXXXXXXXXXXXXX--XXXXXXXXXXXXXXXXXXX--XXXXXXX-----------XXXXXXXXXXXXXXXXXXXXXXXXXXXXXXXXXXXX