--------------------------------------------------------------------------------------------------------------------------------------------
----------------------------------------------------------------------------------------------------------------------S---------------------
--------------------------------------------------------------------------------------------------------------------------------------------
--------------------------------------------------------------------------------------------------------------------------------------------
--------------------------------------------------------------------------------------------------------------------------------------------
SSQ---SS-SSSQS-------------S------------------------------SSSS------------------------------------S?----------------------------------------
--------------------------------------------------------------------------------------------------------------------------------------------
--------------------------------------------------------------------------------------------------------------------------------------------
--------------------------------------------------------------------------------------------------------------------------------------------
-------QS-Q------------XX-----------------X----X---------------------------------------S-------S-S--------------------------QS--------------
---------------------XXX---------------X--XX---XX-------------------------------------------------------------------------------------------
--------------XXX---XXXX---<>------<>-XX---XX--XXX----<>-------------------XXX----<>--------------------------------------------------------
-------------EXX----XXXX---[]------[]XXX---XX-XXXXX---[]-------------------XXXX---[]----------------E--------EEE----------------------------
XXXXXXXXXXXXXXXXXXXXXXXXXXXX--XXXXXXXXXX--XXXXXXXXXXXXXXXXXXXXXXXXXX--XXX--XXXXXXXXXXXXXXXXXXXXXXXXXXXXXXXXXXXXX--X----XX----XXXXXX--XXXXXXX