--------------------------------------------------------------------------------------------------------------------------------------------
--------------------------------------------------------------------------------------------------------------------------------------------
--------------------------------------------------------------------------------------------------------------------------------------------
--------------------------------------------------------------------------------------------------------------------------------------------
--------------------------------------------------------------------------------------E-----------------------------------------------------
---------?----------------------SSSS------SSSSSSS---SSS-----------------------------SSQ--SSS-SSSQS--SSSQS-----XX-----------------------SS---
--------------------------------------------------------------------------------------------------------------XX----------------------------
------------------------------------------------------------------------------------------------------------XXXX----------------------------
------------------------------------------------------------------------------------------------------------XXXX----------------------------
--------<>-------X--X---------------------SS------------Q---------------------S------------QS-Q-----------XX-XXXX-----------QSQS------------
--------[]------XX--XX--X---------------------------------------------------------------------------------XXXXXX----------------------------
X-------[]-----XXX--XXXX-------------------------------<>------------------------------------------------XXXXXXX----------------------------
E--E--E-[]----XXXX--XXXXX------------------------------[]--E-------------------------------------E-E----XXXXXXXX----------------------------
XXXXXXXXXXXXXXXXXXXXXXXXXXXXXXXXXXXXXXXXXXXXXXXXXXXXXXXXXXXXXXXXXXXXXXXXXXXXXXXXXXXXXXXXXXXXXXXXXXXXXXXXXXXXXXXXXXXXXX-XXXXXXXXXXXX--XXXXXXX