--------------------------------------------------------------------------------------------------------------------------------------------
--------------------------------------------------------------------------------------------------------------------------------------------
--------------------------------------------------------------------------------------------------------------------------------------------
--------------------------------------------------------------------------------------------------------------------------------------------
--------------------------------------------------------------------------------------------------------------------------------------------
----SSSS---SQS--SSSSS----SSS-------------------------------------Q-----------------X----------------------------S--------SSSQS-----Q------XX
----------------------------------------------------------------------------------XX-----------------------------------------------------XXX
---------------------------------------------------------------------------------XXX----------------------------------------------------XXXX
---------------------------------------------------------------------------------XXX--------------------------------S------------------XXXX-
--------------S---------------S-----<>-------<>----------SS----<>-------XX--XXXX-XXX-------<>-Q-----X--X---------Q--Q--SS-Q------------XXXX-
------------------------------------[]-------[]----------------[]------XXX---XXX-XXX---------------X---XX-----------------------------XXXX--
------------------------------------[]-------[]-----------------B-----XXXX--XXXXXXXX-------<>-----XXX--XXX---------------------------XXXXX--
-----------E---E----E-------<>----E-[]-------[]---------<>---E-<>----XXXXX-XXXXXXXXX-----E-[]-E---XXX--XXXX------E-----------E-E-E--XXXXXX-X
XXXXXXXXXXXXXXXXXXXXXXXXXXXXXXXXXXXXXXXXXXXXXXXXXXXXXXXXXXXXXXXXXXXXXXXXXXXXXXXXXXXXXXXXXXXXXXXXXXXXXXXXXXXXXXXXXXXXXXXXXXXXXXXXXXXXXXXXXXXX