--------------------------------------------------------------------------------------------------------------------------------------------
--------------------------------------------------------------------------------------------------------------------------------------------
--------------------------------------------------------------------------------------------------------------------------------------------
--------------------------------------------------------------------------------------------------------------------------------------------
--------------------------------------------------------------------------------------------------------------------------------------------
-----------------------------------------Q--------------------?-----SSSSSSSSS--SSSSS-------------------------------------?--S---------------
--------------------------------------------------------------------------------------------------------------------------------------------
---------------------------------------------------------------------------------------------------------------X----------------------------
--------------------------------------------------------------------------------------------------------------------------------------------
-----------SQS----Q--SSQQ--Q--<>-------S------S--Q-----QX-------------SS----S--------SS----<>-------XX--XXXX-XXX--S-----<>-------X-S--------
------------------------------[]-----------------------------------------------------------[]------XXX--XXXX-XXX--------[]------XX----------
------------------------------[]-----------------------------------------------------------[]-----XXXX--XXXX-XXX--------[]-----XXX----------
------------------E-----------[]--------E-E-E-E--E---------------------------------------E-[]-----XXXX-XXXXXXXXXE-EE--E-[]----XXXX-----E----
XXXXXXXXXXXXXXXXXXXXXXXXXXXXXXXXXXXXXXXXXXXXXXXXXXXXXXXXXXXXXXX--XXXXXXXXXXXXXXXXXXXXXXXXXXXXXXXXXXXXXXXXXXXXXXXXXXXXXXXXXXXXXXXXXXXXXXXXXXX