--------------------------------------------------------------------------------------------------------------------------------------------
--------------------------------------------------------------------------------------------------------------------------------------------
--------------------------------------------------------------------------------------------------------------------------------------------
--------------------------------------------------------------------------------------------------------------------------------------------
--------------------------------------------------------------------------------------------------------------------------------------------
SSSSSSSS-----S------------------------SSSSSS-----------------------------------------SS--SSS---SSSSSSSSQ-----SSS----------------------------
--------------------------------------------------------------------------------------------------------------------------------------------
--------------------------------------------------------------------------------------------------------------------------------------------
------------------------------------------------------------------------------S-------------------------------------------------------------
X-------------SS---------------Q-----------------------------------------XX--S------X-------------SS----------------------------------------
----------------------------------------------------------------<>-------XX-------------------------------------------------------XX--------
---------------------------<>---------------------------X-------[]------XXX--------------------------------------------<>-X------XXXX-----<>
---------------------------[]--E--------------------------<>----[]------XXX--------------------------------------------[]-XX----XXXXXX----[]
XXXXXX----XXXXX--XXX--XXXXXXXXXXXXXXXXXXXXXXXXXXXXXXXXXXXXXXXXXXXXXXXXXXXXXXXXXXXXXXXXXXXXXXXXXXXXXXXXXXXXXXXXXX---X-XXXX-----XXXXXXXXXXXXXX