--------------------------------------------------------------------------------------------------------------------------------------------
--------------------------------------------------------------------------------------------------------------------------------------------
--------------------------------------------------------------------------------------------------------------------------------------------
--------------------------------------------------------------------------------------------------------------------------------------------
--------------------------------------------------------------------------------------------------------------------E-----------------------
--SSSSSS--------SSQ-------------------------------------------------------------------------------SSSSSSS---SSS---SSSSSS--------SSQSS-------
--------------------------------------------------------------------------------------------------------------------------------------------
--------------------------------------------------------------------------------------------------------------------------------------------
--------------------------------------------------------------------------------------------------------------------------------------------
--------------------------<>-SS-----<>-------<>-------X---SS--------------S---------------------------------------------------S-------------
--------------------------[]--------[]-------XE------XX-------------------------------------------------------------------------------------
--------------------------[]X-------[]-------XX-----XXX----------E-------<>-----------<>--------------------------------------------------<E
------------------------E-[]EEE---E-[]-----XXXX----XXXX-E-E-----<>--E-E--[]----E------[]-----------------------E--------------------------[]
XXXXXXXXXXXXXXXXXX--XXXXXXXXXXXXXXXXXXXXXXXXXXXXXXXXXXXXXXXXXXXXXXXXXXXXXXXXXXXXXXXXXXXXXXXXXXXXXXXXXXXXXXXXXXXXXXXXXXX----XXXXX------XX--XX