--------------------------------------------------------------------------------------------------------------------------------------------
--------------------------------------------------------------------------------------------------------------------------------------------
--------------------------------------------------------------------------------------------------------------------------------------------
--------------------------------------------------------------------------------------------------------------------------------------------
--------------------------------------------------------------------------------------------------------------------------------------------
SSQ--SSS--SSSSS---SQ-----SSS----------SSQS-----------SSS--------------------------------------------------------------------SQ--------------
--------------------------------------------------------------------------------------------------------------------------------------------
----------------------------------------------------E---------------------------------------------------------------------------------------
--------------------------------------------------------------------------------------------------------------------------------------------
--------------SS----S---------------<>---------S---XX--------------------------------------------SQS-------------S-SS--SSS--------SSS----SS-
------------------------------------[]-----X----X--X----------------------------------------------------------------------------------------
------------------------------------[]----XXX---XX-----<>-<>---------------X------<>--------------------------------------------------------
--------------------E--E---E--EE----[]---XXXXX--XXXX---[]-[]---------------X------[]------------------------------------------E-E------E-E--
XXXXXXXXXXXXXXXXXXXXXXXXXXXXXXXXXXXXXXXXXXXXXXXXXXXXXXXX--XXXXXX-----------XXXXXXXXXXXXX---XXXXXXXXXXXX--XXXXXXXXXXXXXXXXXXXXXXXXXXXXXXXXXXX