--------------------------------------------------------------------------------------------------------------------------------------------
--------------------------------------------------------------------------------------------------------------------------------------------
--------------------------------------------------------------------------------------------------------------------------------------------
--------------------------------------------------------------------------------------------------------------------------------------------
--------------------------------------------------------------------------------------------------------------------------------------------
-------------------------------------?------------------SS---SSS----?S----SQS----SSS--------------------------------------------------------
-----------------------------------------------------------------------------------------------------XX-------------------------------------
-----------------------------------------------------------------------------------------------------XXX------------------------------------
-----------------------------------------------------------------------------------------------------XXXX-----------------------------------
-----------S?S-------Q-----S-SS-----<>-------XX--X--------------------SS-------------------<>-------XXXXX-------X--Q--Q--Q----?S----S?S-S---
------------------------------------[]------XXX--X-----------------------------------------[]------XXX-XX-----------------------------------
----------------------------X-------[]-----XXXX----XXX------------------------------X------[]-----XXXXXXXX----------------------------------
--E---------E-----E---------<>----E-[]----XXXXX---XXXX-----------------------------Eo-EE---[]----XXXXXXXXXX---------------------------------
XXXXXXXXXXXXXXXXXXXXXXXXXXXXXXXXXXXXXXXXXXXXXXXXXXXXXXX-XXXXXXX--XXXXXXXXXXXXXXXXXXXXXXXXXXXXXXXXXXXXXXXXXXXXXXXXXXXXXXXXXXXXXXXXXXXXXXXXXXX