--------------------------------------------------------------------------------------------------------------------------------------------
--------------------------------------------------------------------------------------------------------------------------------------------
--------------------------------------------------------------------------------------------------------------------------------------------
--------------------------------------------------------------------------------------------------------------------------------------------
----------------------------------------------------------------------------------------E---------------------------------------------------
--------------------------------?-----------------------------------------------SSSS--SSSSSS-----------------------?------------------------
--------------------------------------------------------------------------------------------------------------------------------------------
--------------------------------------------------------------------------------------------------------------------------------------------
--------------------------------------------------------------------------------------------------------------------------------------------
----------------------------X-------------Q----------------------------------SS-------------------X----X------------------------------------
-----------------------------------------------------------------------------------------------X--XX---XX--------------------------X--------
--<>----<>-------<>---------------------------------------<>----------------------------------XX--XX---XXX-----<>------<>----------XX-----<>
--[]----[]-------[]---------------------------------------[]----------------------------------EX---XX--XXXX----[]------[]----------XXX----[]
XXXXXXXXXXXX---XXXXXXXXXXXXX---X---------X---X-----X---XXXXXXXXXXXXXXXXXXXXXXXXXXXXX---XXXXXX-----XX---XXXXXXXXX------XX------------X------X