--------------------------------------------------------------------------------------------------------------------------------------------
--------------------------------------------------------------------------------------------------------------------------------------------
--------------------------------------------------------------------------------------------------------------------------------------------
--------------------------------------------------------------------------------------------------------------------------------------------
--------------------------------------------------------------------------------------------------------------------------------------------
-QS-------------------------------------SQS-------------------------------------------------------SQ-------SSSQS----------------------------
--------------------------------------------------------------------------------------------------------------------------------------------
---------------------------------------E-----------------------------------X------------------------------E---------------------------------
-------------------------------------------------------------------------XX---S-------------------------------------------------------------
-------------------------------SS----S?S------S--Q--QS-Q-----------------XX---------Q--Q--Q--Q----?S----S?S-S----SS--------------XX--X------
---------------------------------------------------------------<>-------XXXX--------------------------------------------<>-------XX------<>-
-----------------<>-------------------------------------X------[]------XXXXX-----<>-------------------------------------[]------XXX-----XXX-
------------E----[]-----------------------E-E----E------?-EE---[]------XXXXXXX---[]-----------------------------<>------[]-----XXXX----XXXX-
XXXX--XXXXXXXXXXXXXXXXXXXXXXXXXXXXXXXXXXXXXXXXXXXXXXXXXXXXXXXXXXXXXXXXXXXXXXXXXXXXXXXXXXXXXXXXXXXXXXXXXXXXXXXXXXXXXXXXXXXXXXXXXXXXXXXXXXXXXX