--------------------------------------------------------------------------------------------------------------------------------------------
--------------------------------------------------------------------------------------------------------------------------------------------
--------------------------------------------------------------------------------------------------------------------------------------------
--------------------------------------------------------------------------------------------------------------------------------------------
--------------------------------------------------------------------------------------------------------------------------------------------
---------Q---------------------------?----------------------------------------------------------SQ--------------------------------------?---
--------------------------------------------------------------------------------------------------------------------------------------------
-----------------------------------------------------------------------------------------------E--------------------------------------------
-----------------X--------------------------------------------------------------------------------------------------------------------------
-SS----<>-------XXX-X--------SS----<>-------XX--X--X---------------------------------SSSS----S?S------S--Q-----QX--Q--Q--Q--QSQS----S-------
-------[]------XXX--XX-------------[]------XXX--XX-X---X------------------------------------------------------------------------------------
-------[]-----XXXXX-XXX-----X------[]-----XXXX--XXXX--XX------------------------------------------------------------------------------------
<>---E-[]----XXXXXXXXXXX----EE-E-E-[]----XXXXX-XXXXX--XX------------------------------------------E-E-E--E----E--------------------------E-E
XXXXXXXXXXXXXXXXXXXXXXXXXXXXXXXXXXXXXXXXXXXXXXXXXXXXXXXX-----------------X-----X--XXXXXXXXXXXXXXXXXXXXXXXXXXXXXXXXXXXXXXXXXXXXXXXXXXXXXXXXXX