--------------------------------------------------------------------------------------------------------------------------------------------
--------------------------------------------------------------------------------------------------------------------------------------------
--------------------------------------------------------------------------------------------------------------------------------------------
--------------------------------------------------------------------------------------------------------------------------------------------
--------------------------------------------------------------------------------------------------------------------------------------------
SSQ---------SS--------------SS----?S--SSQS--SSSSS----SSS------------S?S---------Q-------------------------------------------------------SSSS
--------------------------------------------------------------------------------------------------------------------------------------------
-------------------------------------------------------------------E------------------------------------------------------------------------
--------------------------------S-----------------------------------------------------------------------------------------------------------
---------S----------S----SS--------QS-Q---S----S--------Q-<>--Q--S?S------S?S---QSSQ----------------------------X-------------SS----S-------
----------------------------------------------------------[]--------------------------------------------------------------------------------
-------------------------------------------------------<>-[]-----------------------------------------<>------o<>----------------------------
--------------E-E------E---------------E-E-E----E-EX---[]-[]----------E-E----E---E-E-----------------[]------S[]----------------------------
XXXXXXXXXXXXXXXXXXXXXXXXXXXXXXXXXXXXXXXXXXXXXXXXXXXXXXXXXXXXXXXXXXXXXXXXXXXXXXXXXXXXXXXX---XXX-----XXXXXXXXXXXXXXXXXXXXXXXXXXXXXXXXXXXXXXXXX