--------------------------------------------------------------------------------------------------------------------------------------------
--------------------------------------------------------------------------------------------------------------------------------------------
--------------------------------------------------------------------------------------------------------------------------------------------
--------------------------------------------------------------------------------------------------------------------------------------------
--------------------------------------------------------------------------------------------------------------------------------------------
-------------------------------------SSSSQ-----Q--------------------------------------------------------------------SSSS--------SSQ---------
--------------------------------------------------------------------------------------------------------------------------------------------
--------------------------------------------------------------------------------------------------------------------------------------------
--------------------------------------------------------------------------------------------------------------------------------------------
------------QS-------SSQ---S-SS-S--SSS---------S-----X---SS----<>--------XX---------------------------------------------------S-------------
----------------------------------------------------XX---------[]-------XXX-----------------------------------------------------------------
---------------------------------------------------XXX---------[]------XXXX------XX----------------------------?----------------------------
-----------------------------E-----------EEEEE--E-XXXX--<>-E-E-[]-----XXXXX-----X<>----------------------------Q----------------------------
XXXXX--XXXXXXXXXXXXXXXXXXXXXXXXXXXXXXXXXXXXXXXXXXXXXXXX-XXXXXXXXXXXXXXXXXXXXXXXXXXXX-XXX---------X---X-----XXXXXXXXXXXXXX---XXXXXX---XXXXXXX