--------------------------------------------------------------------------------------------------------------------------------------------
--------------------------------------------------------------------------------------------------------------------------------------------
--------------------------------------------------------------------------------------------------------------------------------------------
--------------------------------------------------------------------------------------------------------------------------------------------
------------------------------------------------------------E-------------------------------------------------------------------------------
-------------------------------------------------------S---SSSS---------------------------------SSSQ-------SQSQS----------------------------
--------------------------------------------------------------------------------------------------------------------------------------------
-----------------------------------------------------------------------------------------------E--------------------------------------------
--------------------------------------------------------------------------------------------------------------------------------------------
------------QS----Q--Q-----S-------<>-------X--X---X-----------------------------------------S?S--------S?SQS--Q-SS-----<>-------<>---------
-----------------------------------[]------XX--XX-------------------------------------<>--------------------------------[]-------[]------<>-
-----------------------------------[]-----XXX--XXX------------------------------------[]--------------------------------[]-------[]-----X[]-
------------E-----E------------E-E-[]-E--XXXX--XXXXX----------------------------------[]------------E------------E----E-[]-------[]-----X[]-
XXXXX--XXXXXXXXXXXXXXXXXXXXXXXXXXXXXXXXXXXXXXXXXXXXXXXXX-----------------------X--XXXXXXXXXXXXXXXXXXXXXXXXXXXXXXXXXXXXXXXXXXXXXXXXXXXXXXXXXX