--------------------------------------------------------------------------------------------------------------------------------------------
--------------------------------------------------------------------------------------------------------------------------------------------
--------------------------------------------------------------------------------------------------------------------------------------------
--------------------------------------------------------------------------------------------------------------------------------------------
--------------------------------------------------------------------------------------------------------------------------------------------
----------------------------------------SSSQ-------SQSQS------------------------------------------------------------------------------------
--------------------------------------------------------------------------------------------------------------------------------------------
--------------------------------------------------------------------------------------------------------------------------------------------
--------------------------------------------------------------------------------------------------------------------------------------------
--<>--------?S----S---------Q--Q--Q--S----------S?--SSS----B-------------<>--------S--------------X----X---------SS-S---S--------<>---------
-----------------<>----------------------------------------E-------------[]--------------------X--XX--XX-------------------------[]------<>-
----------------------------------------------------------<>----<>-------[]---------X------<>-X----XXXXXX------------------------[]-----X[]-
--<>--------E-E--<>-------E----E------------E----E------E-[]----[]--E----[]-------E---EE---[]XXX----XXXXXX-------E----------E-E--[]-----XXo-
XXXXXXXXXXXXXXXXXXXXXXXXXXXXXXXXXXXXXXXXXXXXXXXXXXXXXXXXXXXXXXXXXXXXXXXXXXXXXXXXXXXXXXXXXXXXXXXX--XXXXXXXXXXXXXXXXXXXXXXXXXXXXXXXXXXXXXXXXXX