--------------------------------------------------------------------------------------------------------------------------------------------
--------------------------------------------------------------------------------------------------------------------------------------------
--------------------------------------------------------------------------------------------------------------------------------------------
--------------------------------------------------------------------------------------------------------------------------------------------
--------------------------------------------------------------------------------------------------------------------------------------------
-----------------------------------------Q------------------------SSSQ------------------------------------------------------SQ--------------
--------------------------------------------------------------------------------------------------------------------------------------------
--------------------------------------------------------------------------------------------------------------------------------------------
-----------------------------------------------------------------------------------------------------------------------------------------XXX
Q--S-------S?S----Q--Q--Q--S--SS----<>-------------------S--S--SSS---------S-----SS--SS----<>---------X-------------S---SS---------S----XXX-
------------------------------------[]------------------------------------------X----------[]-------XXX-------<>----------------------XXXX--
------------------------------------[]-----XXX---------------------------------XX----------[]-------XXXX-----X[]----------------------XXXX--
------------E-----E--E------E-EE--E-[]----XXXE-----X-----E------------E-E---E-XXX----------[]-E----XXXXX-X--XX[]-E------------EEEE--E-XXXX--
XXXXXXXXXXXXXXXXXXXXXXXXXXXXXXXXXXXXXXXXXXXXXXXXXXXXXXXXXXXXXXXXXXXXXXXXXXXXXXXXXXXXXXXXXXXXXXXXX-XXXXXXXXXXXXXXXXXXXXXXXXXXXXXXXXXXXXXXXXX-