--------------------------------------------------------------------------------------------------------------------------------------------
----------------------------------------------------------------------------------------------------------Q---------------------------------
--------------------------------------------------------------------------------------------------------------------------------------------
--------------------------------------------------------------------------------------------------------------------------------------------
--------------------------------------------------------------------------------------------------------------------------------------------
--------------SSSQS----SSS----SSS------------------------------------------------------------S?QQ-------------XX------------SQ--------------
-------------------------------------------------------------------------------------------------------------XXX----------------------------
------------------------------------------------------------------------------------------------------------XXX-----------------------------
-----------------------------------------------------------------------------------------------------------XXXX-----------------------------
X-------------QS---------------------------------------------------------------------?S-S--?SE-------X--X--XXX----<>-----S---------------SS-
--------------------------------------------------------------------------------------------X------XXX--XXXXXX----[]------------------------
--------------------------------------------------------X-------<>-------<>-----------------------XXXX--XXXXXX----[]------------------------
--------------------------------------------------------E-E-----[]-------[]---------EE---EE------XXXXX--XXXXXX----[]----------E-E------E----
XXXXXX---XXXXXXXXXX--XXXXXXX---------------------------XXXXXXXXXXXXXXXXXXXXXXXXXXXXXXXXXXXXXXXXXXXXXXXXXXXXXXXX-XXXXXXXXXXXXXXXXXXXXXXXXXXXX