--------------------------------------------------------------------------------------------------------------------------------------------
--------------------------------------------------------------------------------------------------------------------------------------------
--------------------------------------------------------------------------------------------------------------------------------------------
--------------------------------------------------------------------------------------------------------------------------------------------
--------------------------------------------------------------------------------------------------------------------------------------------
----------------------------SSQ------SSSSSQ----Q------XX----SSS-------------------S-------------SQS-----------------------------------------
-----------------------------------------------------XXX------------------------------------------------------------------------------------
----------------------------------------------------XXXX---------------------------------------E--------------------------------------------
---------------------------------------------------XXXXX------------------------------------------------------------------------------------
------------QS-------SS---------S--SSS-------------XXXXX------------------------------SSS----S?S------S?-----SSQ-----------------<>--SSQ---S
--------------------------------------------------XXXXXX----------------------------------------------------------------<>-------[]---------
---o---------------------------------------------XXXXXXX----------------------------------------------------------------[]-------[]---------
-----------------------------E-----------EEE-E--XXXXXXXX-----------------------------E------------E-E-E--E--------<>----[]-------[]---------
XXXXXX-XXXXXXXXXXXXXXXXXXXXXXXXXXXXXXXXXXXXXXXXXXXXXXXXX---XXX------X----------X--XXXXXXXXXXXXXXXXXXXXXXXXXXXXXXXXXXXXXXXXXXXXXXXXXXXXXXXXXX