--------------------------------------------------------------------------------------------------------------------------------------------
--------------------------------------------------------------------------------------------------------------------------------------------
--------------------------------------------------------------------------------------------------------------------------------------------
--------------------------------------------------------------------------------------------------------------------------------------------
--------------------------------------------------------------------------------------------------------------------------------------------
---------------------------------------------------------------------Q------------------------S-SQS-----------------------------------------
--------------------------------------------------------------------------------------------------------------------------------------------
--------------------------------------------------------------------------------------------------------------------------------------------
--------------------------------------------------------------------------------------------------------------------------------------------
-SS-S---SS--------SS-----X-------------------<>-----------<>-----S-S?S----S--Q--Q--Q---SS----S--------SS-----S---SQ--------------<>---------
-------------------------X-------------------[]-----------[]------------------------------------------------------------<>-------[]---------
-----------------------XXX-----------Q-------[]-----------[]-----------------------------------------------XX---X-------[]-------[]---------
-E-------E----E-E------XXX--------------E----[]-------E---[]----------E-E-E--E-------E----------E-E-E-E----EXE--E-EE----[]-------[]-------E-
XXXXXXXXXXXXXXXXXXXXXXXXXXXXXXXXXXXXXXXXXXXXXXXXXXXXXXXXXXXXXXXXXXXXXXXXXXXXXXXXXXXXXXXXXXXXXXXXXXXXXXXXXXXXXXXXXXXXXXXXXXXXXXXXXXXXXXXXXXXX