--------------------------------------------------------------------------------------------------------------------------------------------
--------------------------------------------------------------------------------------------------------------------------------------------
--------------------------------------------------------------------------------------------------------------------------------------------
--------------------------------------------------------------------------------------------------------------------------------------------
--------------------------------------------------------------------------------------------------------------------------------------------
----------SSSQQ-------------------------------------------------------------------------------------------------------------------------QSQS
---------------------------------------------XX---------------------------------------------------------------------------------------------
-----------E---------------------------------XXX--------------------------------------------------------------------------------------------
---------------------------------------------XXXX-------------------------------------------------------------------------------------------
---SS----S-S------SSS----SS--SS----<>-------XXXXX---------------------S-------------------------?--------SS----SQ--Q--Q--Q----SS----S?SQS---
-----------------------------------[]------XXXXXX-----------------------------------X----------------<>-------------------------------------
----------------------------X------[]------XXXXXXX---------------------------X------X-<>-------------[]-------------------------------------
-E------------E-E----E-E----<>-E-E-[]----XXXXXXXXX-----------------E---E----EXX-------E---------E----[]------------E------------------------
XXXXXXXXXXXXXXXXXXXXXXXXXXXXXXXXXXXXXXXXXXXXXXXXXXXXXXXXXXXXXXXXXXXXXXXXXXXXXXXXXXXXXXXX---XXXXXXXXXXXXXXXXXXXXXXXXXXXXXXXXXXXXXXXXXXXXXXXXX