--------------------------------------------------------------------------------------------------------------------------------------------
--------------------------------------------------------------------------------------------------------------------------------------------
--------------------------------------------------------------------------------------------------------------------------------------------
--------------------------------------------------------------------------------------------------------------------------------------------
----E---------------------------------------------------------------------------------------------------------------------------------------
SSSSSSSS--------SSQSS----------------SSSQS-----Q------XXSSS-SSSS--------SSSSS---------------------------------------------------------------
-----------------------------------------------------XXX------------------------------------------------------------------------------------
----------------------------------------------------XXXX------------------------------------------------------------------------------------
---------------------------------------------------XXXX-------------------------------------------------------------------------------------
--------------S?-------------------QS-Q------------XXX-X--------------SS----------<>------------QSQS----------------------------------------
-------------------------------------------------XXXXX-X--------------------------[]--------------------------------------------------------
---------------------------<>--------------XX---XXXXXX-X--------------------------[]--------------------------------------------------------
---------------------------[]----E-E-----EXX-E--XXXXXX-X------------------------E-[]--------------------------E-----------------------------
---XXXX----XXXX------------XXXXXXXXXXXXXXXXXXXXXXXXXXXXXXXXXXXX--XXXXXXXXXXXXXXXXXXXXXXX---XXXXXXXXXXXXXXXXXXXXX-XXX----XX-------XX---XXXXXX