--------------------------------------------------------------------------------------------------------------------------------------------
--------------------------------------------------------------------------------------------------------------------------------------------
--------------------------------------------------------------------------------------------------------------------------------------------
--------------------------------------------------------------------------------------------------------------------------------------------
--------------------------------------------------------------------------------------------------------------------------------------------
SS----?S----------SSS---SSS----------SSSSQQ-----------?S--------------S?-------SS------------SSSQS---------------SSSSS----------------------
--------------------------------------------------------------------------------------------------------------------------------------------
----------------------------------------------------E----------------E----------------------------------------------------------------------
-----------------------------------------------------------------------------------------------------------X--------------------------------
-------Q------S?---------------SS---S----------SQ--?S---Q--Q--Q----SQS----S--Q-------------QS-Q------------XX-------------------------------
------------------------------------<>--------------------------------------------------------------------XXX-------------------------------
---------------------------------------------------------------------------------------------------X----XXXXX--<>---------------------------
-----------E---E-----------EE-<>--E------EEE-E--E--E--------------------E-E------EEE-------------EXX----XXXXX--[]---------------------------
XXXXXXXXXXXXXXXXXXXXXXXXXXXXXXXXXXXXXXXXXXXXXXXXXXXXXXXXXXXXXXXXXXXXXXXXXXXXXXXXXXXXXXXXXXXXXXXXXXXXXXXXXXXXXXXXXXXX---XXXXXXXXXXXX--XXXXXXX