--------------------------------------------------------------------------------------------------------------------------------------------
--------------------------------------------------------------------------------------------------------------------------------------------
--------------------------------------------------------------------------------------------------------------------------------------------
--------------------------------------------------------------------------------------------------------------------------------------------
--------------------------------------------------------------------------------------------------------------------------------------------
----------------------------S--------SSSQQ-----Q------XX------------------------------------------------------------SSSS-SSSQS--SSS---------
-----------------------------------------------------XXX------------------------------------------------------------------------------------
----------------------------------------------------XXXX------------------------------------------------------------------------------------
---------------------------------------------------XXXXX------------------------------------------------------------------------------------
---------------S----------------Q--SS----------S---XXXXX-----------------<>-----------------------------------------------------------XX--XX
--------------------------------------------------XXXXXX-----------------[]----------------------------X-----------------------------XXX--XX
-------------------------------------------------XXXXXXXX-------<>-------[]-----------<>---<>-X----X--XXX---------------------------XXXX--XX
-------------------------EE--E-----------EEE-E--XXXXXX-Xo-E-----[]--E----[]-------E---[]---[]XX-----X-XXX----------------------E---XXXXXXXXX
XXXXXXXXXXXXXXXXXXXXXXXXXXXXXXXXXXXXXXXXXXXXXXXXXXXXXXXXXXXX-XXXXXXXXXXXXXXXXXXXXXXXXXXXXXXXXXXX--XXXXXXXXXXXXXXXXXXXXXXXXXXXXXXXXXXXXXXXXXX