--------------------------------------------------------------------------------------------------------------------------------------------
--------------------------------------------------------------------------------------------------------------------------------------------
--------------------------------------------------------------------------------------------------------------------------------------------
--------------------------------------------------------------------------------------------------------------------------------------------
--------------------------------------------------------------------------------------------------------------------------------------------
--------------------------------------------------------SS--------SSQ------Q-------X----------------SS--------------------------------------
--------------------------------------------------------------------------------------------------------------------------------------------
--------------------------------------------------------------------------------------------------------------------------------------------
------------------------------------------------------------S-------------------X-----------------------------------------------------------
---------------------------------------------------------Q--Q--SS-Q--------S---XXX--X--------------------------------------------X---X--XX--
-------------------------------Q----------------------------------------------XXXX---------------------------------------------------XX-XX--
-----------------<>-----------<>-------------<>-------------------------------XXXX--------------------------------------<>-----XXX---XXXXX--
------------E----[]-------E---[]--------E----[]----------------------E-E-E--E-XXXX--------------------------------------[]----XXXX----XXXX--
--X----XX------XXXX-XXXXXXXXXXXXXXXXXXXXXXXXXXXXXXXXXXXXXXXXXXXXXXXXXXXXXXXXXXXXXXXXXXXXXXXXX---XXXXXXX---XXXXXXXXXXXXXXXXXXXXXXXXXXXXXXXXXX