--------------------------------------------------------------------------------------------------------------------------------------------
--------------------------------------------------------------------------------------------------------------------------------------------
--------------------------------------------------------------------------------------------------------------------------------------------
--------------------------------------------------------------------------------------------------------------------------------------------
--------------------------------------------------------------------------------------------------------------------------------------------
----------------------------------------SSSQ-------SSSQ--------------------------------------SSSQQ------------XX-SS-------SSSSS-------------
-------------------------------------------------------------------------------------------------------------XXX----------------------------
------------------------------------------------------------------------------------------------------------XXXX----------------------------
-----------------------------------------------------------------------------------------------------------XXXXX----------------------------
------------QS--------------Q--Q--Q--Q-----S----S?--Q---------------------------------S-S--?S--------------XXXXX----------------------------
----------------------------------------------------------------------------------------------------------XXXXXX----------------------------
---------------------------------------------------------------------------------------------------XXX---XXXXXXX----------------------------
--E---------------E-------------------------E--------E-E----------------------------EE-E-EE------EXXXE--XXXXXXXX-----------------------E-E--
XXXXXXXXXXXXXXXXXXXXXXXXXXXXXXXXXXXXXXXXXXXXXXXXXXXXXXXXXXXXXXXXX---XXXXXXXXXXXXXXXXXXXXXXXXXXXXXXXXXXXXXXXXXXXXXXXXXXXXXXXXXXXXXXXXXXXXXXXX