--------------------------------------------------------------------------------------------------------------------------------------------
--------------------------------------------------------------------------------------------------------------------------------------------
--------------------------------------------------------------------------------------------------------------------------------------------
--------------------------------------------------------------------------------------------------------------------------------------------
--------------------------------------------------------------------------------------------------------------------------------------------
-----------------------------------------QS-------------------------SSSSSSSSS--SSSSS---------------------------X----------------------------
--------------------------------------------------------------------------------------------------------------XX----------------------------
-------------------------------------------------------------------------------------------------------------XXX----------------------------
-------------------------------------------------------------------------------------------------------------XXX----------------------------
-------------------X---------SSSS------S------S------SS-Q--Q--Q--Q----SS----S--------------<>-----------XXXX-XXXQ----------S?S----Q--SS-Q--Q
---------------X---XX----------------------------------------------------------------------[]------XXX---XXX-XXX----------------------------
--------------XXX--XX----------------------------------------------------------------------[]-----XXXX--XXXX-XXX--<>------------------------
----------EE-XXX---XX---------------------E-E-E--E---------E-----------------------E-----E-[]-E---XXXXXXXXXXXXXX--[]--------E-----E---------
XXXXXXXXXXXXXXXXXXXXXXXXXXXXXXXXXXXXXXXXXXXXXXXXXXXXXXXXXXXXXXXXXXXXXXXXXXXXXXXXXXXXXXXXXXXXXXXXXXXXXXXXXXXXXXXXXXXXXXXXXXXXXXXXXXXXXXXXXXXX