--------------------------------------------------------------------------------------------------------------------------------------------
--------------------------------------------------------------------------------------------------------------------------------------------
--------------------------------------------------------------------------------------------------------------------------------------------
--------------------------------------------------------------------------------------------------------------------------------------------
--------------------------------------------------------------------------------------------------------------------------------------------
------------SQ------------------------------------------SS----?S--------SSSSS-------------------------------------------------S?-------SSSQS
--------------------------------------------------------------------------------------------------------------------------------------------
--------------------------------------------------------------------------------------------------------------------------------------E-----
--------------------------------------------------------------------------------------------------------------------------------------------
-SSSS---<>---------S-----SS------------------------------------Q------SS----------<>---------------------XX---XXX--Q--Q--Q---SQS----S?S-----
--------[]--------------X---------------------------------------------------------[]---------------------XX---XX----------------------------
--------[]-------------XX--------------------<>-------<>--------------------------[]-----------------XX-XXX--XXX----------------------------
EE----E-------EEEE-----E---------------------[]-------[]------------------------EX[]-----------------XXXXXX-XXXX----------------------------
XXXXXXXXXXXXXXXXXXXXXXXXXXXXXXXX--XXX------XXXX-XXXXXXXXXXXXXXXXXXXXXXXXXXXXXXXXXXXXXXXX--XXXXXX--XXXXXXXXXXXXXXXXXXXX---XXXXXXXXXXXXXXXXXXX