--------------------------------------------------------------------------------------------------------------------------------------------
--------------------------------------------------------------------------------------------------------------------------------------------
--------------------------------------------------------------------------------------------------------------------------------------------
--------------------------------------------------------------------------------------------------------------------------------------------
------------------------------------------------------------E---------------------------E---------------------------------------------------
--------------S--------------------S--------SSSS-----------SSSS---------------------S-SSSSSS------------------------------------------------
--------------------------------------------------------------------------------------------------------------------------------------------
-------------------------------------------------------X------------------------------------------------------------------------------------
--------------------------------------------------------------------------------------------------------------------------------------------
Q--Q--Q--Q-S?S----S--Q--Q--Q-------Q--Q-----------X---XX------------------------------------------X----X--------Q--Q--Q--Q--QS-S----SSSQS---
-------------------------------------------------XX---XX------------------------------------------XX---XX-----------------------------------
------------------------------------------------XXX--XXX-------------------XX-----<>-----------X--XXX--XXX----<>----------------------------
---E------------E-E--E---EE--------E-------E----XXXXXXXX-------------------XXX-----b----------EE---XX--XXXX---[]---E------------------------
XXXXXXXXXXXXXXXXXXXXXXXXXXXXXXXXXXXXXXXXXXXXXX-XXXXXXXXX------X-------------X------X---XXXXXX-XX--XXX--XXXXX-XXXXXXXXXXXXXXXXXXXXXXXXXXXXXXX