--------------------------------------------------------------------------------------------------------------------------------------------
--------------------------------------------------------------------------------------------------------------------------------------------
--------------------------------------------------------------------------------------------------------------------------------------------
--------------------------------------------------------------------------------------------------------------------------------------------
----------------------------------------------------------------------------------------E---------------------------------------------------
---------------------------------------------------------------------------------------?S---------------------------------------------------
--------------------------------------------------------------------------------------------------------------------------------------------
--------------------------------------------------------------------------------------------------------------------------------------------
----------------------------------------------------------------------------------------------------------------------------------X---------
------------QS-----------------------------------S-------------QS------------SS-------------------X----X---------------<>--------XX-XX------
--------------------------------------------------------------------------------------------------X----XX--------------[]-------XXX--XX--<>-
------------------------------<>-------------<>--------------------------------------------<>-X--------XX-----<>X------[]------XXXX------XX-
------------------------------[]-------------[]--------------------------------------------[]XXX----X-XXXX----[]E--E---[]------XXXX-----XXX-
XXXXXXXXXXXXXXXXXXXXXXXXXXXXXXXXXXXXXXXXXXXXXXXXXXXXXXXXXXXXXXXXXXXXXXXXXXXXXXXXXXXX---XXXXXXXXX---XXXXXXXXXXXXXXXXXXXXXXXXXXXXXXXXXXXXXXXXX