--------------------------------------------------------------------------------------------------------------------------------------------
--------------------------------------------------------------------------------------------------------------------------------------------
--------------------------------------------------------------------------------------------------------------------------------------------
--------------------------------------------------------------------------------------------------------------------------------------------
--------------------------------------------------------------------------------------------------------------------------------------------
-----SSS--------SS-S-------------------------------------Q---------------------------------------------------------------S?QQ------Q-------X
--------------------------------------------------------------------------------------------------------------------------------------------
----------------------------------------------------------------------------------------------------------------------------------------X---
---------------------------------------------------------------------------------------------------------------------------------------X----
--------------X----X-------------------SQS----Q--Q--Q--S---------------------------------------------------------Q--Q--QS-Q------------XX---
--------------XX---XX---------------------------------------------------------------------------------B------------------------X------XXX---
--------------XXX--XXX-----<>------------------------------------------------XX-------<>----<>-------XX-----------------------XXX---XXXX---B
----------EE-XXXX--XXXX----[]-----------E-----E-------E----------------E-E--XXXX------[]----[]-------<>X---------E---E-----E-XXX----XXXX----
XXXXXXXXXXXXXXXXXXXXXXXXXXXXXXXX---XXXXXXXXXXXXXXXXXXXXXXXXXXXXXXXXXXXXXXXXXXXXXXXXXXXXXXXXXXXXX---XXXXXXXXXXXXXXXXXXXXXXXXXXXXXXXXXXXXXXXXX