--------------------------------------------------------------------------------------------------------------------------------------------
--------------------------------------------------------------------------------------------------------------------------------------------
--------------------------------------------------------------------------------------------------------------------------------------------
--------------------------------------------------------------------------------------------------------------------------------------------
--------------------------------------------------------------------------------------------------------------------------------------------
SSSSSSSS----------------------------------------------------------------------------------------------------Q-------------------SS----------
--------------------------------------------------------------------------------------------------------------------------------------------
--------------------------------------------------------------------------------------------------------------------------------------------
--------------------------------------------------------------------------------------------------------------------------------------------
-------------------------XX---------------------------------------------------------X--Q--Q-----QSQS-----SS---------------------------------
-------------------------XX----S---------------------------B-------------<>-----------------------------------------------------------------
------------------------XXXX--<>----<>-------<>-----------<>----b--------XX--------------------------------------------------------X------<>
----------------------XXXXXX--[]----[]-------[]-----------[]---<>o------XXX---------------------------------------E---------------XX------[]
XXXXXXXXXXXXXXXXXXXXXXXXXXXXXXXXXXXXXXXXXXXXXXXXXXXXXXXXXXXXXXXXXXXXXXXXXXXXXXXXXXXXXXXXXX---XXXXXXXXXX--XXXXXXXXXXXXXXXXXXXXXXXXXXXXXXXXXXX