--------------------------------------------------------------------------------------------------------------------------------------------
--------------------------------------------------------------------------------------------------------------------------------------------
--------------------------------------------------------------------------------------------------------------------------------------------
--------------------------------------------------------------------------------------------------------------------------------------------
--------------------------------E-----------------------------------------------------------------------------------------------------------
----------------SSSSS---------SSSS----------------------SSQ---SS---SQS----SQ------XX---------?------------------S-----?S---SSSS----------SSS
---------------------------------------------------------------------------------XXX--------------------------------------------------------
--------------------------------------------------------------------------------XXXX------------------------E-------------------------------
-------------------------------------------------------------------------------XXXX---------------------------------------------------------
---------------------------------------------------------------Q--------------XXXXXX--------<>-------X----S?S----------Q------SS----S-SQ----
------------------------------------------------------------------------------XXXXXX--------[]------XX--------------------------------------
------------------------------------------------------<>--------------------XXXXXXXX--------[]----XXXX--------------------------------------
---------------------------E--------------------------[]-----------E-E-E----XXXXXXXXEEEE--E-[]----XXXX-----E--------------------------------
XXXXXXXXXXXXXXXXXXXXXXXXXXXX---------------------------XXXXXXXXXXXXXXXXXXXXXXXXXXXXXXXXXXXXXXXXXXXXXXXXXXXXXXXXXXXXXXXXXXXXXXXXXXXXXXXXXXXXX