--------------------------------------------------------------------------------------------------------------------------------------------
--------------------------------------------------------------------------------------------------------------------------------------------
--------------------------------------------------------------------------------------------------------------------------------------------
--------------------------------------------------------------------------------------------------------------------------------------------
--------------------------------------------------------------------------------------------------------------------------------------------
----------------------------------------------------------------------------------------------------------------SS----?S---------SSSS-------
--------------------------------------------------------------------------------------------------------------------------------------------
--------------------------------------------------------------------------------------------------------------------------------------------
----------------------------------------------------------------------------------------------------------S---------------------------------
-SS-----<>-------XX-XX-------------------------------------------------------------------------------XX----------------Q------S-------------
--------[]------XXX--XX--------------------------------------------------------------------<>>-------XX-------------------------------------
X-------[]-----XXXX--XXXXX----------------------------<------------------------------------[]]------XXX------------------------------X-----<
E-----E-[]----XXXXX--XXXXX----------------------------[-------------------------------EE---[]]-----XXXX-------E------------E---E----XXX----[
XXXXXXXXXXXXXXXXXXXXXXXXXXXXXXXXXXXXXXXXXXXXXXXXXXXXXXXX---------------------------XXXXXXXXXXXXXXXXXXXXXXXXXXXXXXXXXXXXXXXXXXXXXXXXXXXXXXXXX