--------------------------------------------------------------------------------------------------------------------------------------------
--------------------------------------------------------------------------------------------------------------------------------------------
--------------------------------------------------------------------------------------------------------------------------------------------
--------------------------------------------------------------------------------------------------------------------------------------------
--------------------------------------------------------------------------------------------------------------------------------------------
---------SSQQ-------------XX--------------S--------------------------Q-----------------------SSQQ-------------------------------------------
--------------------------------------------------------------------------------------------------------------------------------------------
------------------------X------------------------------------------E------------------------------------------------------------------------
-----------------------XX-------------------------------------------------------------------------------------------------------------------
----Q--QS-Q------------XX---Q--Q--Q--Q----------SSS-------<>-----S?S-S----S--Q--QSSS-Q--Q--SS-Q--------S-----XX------------------XXX-X------
---------------------XXXX---------------------------------[]------------------------------------------------XXX--------<>-------XXXXXX------
---------------XX---XXXXX-----[]--------------------------------------------------------------------------XXXXX-X------[]------XXXXXXX---XXX
-E-----------EXX-E--XXXXX------E------------E--------------E----------E-E-E--E----E--E-----------EEE-E--E-XXXXXX]-EE---[]------XXXXXXXX---[X
XXXXXXXXXXXXXXXXXXXXXXXXXXXXXXXXXXXXXXXXXXXXXXXXXXXXXXXXXXXXXXXXXXXXXXXXXXXXXXXXXXXXXXXXXXXXXXXXXXXXXXXXXXXXXXXXXXXXXXXXXXXXX-XXXXXXXXXXXXXX