--------------------------------------------------------------------------------------------------------------------------------------------
--------------------------------------------------------------------------------------------------------------------------------------------
--------------------------------------------------------------------------------------------------------------------------------------------
--------------------------------------------------------------------------------------------------------------------------------------------
--------------------------------------------------------------------------------------------------------------------------------------------
------------------------------------------------------------------------------------SSSSSSSS--SSQS--SSSSS----------------SSSQQ-----Q------XX
--------------------------------------------------------------------------------------------------------------------------------------------
----------------------------------------------------------------------------------------------------------------------------------------X---
---------------------------------------------------------------------------------------------------------------------------------------XX---
---S-------S?S----Q--Q--Q--S-----------------------------SS----<>-------X--X------<>-------Q------------------XX----Q--SSS---------S---XX---
---------------------------------------------------------------[]------XXX--X-----[]----------------------X---XX-----------------------XXX--
---------------------------------------------------------------[]-----XXXX-XXX----XX---------------------X----XX---------------------XXXXX--
------------E-----E--E-------------------------------------E-E-[]----XXXXX-XXXX-E-[X---------------E----E-X-XXXX-E-----------EEE-E--EXXXXX--
XXXXXXXXXXXXXXXXXXXXXXXXXXXXXXXXXXXXX--XXXXXXXX--XXXXXXXXXXXXXXXXXXXXXXXXXXXXXXXXXXXXXXXXXXXXXXXXXXXXXXXXXXXXXXXXXXXXXXXXXXXXXXXXXXXXXXXXXXX