--------------------------------------------------------------------------------------------------------------------------------------------
--------------------------------------------------------------------------------------------------------------------------------------------
--------------------------------------------------------------------------------------------------------------------------------------------
--------------------------------------------------------------------------------------------------------------------------------------------
----E---------------------------------------------------------------------------------------------------------------------------------------
--SSSSSS--------------------------------------------------------------S--------SSSQS--------------------------------------------------------
--------------------------------------------------------------------------------------------------------------------------------------------
------------------------------------------------------------------------------E-------------------------------------------------------------
--------------------------------------------------------------------------------------------------------------------------------------------
--------------S-----------------------------------------X--Q--Q--Q----SS----S?SQS-----<>-----------------------------------------<>--------S
--------------------------------------------------------------------------------------[>-----------------------------------------[]---------
--------------------------<>-----------------<>---------------------------------------[]----<>------------------X-->----<>-------[]---------
--------------------E-----[]-----------------[]---------------------------------------[]----[]------E-----------E-E]----[]-------[]---------
------X--------------------XXXXX---XX-----XXXXXXXXXXXXXXXXXXXXX--XXXXXXXXXXXXXXXXXXXXXXXXXXXXXXXXXXXXXXXXXXXXXXXXXXXXXXXXXXXXXXXXXXXXXXXXXXX