--------------------------------------------------------------------------------------------------------------------------------------------
--------------------------------------------------------------------------------------------------------------------------------------------
--------------------------------------------------------------------------------------------------------------------------------------------
--------------------------------------------------------------------------------------------------------------------------------------------
--------------------------------------------------------------------------------------------------------------------------------------------
--------------------------------------------------------------------------------------------------------------------------------------------
--------------------------------------------------------------------------------------------------------------------------------------------
--------------------------------------------------------------------------------------------------------------------------------------------
--------------------------------------------------------------------------------------------------------------------------------------------
--->-------S?S----Q--Q-----S-----------------<>-------------------------------------X---------------------S----------------------XX--X------
--[]-----------------------------------------[]-------------------------------------------------------------------->----<>------XXX--XX-----
--[]------------------------X-------<>-------[]------<>--------<>-----------------<>----------------------------X-[]----[]------XXX--XXXX---
--[]--------E-----E---------E-E-----[]-------[]------[]--------[]----------X------[]----------------------------E-[]----[]-----XXXX--XXXX---
XXXXXXXXXXXXXXXXXXXXXXXXXXXXXXXXXXXXXXXXXXXXXXXXXXXXXXXX---XXXXXX-----XX---XXXXXXXXXXXXXX---XXXXXX--XXXXXXXXXXXXXXXXXXXXXXXXXXXXXXXXXXXXXXXX