--------------------------------------------------------------------------------------------------------------------------------------------
--------------------------------------------------------------------------------------------------------------------------------------------
--------------------------------------------------------------------------------------------------------------------------------------------
--------------------------------------------------------------------------------------------------------------------------------------------
--------------------------------------------------------------------------------------------------------------------------------------------
-----------------------------QS-----------SSSSS-----S---------------SQS---------Q-------------SSSSQ----Q------SS-------------Q--------------
--------------------------------------------------------------------------------------------------------------------------------------------
-------------------------------------------------------------------E------------------------------------------------------------------------
--------------------------------------------------------------------------------------------------------------------------------------------
-SS-S---<>-------<>---------------------------------------SSS----S?S------S--Q--Q--Q---Q---S?S---------SS----------S-----------------SSQS--Q
--------[]-------[]---------------------------------------[]--------------------------------------------------------------------------------
--------[]-------[]-------------------------------------------------------------------------------------------------------------------------
[E----E-[]-----X-[]-------E-----------------------------E-E-----------E-E-E--E---------E---------EEEE---E--E-E----------------E-E-E---------
XXXXXXXXXXXXXXXXXXXXXXXXXXXXXXXXXXXXXXXXXXXXXXXXXXXXXXXXXXXXXXXXXXXXXXXXXXXXXXXXXXXXXXXXXXXXXXXXXXXXXXXXXXXXXXXXXXXXXXXXXXXXXXXXXXXXXXXXXXXX