--------------------------------------------------------------------------------------------------------------------------------------------
--------------------------------------------------------------------------------------------------------------------------------------------
--------------------------------------------------------------------------------------------------------------------------------------------
--------------------------------------------------------------------------------------------------------------------------------------------
--------------------------------------------------------------------------------------------------------------------------------------------
-----SSS--------SS-S-------------------------------------Q---------------------------------------------------------------S?QQ------Q-------X
--------------------------------------------------------------------------------------------------------------------------------------------
----------------------------------------------------------------------------------------------------------------------------------------X---
---------------------------------------------------------------------------------------------------------------------------------------X----
--------------X----X-------------------SQS----Q--Q--Q--S---------------------------------------------------------Q--Q--QS-Q------------XX---
--------------XX---XX--------------------------------------------------------------------------------->------------------------X------XXX---
--------------XXX--XXX-----<-------------------------------------------------XX-------<>----<>-------XX-----------------------XXX---XXXX---<
----------EE-XXXX--XXXX----[------------E-----E-------E----------------E-E--XXXX------[]----[]-------[XX---------E---E-----E-XXX----XXXX---[
XXXXXXXXXXXXXXXXXXXXXXXXXXXXXXXX---XXXXXXXXXXXXXXXXXXXXXXXXXXXXXXXXXXXXXXXXXXXXXXXXXXXXXXXXXXXXX---XXXXXXXXXXXXXXXXXXXXXXXXXXXXXXXXXXXXXXXXX