--------------------------------------------------------------------------------------------------------------------------------------------
--------------------------------------------------------------------------------------------------------------------------------------------
--------------------------------------------------------------------------------------------------------------------------------------------
--------------------------------------------------------------------------------------------------------------------------------------------
--------------------------------------------------------------------------------------------------------------------------------------------
-?----?-----SSSQS-S----SSSQS-------S--------SSSQS------X--------------S?------------SSSSSSSS------------------------------------------------
--------------------------------------------------------------------------------------------------------------------------------------------
--------------------------------------------------------------------------------------------------------------------------------------------
--------------------------------------------------------------------------------------------------------------------------------------------
X--Q--Q--Q----SS----S--------------QS-Q--------S-------XQ--Q-------SQS----S-----------------------X----X--------------------QS-------S------
---------------------------------------------------X--XX-------------------------<>---------------XX---XX-----------------------------------
-------------------------------------------------X-XX-XX-------------------------[]---------------XXX--XXX-----<----------------------------
-------------------------E-E-----------E-E-E----E-XXXXXX----------------E-E------[]X----------EE--XXX--XXXX----[----------------------------
XXXXXXXXXXXXXXXXXXXXXXXXXXXXXXXXXXXXXXXXXXXXXXXXXXXXXXXXXXXXXXXXXXXXXXXXXXXXXXXXXXXX--XXXXXXXXXXXXXXX--XXXXXXXXXXXXXXX-XXXXXXXXXXXXXXXXXXXXX