--------------------------------------------------------------------------------------------------------------------------------------------
--------------------------------------------------------------------------------------------------------------------------------------------
--------------------------------------------------------------------------------------------------------------------------------------------
--------------------------------------------------------------------------------------------------------------------------------------------
--------------------------------------------------------------------------------------------------------------------------------------------
------------------------------------------------------------------SSSSQ----------------?------------------------SSSSSSSS------SSSSS---------
--------------------------------------------------------------------------------------------------------------------------------------------
--------------------------------------------------------------------------------------------------------------------------------------------
--------------------------------------------------------------------------------------------------------------------------------------------
-----------------------------------------------X-----------SS---SS---------SQ----SS-------------QS-------Q----------------------------------
X----------------<>------------------------XX-----------------------------------------------------------------------------------------------
X-------<>-------[]-----------------------XXX----------X----------------------------------------------------------------------------------<X
]-E-----[]-------[]X---------------------XXXX-----X----X-E------------E-E---E--E----------------E-----E-----------------------------------[]
XXXXXXXXXXXX--XXXXXXXXXXXXXXXXXXXXXXXXXXXXXXXXXXXXXXXXXXXXXXXXXXXXXXXXXXXXXXXXXXXXXXXXXX---XXXXXXXXXXXX-XXXXXXXXXXXX---XXXXXXXXXXXX-XXXXXXXX