--------------------------------------------------------------------------------------------------------------------------------------------
--------------------------------------------------------------------------------------------------------------------------------------------
--------------------------------------------------------------------------------------------------------------------------------------------
--------------------------------------------------------------------------------------------------------------------------------------------
--------------------------------------------------------------------------------------------------------------------------------------------
-SSSS-------------------------------------------------------------S-SSSQ-------SSSQS------------------------------SSSSS---------------------
--------------------------------------------------------------------------------------------------------------------------------------------
--------------------------------------------------------------------------------------------------------------------------------------------
----------------------------------------------X---------------------------------------------------------------------------------------------
------------------------------S----<>>-------XX-XX---X-----SS---?S----------S---S----SS----?>---------------------------------------------<>
-----------------------------------[[]------XXX--XX--XX---------------------------------------------XXX------------------------X---XX-----[]
----------------------------X------[]]-----XXXX--XXXXXX-------------------------------------]-------XXX----------------<>------XXXXXXX----[]
----------------------------E--E--E[]-----XXXXX--XXXXXX-----------------E------------------[]------XXXX----------------[]-E----XXXXXXXX---[]
---------------------------XXXXXXXXXXXXXXXXXXXXXXXXXXXXXXXXXXXXXXXXXXXXXXXXXXXXXXXXXXXXXXXXXXXXXXXXXXXXXXXXXXXXXXXXXXXXXXXXXXXXXXXXXXXXXXXXX