--------------------------------------------------------------------------------------------------------------------------------------------
--------------------------------------------------------------------------------------------------------------------------------------------
--------------------------------------------------------------------------------------------------------------------------------------------
--------------------------------------------------------------------------------------------------------------------------------------------
--------------------------------------------------------------------------------------------------------------------------------------------
------------SSSQ-------SS---SSQ---S-----SSS---------SSSS------------------------------------------------------------------------------------
--------------------------------------------------------------------------------------------------------------------------------------------
--------------------------------------------------------------------------------------------------------------------------------------------
--------------------------------------------------------------------------------------------------------------------------------------------
X--Q-----Q----?S----S---------------------SS------------Q--Q--Q----SQ-----S--Q-----S-------<>--------XX-XXX---XX-----------SQS----Q--SS-Q--Q
-------------------------------------------------------------------------------------------[]-------XXX-XXX--XXX----------------------------
-------------------------------------------------------------------------------------------[]------XXXX-XXX--XXX--<>------------------------
-------------------------EEE---------------------------E---E------------E-E--E--------EE---[]-----XXXXXXXXX-XXXX--[]--------------E---------
XXXXXXXXXXXXXXXXXXXXXXXXXXXXXXXXXXXXXXXXXXXXXXXXXXXXXXXXXXXXXXXXXXXXXXXXXXXXXXXXXXXXXXXXXXXXXXXXXXXXXXXXXXXXXXXXXXXXXXXXXXXXXXXXXXXXXXXXXXXX