--------------------------------------------------------------------------------------------------------------------------------------------
--------------------------------------------------------------------------------------------------------------------------------------------
--------------------------------------------------------------------------------------------------------------------------------------------
--------------------------------------------------------------------------------------------------------------------------------------------
----E---------------------------------------------------------------------------------------------------------------E-----------------------
SSSSSSSS--------SSSSS-------SS----?S---------SSQ-------X----------------------------SSSSSSSS---S----------------SSSSSSS---------------------
------------------------------------------------------XX------------------------------------------------------------------------------------
-----------------------------------------------------XXX------------------------------------------------------------------------------------
----------------------------------------------------XXXX------------------------------------------------------------------------------------
--------------S----X---------Q--Q--QS-Q-----------XX-XXX--SSS---<>--------S----------------------------------XXXX---------------------------
--------------X----XX-----------------------------XX-XXX--------[]----------------------------------------X--XXX----------------------------
-------------------XXX----<<---------------------XXXXXXX--------[]---------------------------------------XXXXXXX----------------------------
----------EE-------XXXX---[[-----------E-E-E----XXXXXXXX-E------[]----EEE--------------------------------XXXXXXX----------------------------
--XXXXXX--XXXXXX---XXXXXXXXXXXXXXXXXXXXXXXXXXXXXXXXXXXXXXXXXXXXXXXXXXXXXXXXXXXXXXXXXXXXXXXXXXXXXXXXXXXXXXXXXXXXX-XXX-----X-----------------X