--------------------------------------------------------------------------------------------------------------------------------------------
--------------------------------------------------------------------------------------------------------------------------------------------
--------------------------------------------------------------------------------------------------------------------------------------------
--------------------------------------------------------------------------------------------------------------------------------------------
------------------------------------------------------------E-------------------------------------------------------------------------------
------------------------------------------------X---------SSSSSS-----SSSSSQ------------SS-----------SS-----SS-------------------------------
---------------------------------------------XX---------------------------------------------------------------------------------------------
---------------------------------------------XXX--------------------------------------------------------------------------------------------
---------------------------------------------XXXX-------------------------------------------------------------------------------------------
------------Q----------------------<>X------XXXXXSSQ------------------------------------------------------------------------?S-------SS----S
-----------------------------------[[]-----XXX-XX-------------------------------------------------------------------------------------------
----------------------------X------[]-----XXXXXX------------------------------------------------------------------<>----->-------<>---------
----------------------------E-EE---[]----XXXXXXXX-----------------------------------------------------------------[]--------E----[]---------
XXXXXXXXXXXXXXXXXXXXXXXXXXXXXXXXXXXXXXXXXXXXXXXXXXXXXXXXXXXXXXXXXXX-X----XXXXXXXXXXX-------------X---------X----XXXXXXXXXXXXXXXXXXXXXXXXXXXX