--------------------------------------------------------------------------------------------------------------------------------------------
--------------------------------------------------------------------------------------------------------------------------------------------
--------------------------------------------------------------------------------------------------------------------------------------------
--------------------------------------------------------------------------------------------------------------------------------------------
----------------------------------------------------------------------------------------E---------------------------------------------------
SSQS-SSS---S?S------------SS--------------------------------------------------------SSSSSSSS--------SSSSS-----------------------------------
---------------------------------------------XX---------------------------------------------------------------------------------------------
------------------------E--------------------XXX--------------------------------------------------------------------------------------------
---------------------------------------------XXXX-------------------------------------------------------------------------------------------
----------------------S?S-----------<-------XXXXX------------------------<------------------------SS----------<X-SS-----<>-------X----------
-----------------------------------<[------XXX-XX------------------------<>-----------------------------------[X--------[]------XX----------
----------------------------X------[]-----XXXXXXXX------X-------<>-------[]-----------------------------------[]--------[------XXX----------
---------------E------------E-EE---[]----XXXXXXXXXX-----]-E-----[]-------[]-------E---------------------E-X-E-[]-E----E-[]----XXXX----------
XXXXXXXXXXXXXXXXXXXXXXXXXXXXXXXXXXXXXXXXXXXXXXXXXXXXXXXXXXXXXXXXXXXXXXXXXXXXXXXXXXXXXXXXXXX--XXXXXXXXX-XXXXXXXXXXXXXXXXXXXXXXXXXXXXXXXXXXXXX