--------------------------------------------------------------------------------------------------------------------------------------------
--------------------------------------------------------------------------------------------------------------------------------------------
--------------------------------------------------------------------------------------------------------------------------------------------
--------------------------------------------------------------------------------------------------------------------------------------------
--------------------------------------------------------------------------------------------------------------------------------------------
------------SQ-----Q-----------------SSSQQ-----Q--------SSSSSSSS-----SSSSSSSS--SSSSS------SS------SSSSSSS-----------------------------------
--------------------------------------------------------------------------------------------------------------------------------------------
--------------------------------------------------------------------------------------------------------------------------------------------
--------------------------------------------------------------------------------------------------------------------------------------------
---Q---SSS---------SS-----------Q--SS-Q--------S----------------------SS--------------------------SS----------<>----------------X--X--------
----------------------------------------------------XX--------------------------------------------------------[]-------[]-----XX---XX-------
---------------------------------------------------XXX--------------------------------------------------------[]--<----[]-----XXX--XXX-----<
-------------EEEE--------E-E-E-----------EEE-E--E-XXXX-X---------------------------E------------------------E-[]--EE---[]XE--XXXX--XXXX----[
XXXXXXXXXXXXXXXXXXXXXXXXXXXXXXXXXXXXXXXXXXXXXXXXXXXXXXXXXXXXXX---XXXXXXXXXX---XXXXXXXXXXXXXXXXXXXXXXXXXXXXXXXXXXXXXXXXXXXXXXXXXXXX-XXXXXXXXX