--------------------------------------------------------------------------------------------------------------------------------------------
--------------------------------------------------------------------------------------------------------------------------------------------
--------------------------------------------------------------------------------------------------------------------------------------------
--------------------------------------------------------------------------------------------------------------------------------------------
--------------------------------------------------------------------------------------------------------------------------------------------
---------------------------X------------SSSQ-------SQSQS------------------------------------------------------------------------------------
---------------------------X----------------------------------------------------------------------------------------------------------------
--------------------------------------------------E-----------------------------------------------------------------------------------------
--------------------------------------------------------------------------------------------------------------------------------------------
-------<>-Q-----X---X-XX--XXQ--Q--Q--Q-----S----S?SQS---X-------------QS-------------------------------X---------SS--------------<>---------
-------[]------XXX--XXXX--XX----------------------------------------------------------------------XX---XX---------------<>-------[]------X>-
-------[]-----XXXX--XXXX--XX---------------------------------------------------------------<------XXX--XXX-----<X-------[]-------[]-----XX]-
---E-E-[]-E--XXXXX-XXXXXXXXX---E------------E-------------------------------------EE-------[]-E---XXX--XXXX----[[-------[]-------[]----XXXX-
XXXXXXXXXXXXXXXXXXXXXXXXXXXXXXXXXXXXXXXXXXXXXXXXXXXXXXXXXXXXX---XXXXXXXXXXXXXXXXXXXXXXXXXXXXXXXXXXXXXXXXXXXXXXXXXXXXXXXXXXXXXXXXXXXXXXXXXXXX