--------------------------------------------------------------------------------------------------------------------------------------------
--------------------------------------------------------------------------------------------------------------------------------------------
--------------------------------------------------------------------------------------------------------------------------------------------
--------------------------------------------------------------------------------------------------------------------------------------------
--------------------------------------------------------------------------------------------------------------------------------------------
---------------------------------------------------------------------------------------------S-----------------XS------S--SSSS-----Q--------
-------------------------------------------------------------------------XX-----------------------------------XX----------------------------
-------------------------------------------------------------------------XXX--------------------------------XXXX----------------------------
-------------------------------------------------------------------------XXX-------------------------------XXXXX----------------------------
-----------------------------SS---------------------------------------X-X-XXX--------------<>-------XX---XXXXXXX-------QS-------------------
-----------------------------------------------------<X--------<>------XXXXXX--------------[]------XXX---XXXXXXX----------------------------
---------------------------------------------<-------XX-X------[]-X---XXXXXXXX----<>--------]-----XXXX--XXXXXXXX----------------------------
---------------------------------------------[]-----XXXX]-EE---[]XX---XXXXXXXXX---[]-E---E-E-----XXXXX--XXXXXXXX----------------------XXX---
XXXX---XX----X-XXXX--XXXXXXXXXXXXXXXXXXXXXXXXXXXXXXXXXXXXXXXXXXXXXXX--XXXXXXXXXXXXXXXXXXXXXXXXXXXXXXXXXXXXXXXXXXXXXXXXXXXXXXXXXXXXXXXXXXXXXX