--------------------------------------------------------------------------------------------------------------------------------------------
--------------------------------------------------------------------------------------------------------------------------------------------
--------------------------------------------------------------------------------------------------------------------------------------------
--------------------------------------------------------------------------------------------------------------------------------------------
--------------------------------------------------------------------------------------------------------------------------------------------
---------SSSQQ-----Q------XXSS--------SSQS-----Q-------X---SSSS------SSSSSSS---SSSSS------------------S---------------------------------Q---
-------------------------XX----------------------------X------------------------------------------------------------------------------------
------------------------XX------------------------------------------------------------------------------------------------------------------
-----------------------XX-------------------------------------------------------------------------------------------------------------------
--S-S--?<>---------S---XX----------SSS---------S---X--XXX-------------SS------------------------------------------SS-----S?S------S-S?S-Q--Q
--------[]------------XXX--------------------------XXXXX------------------------------------------------------------------------------------
--------[]----XXX----XXXX--------------------------XXXXX------------------------------[]----------------------------------------------------
EE-E--E--]---XXXXE--XXXXX----------------E-E-E--E-XXXXXX------------------------------[]--------------------------E-------------E----E------
XXXXXXXXXXXXXXXXXXXXXXXXXXXXXXXXXXXXXXXXXXXXXXXXXXXXXXXXXXXXXX---XXXXXXXXXX---XXXXXXXXXXXXXXXXXXXXXXXXXXXXXXXXXXXXXXXXXXXXXXXXXXXXXXXXXXXXXX