--------------------------------------------------------------------------------------------------------------------------------------------
--------------------------------------------------------------------------------------------------------------------------------------------
--------------------------------------------------------------------------------------------------------------------------------------------
--------------------------------------------------------------------------------------------------------------------------------------------
----E---------------------------------------------------------------------------------------------------------------------------------------
--SSSSSS----------------------------------------------------------------------------SSQ------------------------X--SSSQ----------------------
---------------------------------------------------------------------------------------------------------------X----------------------------
-----------------------------------------------X--------------------------------------------------------------------------------------------
----------------------------------------------XX--------------------------------------------------------------------------------------------
----------------------------------------------XXX-----<>--------------------------------------------X-----XX--XX----------------------------
-----------------------------------<>-------XXXXXX----[]------------------------------------------XXXX--XXXX--XX----------------------------
----------------------------X------[]------XXXXXXXX---[]-----------------<>----------------<]-----XXXX--XXXX-XXX----------------------------
----------------------------]-EE---[]-X----XXXXXXXX---[]------------E----[]----------------[]-E--XXXXX-XXXXXX-XX----------------------------
--XX--XXX-------------XXXXXXXXXXXXXXXXXX--XXXXXXXXXXXXXXXXXXX--XXXXXXXXXXXXXXXXXXXXXXXXXXXXXXXXXXXXXXXXXXXXXXXXX---X---------X---------X---X