--------------------------------------------------------------------------------------------------------------------------------------------
--------------------------------------------------------------------------------------------------------------------------------------------
--------------------------------------------------------------------------------------------------------------------------------------------
--------------------------------------------------------------------------------------------------------------------------------------------
------------------------------E-------------------------------------------------------------------------------------------------------------
---SS-----------------------SSSSSSSS---SQS-----Q-------X------------SSSQ-------SSSQS-------------------------------------SSS----------------
--------------------------------------------------------------------------------------------------------------------------------------------
------------------------------------------------------------------------------E-------------------------------------------------------------
--------------------------------------------------------------------------------------------------------------------------------------------
------------------------------------------S--------X---XQ--Q--Q--Q----SS----S?SQS---------------QS---------------------QS-------------------
--------------------------------------------------XX--XX-----------------------------------------------------------------------------XXXXXX-
------------------------------------------------XXXX--X<---------------------------------------------<>------------------------XXX---XXXXXXX
---------------------------------------E---E---XXXXX--X[------------------------------E---------E----[]-------E---------------XXXX--XXXXXXXX
----------------------------XXXXXXX---XXXXXX---XXXXXXXXXXXXXXXXXXXXXXXXXXXXXXXXXXXXXXXXXXXXXXXXXXXXXXXXXXXXXXXXXXXXXXXXXXXXXXXXXXXXXXXXXXXXX