--------------------------------------------------------------------------------------------------------------------------------------------
--------------------------------------------------------------------------------------------------------------------------------------------
--------------------------------------------------------------------------------------------------------------------------------------------
--------------------------------------------------------------------------------------------------------------------------------------------
--------------------------------------------------------------------------------------------------------------------------------------------
-------------------------------------?----------------------------------------------S-----?S--------------------SSSSSSSS---S?SSSSSSSS--SSSSS
--------------------------------------------------------------------------------------------------------------------------------------------
--------------------------------------------------------------------------------------------------------------------------------------------
--------------------------------------------------------------------------------------------------------------------------------------------
--------------X----X---------?S-----<>-------XX--X---X---SS----<>--------XX----------------Q------S?--------------------------SS------------
-----------X--XX---XX---------------[]------XX---XX-XX---------[]-------XXX-----------------------------------------------------------------
-------<>-XX---XX--XXX----[]X-------[]-----XXXX---XXXXX--------[]-------XXX-----------------------------------------------------------------
-------[]XXX---XX-XXXXX---[]EE----E-[]----XXXXX---XXXX---------[]------XXXX--------------------E---E----------------------------------------
--XXXXXXXXXX--XXXX-XXXXXXXXXXXXXXXXXXXXXXXXXXXXXXXXXXXX-XXXXXXXXXXXXXXXXXXXXXXXXXXXXXXXXXXXXXXXXXXXXXXXXXXXXXXXXXXXXXXX--XXXXXXXXXXXXXXXXXXX