--------------------------------------------------------------------------------------------------------------------------------------------
--------------------------------------------------------------------------------------------------------------------------------------------
--------------------------------------------------------------------------------------------------------------------------------------------
--------------------------------------------------------------------------------------------------------------------------------------------
--------------------------------------------------------------------------------------------------------------------------------------------
SSS--------------------------------------------------------?S-------------------------------------------------------------------------------
--------------------------------------------------------------------------------------------------------------------------------------------
--------------------------------------------------------------------------------------------------------------------------------------------
--------------------------------------------------S-----------------------------------------------------------------------------------------
---------------------------------------------XX-----------------------X----X-------------------------------------SS--------------XX---------
------------------------------->----<>------XXX--------------------X--X----XX-------------------------------------------<>-------XX---------
------------------------------[]----[]------XXX----------------<>-X--------XX-----------------------------------X-------[]-------XX---------
------------------------------[]----[]-----XXXXX---------------[]XXX----X-XXXX----------------------------------[-------[]-----XXXX-------E-
XXXXXXXXXXXXXXXXXXXXXXXXXXXXXXXXXXXXXXXXXXXXXXXXXXXXXXXX--XX-XXXXXX-------XXXX-----X---XXX-----------XX----XXXXXXXXXXXXXXXXXXXXXXXXXXXXXXXXX