--------------------------------------------------------------------------------------------------------------------------------------------
--------------------------------------------------------------------------------------------------------------------------------------------
--------------------------------------------------------------------------------------------------------------------------------------------
--------------------------------------------------------------------------------------------------------------------------------------------
--------------------------------------------------------------------------------------------------------------------------------------------
-----------------------------Q------------------------------------------------------SSQ-------SSSSSQ-------SQSQS-----------------------SS---
--------------------------------------------------------------------------------------------------------------------------------------------
---------------------------------------------------------------------------------------------E------------E---------------------------------
--------------------------------------------------------------------------------------------------------------------------------------------
-----------------------------------------------X---------------------------------------Q---S?S----SS----S?S?S---X-----------QSQS------------
------------------X-----------------------XX---XX-------------------------------------------------------------------------------------------
--------<>-------XX-------<>-------<>-----XXX--XXX-----<-----------------<>-----------------------------------------------------------------
--------[]------XXXX------XX-------[]XXX-XXXX--XXXXX---[-----------------[]-------E-----------------E---------------------------------------
XXXXXXXXXXXXXXXXXXXXXXXXXXXXXXXXXXXXXXXXXXXXXXXXXXXXXXXXXXXX---XXX--XXXXXXX--XXXXXXXXXXXXXXXXXXXXXXXXXXXXXXXXXXXXXXXXXXXXXXXXXXXXXX--XXXXXXX