--------------------------------------------------------------------------------------------------------------------------------------------
--------------------------------------------------------------------------------------------------------------------------------------------
--------------------------------------------------------------------------------------------------------------------------------------------
--------------------------------------------------------------------------------------------------------------------------------------------
--------------------------------------------------------------------------------------------------------------------------------------------
-------------------------------------------------------------------------------SS-----------------------------------------------------------
--------------------------------------------------------------------------------------------------------------------------------------------
--------------------------------------------------------------------------------------------------------------------------------------------
--------------------------------------------------------------------------------------------------------------------------------------------
-----------S?S---<>--------S----------------------------X------------SQS--------------------<>-------XX-------S---------<>-------X--XX-XX---
--->-------------[]-------------------------------------------------------------------------[]-------XX-----------------[]------XX--XXXXXX--
--[]----<>-------[]--------------------------<>-------------------------------------X-------[]------XXX-----------------[]----XXXX---XXXXX--
--[]----[]--E----[]---------------------E----[]-------E-----------------------------E-EE--E-[]-----XXXX----E----E-EE--E-[]----XXXX--XXXXX---
XXXXXXXXXXXXXXXXXXXXXXXXXXXXXXXX--XXXXXXXXXXXXXXXXXXXXXXXXXXXX---XXXXXXXXXX---XXXXXXXXXXXXXXXXXXXXXXXXXXXXXXXXXXXXXXXXXXXXXXXXXXXXXXXXXXXXX-