--------------------------------------------------------------------------------------------------------------------------------------------
--------------------------------------------------------------------------------------------------------------------------------------------
--------------------------------------------------------------------------------------------------------------------------------------------
--------------------------------------------------------------------------------------------------------------------------------------------
--------------------------------E-----------------------------------------------------------------------------------------------------------
----------------------------SSSSSSSS-------------------------SS-------SSSQSSS--SSSQS--------------------------------------------------------
--------------------------------------------------------------------------------------------------------------------------------------------
------------------------------------------------------------------------------E-------------------------------------------------------------
----------------------------------------------------------------------------------------------------------S---------------------------------
--------<--------<>---------X---------------------------X-------------SS----S------------------------XX--------------------S?S--------------
--------<]-------[]-------------------------------------------------------------------->-------------XX-------------------------------------
---]----[]-------[]-------------------------------------------------------------------<>----<>------XXXX-------------------------<>---------
E-EE----[]-------[]----------------------------------------------------------------E--[]----[]------XXXX--------------------E----[]-------E-
XXXXXXXXXXXXXXXXXXXXXXXXXXXXXXXXXX---XXXXX---XX---XXXXXXXXXXXX---XXXXXXXXXX---XXXXXXXXXXXXXXXXXXXXXXXXXXXXXXXXXXXXXXX--XXXXXXXXXXXXXXXXXXXXX