--------------------------------------------------------------------------------------------------------------------------------------------
--------------------------------------------------------------------------------------------------------------------------------------------
--------------------------------------------------------------------------------------------------------------------------------------------
--------------------------------------------------------------------------------------------------------------------------------------------
------------------------------------------------------------E-------------------------------------------------------------------------------
------------------------------SSSSS-------SSSSSS----------SSSSS-----------------------------------------------------------------------------
-----------------------------------------------------------------------------------------------------XX-------------------------------------
-----------------------------------------------------------------------------------------------------XXX------------------------------------
-----------------------------------------------------------------------------------------------------XXXX-----------------------------------
-SSS-------S?S----S--Q--Q--QX-------------QS------------------------------------------------------X---XX------------------------------------
------------------------------------------------------------------------------------X------<>--X--XXX-XXX-----------------------------------
------------------------------------------------------<>----------------------------X------[]-X---XXXXXXXX-----------------------<----------
----------------E-E--E--------------------------------[]----------------------------]-EE---[]XX---XXXXXXXX------------------------]-------E-
XXXXXXXXXXXXXXXXXXXXXXXXXXXXXXXXX----XX-XXX--X-----X---X------X---------------------XXXXXXXXXXXX--XXXXXXXXXXXXXXXXXXXXXXXXXXXXXXXXXXXXXXXXXX