--------------------------------------------------------------------------------------------------------------------------------------------
--------------------------------------------------------------------------------------------------------------------------------------------
--------------------------------------------------------------------------------------------------------------------------------------------
--------------------------------------------------------------------------------------------------------------------------------------------
--------------------------------------------------------------------------------------------------------------------------------------------
----------------------------S------S--SSQS--SSSQ---------------------Q--------------------------------------------SSSS----------SSQS--------
---------------------------------------------------------------------------------------------------------------X----------------------------
---------------------------------------------------------------------------------------------------------------X----------------------------
---------------------------------------------------------------------------------------------------------------X----------------------------
-SSS-------S?S----S--Q-----S-Q--Q--SS-Q--------S-----XX---SSS----S--------S----------SS----<>--------XX--XX--XXX----------------------------
----------------------------------------------------XXXX-----------------------------------[]-------XXX--XX--XXX----------------------------
---------------------------------------------------XXXXX-----------------------------------[]------XXXX--XXXXXXX--------------------------<>
------------E-E---E--E----E--------------E-E----E-XXXXXX--------------E-E-E------EE-[E---E-[]------XXXX---XXXXXX--------------------------[]
XXXXXXXXXXXXXXXXXXXXXXXXXXXXXXXXXXXXXXXXXXXXXXXXXXXXXXXXXXXXXXXXXXXXXXXXXXXXXXXXXXXXXXXXXXXXXXXXXXXXXXXXXXXXXXXXXXXX---XX------XXX---XXXXXXX