--------------------------------------------------------------------------------------------------------------------------------------------
--------------------------------------------------------------------------------------------------------------------------------------------
--------------------------------------------------------------------------------------------------------------------------------------------
--------------------------------------------------------------------------------------------------------------------------------------------
--------------------------------------------------------------------------------------------------------------------------------------------
SSSSSSSS----SSSSSSSSS--SSSS-SSQ-------SSSSQ----Q-----------------Q----------------------------------------------------------------------QS--
--------------------------------------------------------------------------------------------------------------------------------------------
-------------------------------------------------------------------------X------------------------------------------------------------------
--------------------------------------------------------------------------------------------------------------------------------------------
--------------SS---------------------S---------S---------SS----<>-------XX-XX---------------------------------<>Q--Q--Q--Q-----S----S?SQS---
----------------------------------------------------X----------[]------XXX-XXX-------------------------X------[]----------------------------
---------------------------------------------------XX----------[]-----XXXX-XXX-------------<>-X-------XXX-----[]----------------------------
-------------------------E-E---------------EE---E-XXX--E[--E-E-[]----XXXXX-XXXX------------[]XX-------XXXX----[]---E------------E-----------
XXXXXXXX-XXXXXXXXXXXXXXXXXXXXXXXXXXXXXXXXXXXXXXXXXXXXXXXXXXXXXXXXXXXXXXXXXXXXXXXXXXXXXXXXXXXXXX--------XXXXXXXXXXXXXXXXXXXXXXXXXXXXXXXXXXXXX