--------------------------------------------------------------------------------------------------------------------------------------------
--------------------------------------------------------------------------------------------------------------------------------------------
--------------------------------------------------------------------------------------------------------------------------------------------
--------------------------------------------------------------------------------------------------------------------------------------------
--------------------------------------------------------------------------------------------------------------------E-----------------------
-------------Q----------------------------------------------------SSSQ-----------------------SSSSSQ----Q-----SSS--SSSSSS--------SS----------
--------------------------------------------------------------------------------------------------------------------------------------------
------------------------------------------------------------------------------------------------------------E-------------------------------
--------------------------------------------------------------------------------------------------------------------------------------------
--<>-------S?S----S--Q---SSS------------QSQ------QS-Q--Q----S----S---------------SS--?--Q--SSS---------SS--?S-----------------S-------------
--[]----------------------------------------------------------------------------------------------------------------------------------------
--[]----------------------------------------------------------------------------------------------------------------------------------------
--[]--------E-E---E--E------------------------------------------------EEE]-----E-----E-----------EEE-E--E--E--------------------------------
XXXXXXXXXXXXXXXXXXXXXXXXXXXXXXXXX--XXXXXXXXXXXXXXXXXXXXXXXXXXXXXXXXXXXXXXXXXXXXXXXXXXXXXXXXXXXXXXXXXXXXXXXXXXXXX---XXX------XX-------------X