--------------------------------------------------------------------------------------------------------------------------------------------
--------------------------------------------------------------------------------------------------------------------------------------------
--------------------------------------------------------------------------------------------------------------------------------------------
--------------------------------------------------------------------------------------------------------------------------------------------
--------------------------------------------------------------------------------------------------------------------------------------------
----------------------------------------SQS-----------------------------------------SSQSSSS-------S-S------------------------QS-------------
--------------------------------------------------------------------------------------------------------------------------------------------
---------------------------------------E-----------------------------------------------------------------------------------E----------------
--------------------------------------------------------------------------------------------------------------------------------------------
------------------------------<>-----S?S------S?-Q--SSSQ----------------------------X--Q----------SS--------------<>-------S?S----S--Q--QSSQ
-----------------[]------<>---[]----------------------------------------------------------------------------------[]------------------------
--<>----<>-------[]------[]---[]-----------------------------------------<>-----------------------------------<]--[]------------------------
--[]----[---E----[]------[]---[]----------E-E-E--E-E---------------------[]-------E---------------------------[]--[]----------E-E-E--E------
XXXXXXXXXXXXXXXXXXXXXXXXXXXXXXXXXXXXXXXXXXXXXXXXXXXXXXXXXXXX---XXX-----XXXXXXXXXXXXXXXXXXX---XXXXXXXXXX--XXXXXXXXXXXXXXXXXXXXXXXXXXXXXXXXXXX