--------------------------------------------------------------------------------------------------------------------------------------------
--------------------------------------------------------------------------------------------------------------------------------------------
--------------------------------------------------------------------------------------------------------------------------------------------
--------------------------------------------------------------------------------------------------------------------------------------------
------------------------------E-E-----------------------------------------------------------------------------------------------------------
----------------------------SSSSSSSS----?----------------------------------------------SSSS--------SSSSS-----------------?------------------
--------------------------------------------------------------------------------------------------------------------------------------------
--------------------------------------------------------------------------------------------------------------------------------------------
--------------------------------------------------------------------------------------------------------------------------------------------
------------------------------------------S------------------------------<>--------------------------------------Q--Q--QS-Q-----------------
-------------------X-----------------------------------------------------[]-----------------------------------------------------------------
X------<>-X-----XXXX----------------------------XX-----<X-------<>-------[]------<>---------------------------<>----------------------------
--EE---[]XX-----XXXX----------------------------XX-----[E-E-----[]-------[]------[]----------------------------]-E---------E-E-E-----------E
XXXXXXXXXXXXX-XXXXXXXXXXXXXXXXXXXX----XX-------X--XXXXXXXXXXXXXXXXXXXXXXXXXXXXXXXXXXXXXXXXXXXXXXXXXXXXXXXXXXXXXXXXXXXXXXXXXXXXXXXXXXXXXXXXXX