--------------------------------------------------------------------------------------------------------------------------------------------
--------------------------------------------------------------------------------------------------------------------------------------------
--------------------------------------------------------------------------------------------------------------------------------------------
--------------------------------------------------------------------------------------------------------------------------------------------
--------------------------------------------------------------------------------------------------------------------------------------------
-QS?-----------------------------------------------SS-------------------------------SSSSSSSS--SSSS-----Q-----------------S------------------
---------------------------------------------------------------------------------------------------------------X----------------------------
--------------------------------------------------------------------------------------------------------------X-----------------------------
-------------------------------------------------------------------------------------------------------------X------------------------------
----------------------X--XXX?--Q-----Q----?S----S--------SS--------------<>-------------------------------XX--XX-SS-Q--?S-Q---------------X-
---------------------XX--XXX---------------------------------------------[]------<>-----------------------XX-XXX----------------X--------XXX
-----------------<---XXXXXXX---------------------------------------------[]------[]----------------------XXXXXXX---------------XXX-----XXXXX
-----------------[]--XXXXXXX----------------E--------E-E[-----------E----[]------[]----------------E----XXXXXXXX-E-----E-----EXXXX----XXXXXX
XXXX--XXX---XXXXXXXXXXXXXXXXXXXXXXXXXXXXXXXXXXXXXXXXXXXXXXXXXXXXXXXXXXXXXXXXXXXXXXXXXXXXXXXXXXXXXXXXXXXXXXXXXXXXXXXXXXXXXXXXXXXXXXXXXXXXXXXX