--------------------------------------------------------------------------------------------------------------------------------------------
--------------------------------------------------------------------------------------------------------------------------------------------
--------------------------------------------------------------------------------------------------------------------------------------------
--------------------------------------------------------------------------------------------------------------------------------------------
--------------------------------------------------------------------------------------------------------------------E-----------------------
---------------------------------------------------------------------Q------------------------------------------SSSSSSSS---S?SSSSSSSS---SSSS
--------------------------------------------------------------------------------------------------------------------------------------------
--------------------------------------------------------------------------------------------------------------------------------------------
--------------------------------------------------------------------------------------------------------------------------------------------
----------------XX-X--S-----------------------------------<>-------S------S--Q--Q--S--------<>-------XX---------X-------------SS------------
---------------XXXXXX-------------------------------------[]--------------------------------[]------XXX-------------------------------------
--<>---<>-----XXXXXXXX--------------------------------<>--[]----<>--------------------------[]-----XXXX------------------------------------<
--[]---[]XX--XXXXXXXXX-------------[------------------[]E-[]----[]--E-E---E--E------E--E--E-[]----XXXXX------------------------------------[
XXXXXXXXXXXXXXXXXXXXXXXXXXXXXXXXXXXXXXXXXXXXXX--XXXXXXXXXXXXXXXXXXXXXXXXXXXXXXXXXXXXXXXXXXXXXXXXXXXXXXXXXXXXXXXXXXXXXX---XXXXXXXXXX---XXXXXX