--------------------------------------------------------------------------------------------------------------------------------------------
--------------------------------------------------------------------------------------------------------------------------------------------
--------------------------------------------------------------------------------------------------------------------------------------------
--------------------------------------------------------------------------------------------------------------------------------------------
--------------------------------------------------------------------------------------------------------------------------------------------
--------------------------------?--------------------------SS----------------------------------QQ------------SSSSSQ-SSSS------SSSSSSS-------
--------------------------------------------------------------------------------------------------------------------------------------------
------------------------------------------------------------------------------------------------------------E-------------------------------
--------------------------------------------------------------------------------------------------------------------------------------------
-SS----<>--------XX--X----XX----------------------------------------------------------------<>------------S?S---X-------------SS----------->
-------[]-------XX---XX--XX-----------------------------------------------------------------[]----------------------------------------------
X------[]------XXXX-----XXXX----------------------------------------------------------------[]--------------------------------------------[]
[E---E-[]-----XXXXX---XXXXXX----------------------------------------------------------EE----[]---X-E-E------------------------------------[]
XXXXXXXXXXXXXXXXXXXXXXXXXXXX-------------------------------------------------------XXXXXXXXXXXXXXXXXXXXXXXXXXXXXXXXXXX---XXXXXXXXXX--XXXXXXX