--------------------------------------------------------------------------------------------------------------------------------------------
--------------------------------------------------------------------------------------------------------------------------------------------
--------------------------------------------------------------------------------------------------------------------------------------------
--------------------------------------------------------------------------------------------------------------------------------------------
----------------------------------------------------------------------------------------E---------------------------------------------------
---------SSSSQ---------------------------------------------------------------------XSSSSSSSS---------------------------------Q--------------
----------------------------------------------------------------------------------XX--------------------------------------------------------
---------------------------------------------------------------------------------XXX--------------------------------------------------------
---------------------------------------------------------------------------------XXX--------------------------------------------------------
--S-S--?S>---------S----X----------Q--Q----------------X-SS------------------XXX-XXX------------------------------<>-------S?-----S--Q---SSS
--------[]------X-------X------------------X----------XX----------------XX---XXX-XXX------------------------------[]------------------------
--------[]-----XXX-----XX-----------------XXX---XX----XX-------[]------XXX--XXXXXXXX--------------------------<>--[]------------------------
EE----E-[]----XXXX----XXX----------E--E--XXXX---XXX---XX[------[]------XXX-XXXXXXXXX---------------------------]--[]----------E-E-E--E------
XXXXXXXXXXXXXXXXXXXXXXXXXXXXXXXXXXXXXXXXXXXXXXXXXXXXXXXXXXXXXXXXXXXXXXXXXXXXXXXXXXXX----------------------------XXXXXXXXXXXXXXXXXXXXXXXXXXXX