--------------------------------------------------------------------------------------------------------------------------------------------
--------------------------------------------------------------------------------------------------------------------------------------------
--------------------------------------------------------------------------------------------------------------------------------------------
--------------------------------------------------------------------------------------------------------------------------------------------
--------------------------------------------------------------------------------------------------------------------------------------------
--------------------------------SSSS------------------S----------Q-------------------------------------------------------SSSSSQ----Q--------
--------------------------------------------------------------------------------------------------------------------------------------------
-----------------------------------------------------------------------------------X-------------------------------------E------------------
--------------------------------------------------------------------------------------------------------------------------------------------
-SS----QS-Q------------X----X-------------SS-------------SS----<>-Q-----XX--XX----XX-------------------X------------S--S?S---------SQ----SS-
---------------------------------------------------------------[]------XXX--XXX--XXX-------------------XX-------------------------------X---
---------------------XX----------------------------------------[]-----XXXX--XXXXXXXX--<>---------------XXX------------------------------X---
-E-----E-----E-E-E--XXXX--------------------------------[E---E-[]----XXXXX--XXXXXXXX--[]------------X-XXXX-------E-----------EEEEE--E--E----
XXXXXXXXXXXXXXXXXXXXXXXXXXXXXXXXXX----XXXXX--XX----XXXXXXXXXXXXXXXXXXXXXXXXXXXXXXXXXXXXXXXXXXXX----XXXXXXXXXXXXXXXXXXXXXXXXXXXXXXXXXXXXXXXXX