--------------------------------------------------------------------------------------------------------------------------------------------
--------------------------------------------------------------------------------------------------------------------------------------------
--------------------------------------------------------------------------------------------------------------------------------------------
--------------------------------------------------------------------------------------------------------------------------------------------
--------------------------------------------------------------------------------------------------------------------------------------------
--------------------------------------------------------------------------------SSSS------------------------------SSSSSS--------------------
--------------------------------------------------------------------------------------------------------------------------------------------
--------------------------------------------------------------------------------------------------------------------------------------------
----------------------------------------------------------------------------------------------------------S---------------------------------
---S-------S?S---<>--------------------X--X-X--X----------------------SS------------------------------------------------------S?------------
-----------------[]--------------------X--XX---XX-----------------------------------X----------------<>-------------------------------------
-----------------[]----------------<>-XX--XXX-XXXX----<>----------------------------X-<>----<>-------[]-------------------------------------
--[---------E----[]-------E----E---[]XXX--XXXXXXXXX---[]---------------------------E]-[]----[]-------[]--------------------E---------------[
XXXXXXXXXXXXXXXXXXXXXXXXXXXX---XXXXXXXXX--XXXXXXXXXXXXXXXXXXXXXXXXXXXXXXXXXXXXXXXXXXXXXXXXXXXXXXXXXXXXXXXXXXXXXXXXXXXXX---XXXXXX------XXXXXX