--------------------------------------------------------------------------------------------------------------------------------------------
--------------------------------------------------------------------------------------------------------------------------------------------
--------------------------------------------------------------------------------------------------------------------------------------------
--------------------------------------------------------------------------------------------------------------------------------------------
--------------------------------------------------------------------------------------------------------------------------------------------
SSQSSSS------SSSS-------S------------------------------------------SSS-----Q------SS--------------------------------------------------------
---------------------------------------------X----------------------------------------------------------------------------------------------
---------------------------------------------X----------------------------------------------------------------------------------------------
---------------------------------------------X----------------------------------------------------------------------------------------------
X--Q--Q-------QS-------------------<>-------XX-XX---------<>----SS---------S----S--------------------------------SSS-------------<>--------S
-----------------------------------[]------XXX-XXX--------[]------------------------X-----------------X--------------------------[]---------
-----------------------------------[]-----XXXX-XXX-----<--[]------------------------X-<>---<>--------XXX--------X-------<>-------[]---------
---------------------------E---E-E-[]----XXXXX-XXXX----[--[]---------EEE-E-----E------[]---[]X------XXXX--------E-------[]-------[]---------
XXXXXX---XXXXXXXXXX--XXXXXXXXXXXXXXXXXXXXXXXXXXXXXXXXXXXXXXXXXXXXXXXXXXXXXXXXXXXXXXXXXXXXXXXXXXX---XXXXXXXXXXXXXXXXXXXXXXXXXXXXXXXXXXXXXXXXX