--------------------------------------------------------------------------------------------------------------------------------------------
--------------------------------------------------------------------------------------------------------------------------------------------
--------------------------------------------------------------------------------------------------------------------------------------------
--------------------------------------------------------------------------------------------------------------------------------------------
------------------------------E-------------------------------------------------------------------------------------------------------------
----------------------------SSQ---?S--SSSSQ-SSSQS-----SX----------------------------SSS-SSSS--------------------------------SQQ-------------
-------------------------------------------------------X------------------------------------------------------------------------------------
-------------------------------------E------------------------------------------------------------------------------------------------------
--------------------------------------------------------------------------------------------------------------------------------------------
-SS----<>--------XX----------------S?S---------S---X------->-------SQS----Q--SSQQ--Q--------------S-------------S--Q--Q--S----------S?SQSSS-
-------[]-------XXX-------[------------------------XX--X---]--------------------------------------------------------------------------------
X------[]------XXXXX-----XXX----------------------XXX--X--[]--------------------------------------------------------------------------------
[------[]-----XXXXXX-X--XXXX-------------E-E-E--E-XXXX-X--[]--------------E----------------------------------------E----------E-E----E------
XXXXXXXXXXXXXXXXXXXXXXXXXXXXXXXXXXXXXXXXXXXXXXXXXXXXXXXXXXXXXXXXXXXXXXXXXXXXXXXXXXXX---XX-------XX---------X----XXXXXXXXXXXXXXXXXXXXXXXXXXXX