--------------------------------------------------------------------------------------------------------------------------------------------
--------------------------------------------------------------------------------------------------------------------------------------------
--------------------------------------------------------------------------------------------------------------------------------------------
--------------------------------------------------------------------------------------------------------------------------------------------
----E---------------------------------------------------------------------------------------------------------------------------------------
--SSSQ-----------------------SSSSSSS----------------SSSS-----------------------------------------Q--------------SQS-------------------------
--------------------------------------------------------------------------------------------------------------------------------------------
-----------------------------------------------------------------------------------------------E--------------------------------------------
--------------------------------------------------------------------------------------------------------------------------------------------
--------------------------<>X-------------SS------------S--Q-----S-----S---SS-------S--SS----S?S------S?-----S------------------X--X--------
--------------------------[]--------------------------------------------------------------------------------------------------XX---XXX------
--------------------------[]-------------------------------------------------------------------------------------------<>-----XXX--XXX-----<
--------------------------[]--------------------------------------------E--------EEE--------------E-E-E--E---EEE-------[]-E---XXX--XXXX----[
--------------------XXXXXXXXXXXXXXX---XXXXX---X---XXXXXXXXXXXXXXXXXXXXXXXXXXXXXXXXXXXXXXXXXXXXXXXXXXXXXXXXXXXXXXXXXXXXXXXXXXXXXXXXXXXXXXXXXX