--------------------------------------------------------------------------------------------------------------------------------------------
--------------------------------------------------------------------------------------------------------------------------------------------
--------------------------------------------------------------------------------------------------------------------------------------------
--------------------------------------------------------------------------------------------------------------------------------------------
--------------------------------------------------------------------------------------------------------------------------------------------
-------------------------------------------------------------------------------------------------------------------------?------------------
--------------------------------------------------------------------------------------------------------------------------------------------
--------------------------------------------------------------------------------------------------------------------------------------------
--------------------------------------------------------------------------------------------------------------------------------------------
-S-----------------SS----SS---S------X-------<X--X---XX-------------------X--------------------------------------SS-Q--?S-Q-----XX---X---X--
------------------------------------<>-------[]------XX------------------XX----------------------------------------------------XXX---X---XX-
----------------------------X-------[]-------[]----XXXX--------<>--------XX-----------<>--------------------------------------XXXX----XXXXX-
----------------E-----------E-E---E-[]-------[]----XXXX---EE---[]-------XXX-----------[]------------------------[E---E-E-----XXXXX----XXXXX-
XXXXXXXXXXXXXXXXXXXXXXXXXXXXXXXXXXXXXXXXXXXXXXXXXXXXXXXXXXXXXXXXXXXXXXXXXXXXXXXXXXXXXXXXXXXXXX----------------XXXXXXXXXXXXXXXXXXXXXXXXXXXXXX