--------------------------------------------------------------------------------------------------------------------------------------------
--------------------------------------------------------------------------------------------------------------------------------------------
--------------------------------------------------------------------------------------------------------------------------------------------
--------------------------------------------------------------------------------------------------------------------------------------------
--------------------------------E-----------------------------------------------------------------------------------------------------------
------------------------------SSSSS-------------------------------SSSSQ----------SSSSSQ-----------S-SSS-------------------------------------
--------------------------------------------------------------------------------------------------------------------------------------------
--------------------------------------------------------------------------------E-----------------------------------------------------------
--------------------------------------------------------------------------------------------------------------------------------------------
------------------------------------------X----X---------------SSS----------S?SQS------------S-----S---S-------X----------------------S-----
-----------------<X------<>---------------X----X--------------------------------------------------------------XX----------------------------
-------<>--------XX------[]]-------<-----------XX-----<>-----------------------------------------------------XXX----------------------------
-------[]-------XXXX----E[[]-------[]-EE-------XXX----[]-------------E-E------------------------------------XXXX----------------------------
XXXXXXXXXXXX--XXXXXXXXXXXXXXXXXXXXXXX-----XXX--XXXXXXXXXXXXXXXXXXXXXXXXXXXXXXXXXXXXXXXXXXXXXXXXXXXXXXXXXXXXXXXXXXXXXXXXXXXXXXXXXXXXXXXXXXXXX