--------------------------------------------------------------------------------------------------------------------------------------------
--------------------------------------------------------------------------------------------------------------------------------------------
--------------------------------------------------------------------------------------------------------------------------------------------
--------------------------------------------------------------------------------------------------------------------------------------------
--------------------------------------------------------------------------------------------------------------------------------------------
------------------------------------------S?S------SSSQS------------SSS---------QS--------------SQ------------------------------------------
--------------------------------------------------------------------------------------------------------------------------------------------
--------------------------------------------------------------------------------------------------------------------------------------------
----------------------------------------------------------------------------------------------------------------------------------E---S-----
-----------------<>-----------------------QS---------------QS----S---------SS---SSSQ-SS-S---SS--------SS-----SS------------------XX---------
-----------------[]------<>---------------------------------------------------------------------------------------------<--------XX---------
--------<>-------[]------[]-------------------------------------------------------------------------------------X-------[]------XXX---------
--------[---E----[]-----E[]---------------------------------------------E----E-E-E---E------------E-E-E--E-E----]-EE----[]------XXXX--------
XXXXXXXXXXXXXXXXXXXXXXXXXXXXXXXXXXXXXXXXXXXXXXXXXXXXXXXXXXXXXXXXXXXXXXXXXXXXXXXXXXXXXXXXXXXXXXXXXXXXXXXXXXXXXXXXXXXXXXXXXXXXXXXXXXXXXXXXXXXX