--------------------------------------------------------------------------------------------------------------------------------------------
--------------------------------------------------------------------------------------------------------------------------------------------
--------------------------------------------------------------------------------------------------------------------------------------------
--------------------------------------------------------------------------------------------------------------------------------------------
--------------------------------------------------------------------------------------------------------------------------------------------
----------------------------------------SSSQ-------SQSQS------------------------------------------------------------------------------------
--------------------------------------------------------------------------------------------------------------------------------------------
--------------------------------------------------------------------------------------------------------------------------------------------
--------------------------------------------------------------------------------------------------------------------------------------------
--<S--------?S---->---------Q--Q--Q--S----------S?--SSS---->-------------<>--------S--------------X----X---------SS-S---S--------<>---------
-----------------[-----------------------------------------]-------------[]--------------------X--XX--XX-------------------------[]------<>-
----------------------------------------------------------[]----<>-------[]---------X------<>-X----XXXXXX------------------------[]-----X[]-
--[]--------E-E--[]-------E----E------------E----E------E-[]----[]--E----[]-------E---EE---[]XXX----XXXXXX-------E----------E-E--[]-----XX]-
XXXXXXXXXXXXXXXXXXXXXXXXXXXXXXXXXXXXXXXXXXXXXXXXXXXXXXXXXXXXXXXXXXXXXXXXXXXXXXXXXXXXXXXXXXXXXXXX--XXXXXXXXXXXXXXXXXXXXXXXXXXXXXXXXXXXXXXXXXX