--------------------------------------------------------------------------------------------------------------------------------------------
--------------------------------------------------------------------------------------------------------------------------------------------
--------------------------------------------------------------------------------------------------------------------------------------------
--------------------------------------------------------------------------------------------------------------------------------------------
----------------------------------------SXSXSXSX--------------------------------------------------------------------------------------------
-------------------Q--------SQQ----SSSSXSX--------------------------------------------------------------------------------------------------
---SX-----------------------------------------------------------------------------------------------------------XX----------------------SXS-
-XXXX-------------------------------------X-------------------------------------------------------------------------------------------------
--------------------------------E---------------------X-----E-------E--------E------SX-------------SXSX-------------------------------------
XXX------------QS--------Q-QS--<?S-------------------XX----[]---------------<>------------XXX-----------------------------X-----------------
XXX-------->------E-E----------[-S-------------------XX-E--[]-----E--E------[]-XXXX---------------------------------------------------------
XX---S-------------<>----------[]------------------XXXX----[]----<>---------[]--------------------------------------------XXXXX-------------
XXX--SX-----EX-----[---------E-[]---------EE-E--EEXXXXX----[]-E--[]------E--[]---------------------------------X----------XX----------------
XXXXXXXXXXXXXXXXXXXXXXXXXXXXXXXXXXXXXXXXXXXXXXXXXXXXXXX-XXXXXXXXXXXXXXXXXXXXXXXX-X--XXXXXXXXXXXXXXXXXXXXXXXXXXXX-------XXXX------XXXXXXXXXXX