-------------------------------------------------------------------------------------------E------------------------------------------------
--------------------------------------------------------------------------------------------------------------------------------------------
---------------------------------------------SSSSSSSSSSS----------------------------------SSSSSSSSSSSSSSSSSSSSSS----------------------------
-----------------------------------------------------------------------------------------SSSSSSSSSSSSSSS------------------------------------
-------------------------------------------------------------------------------------------SSSSSSSSSSSSS----------------------XSXSXS--------
---------------------XSXX--------------------------------------------------------------S----?SSSSSSSSSSS------------------------------------
-------------------------------------------------------------------------------------SSSX---------------------------------------------------
------------------------------XXXX---------------------------------------------------[]XX-------------------------------E-------------------
--------------------------------------E--SX------------------------------------X----?X------------------------SX----------------------------
-QQQQQ-------SS----------------------<>----------X----------------------------------X-----<>--SSSSSSSSS------SSS----S-SSS-----------------E-
----------------------------------E--[]---------E-----------------------------XX----------[]---SSSSSSS-----------------------------------<>-
-------------------------------------[]--------<X-----------------------------XXX--------S[]----SSS----->---------------X----------------[]-
---------------E-E-------------------[]-----X--[]X----------------------------XX----X----SXS--SSSSS----[]-E------------------E--E-EE---[][]-
X--XXXXXXXXXXXXXXXXX---------XXXXXXXXXXXXXXXXXXXXXXXXXXXXXXXXX--XXXXXXXXXXXXXXXXXXXXX-XXXX-XXXXXXXXXXXXXXXXXXXXXXXXXXXXXXXXXXXXXXXXXXXXXXXXX