--------------------------------------------------------------------------------------------------------------------------------------------
--------------------------------------------------------------------------------------------------------------------------------------------
--------------------------------------------------------------------------------------------------------------------------------------------
--------------------------------------------------------------------------------------------------------------------------------------------
--------------------------------------------------------------------SX----------------------------------------------------------------------
--------------------------------------------------------X------S----EX----Q---------SSS-----------------S-----------------------------------
--------------------------------------------------------------------------------------------------------------------------------------------
-----------------------------------------------------------------------S------------------------------------XX------------------------------
--------------------------------------------------------Q--<>-------E--------E----XX------------S-------------------------------------------
--------------------------------X---------------------X----[]-----------QQ--S--X-XX-SQQQQQQ-------------------------------------------------
-----------------------------------------------------XX-?E-[]-----E--E---------XXXXX--------------------------------------------------------
-----------------------------------------------------XX-]--[]----<>SS-------XXXXXXX-------------------------XXXX----------------------------
----------E-E-------E--------EE-E--------EE-E-------EXX----[]----[-------E--XXX-XXX----------------E----------------------E-E-------E-------
XXXXXXXXXXXXXXXXXXXXXXXXXXXXXXXXXXXXXXXXXXXXXXXXXXXXXXXXXXXXXXXXXXXXX-XXXXXXXXXXXX--XXXXXXXXX-XXXXXXXX----------XXXX-XXXXXXX----------XXXXXX