--------------------------------------------------------------------------------------------------------------------------------------------
--------------------------------------------------------------------------------------------------------------------------------------------
------------------------------------------------------------------------------------SSSSSSSSSSSSSSSSSSS-------S-----------------------------
----------------------------------------------------------------------------------------X---------------------------------------------------
----------------------------------------------------------------------------------------------------------------------------SXSXSXSX--------
-------------Q----Q-----------------------------------------------SSSQ------------------------------------------XQQ----SSSS-SX--------------
--------------------------------------------------------------------------------------------------------SXSX--------------------------------
------------------------------------------------------------------------------------------------------------XX-----------------S------------
----------------------------------------------------------------------------------XX-----------------------XXX------E---------------------XX
----E-----------QQQQQQQ---------------E---------XXX--------<>--------------------XXX----------E--SX------XXXXX--?--<>------------QQ------XX-
---<>--------------------------------<>--------XXXX--------[]-------------------XXXX---------<----------XXXXX------[]--------------------XX-
---[]------S-------------------------[]---------XXX--------[]------------------XXXXX-------------------XXXXXX---]--[]------SE----------EXXX-
E--[--[]---------E----E---------E-E--[]-----X--XXXX--------[]---------EE-------XXXXX---------E------XXXXXXXXXX-->E-[]---------EE-E--EEEXXXX-
XXXXXXXXXXXXXXXXXXXXXXXXXXXXXXXXXXXXXXXXXXXX----X-XX-XXXXX-XXXXX------XXXXXXXXXXXXXXXXXXXXXXXXXXXXXXXXXXXXXXXXXXXX-XXX----XXXXXXXXXXXXXXXXX-