--------------------------------------------------------------------------------------------------------------------------------------------
--------------------------------------------------------------------------------------------------------------------------------------------
-------------------------------------------SS----------E------------------------------------------------------------------------------------
-XXXXX------------------------------------------------<>------------------------------------------------------------------------------------
-----------------------------------------S------------[]------------------------------------------------------------------------------------
--------------------------------------------------E----X---------------------------------SSSS-----------------------------------------------
-----------------------------S--------------------------------------------------------------------XXXX---------X----------------------------
--------------------------------------------------------------------------------------------------E-----------------------------------------
----E-------E---------------SSS------S-SXSXSXSX-------------E-------E-------------------------------XXXX-----------------------------E------
---SX------------------X-----------------------------------<>---------------S----XX-XX-X-XXXX---------------------------------------<>------
-----------------------X-----------------------------------[]------------------XXXX-XXX---------E-----E---------E--<>-----E---------[]-XXXXX
---<>---<>------------XX-----------------------------------[]--------------------XX-XX------S-SXX------------------[]----<>---------[]------
---[]---[]-----------XX------------------------------------[]----E-----------EE--XX-XX-X----S--XX------------E-----[]-E--[]---------[]------
XXXXXXXXXXXXXXXXXXXXXXXX-X--XXXXXXXXXXXXXXXXXXXX------XXXXXXXX-XX-XXXXXXXXXXXXX--XX-XXXXXXXXXXXXXXXXXXXXXXXXXXXXXXXXXXXXXXXXXXXXXXX-XXX-----