--------------------------------------------------------------------------------------------------------------------------------------------
--------------------------------------------------------------------------------------------------------------------------------------------
--------------------------------------------------------------------SSSSSSSSSSSSSSSS-------------------------------XSX----------------------
----------------------------------------------------------------------------------------------------------------XXXXXXX---------------------
--------------------------------------------------------------------------------------------------------------------XXX---SXSXSXSX----------
---------------------------------XX-------------------------------------S--------------------------------------------XXS--------------------
-----------------------------------------------------------SX--------------------------------------------------------XX---------------------
-----------------------------------------------------SX-------------------------------SXXX--------------------------------------------------
------------------------------------------------------------------E------------------------------SXSX----------------------------------XX---
-----------------------------SS-S------XXX----------X------------S>--SSSS---X------Q------------------------------SSXS-----XXXXX-------X----
-------------------------------------------------X-XXXX--------------SS-----XX-------------------------------------------E------------XXX---
-------------------------------------------------X-XXXXX--X----------SS-----[X----------------------------------X-------<>------------XXX---
-------------------------------------------------X-XXXX---X---E--EE-[]-----[]]--------------------------E------X--E-----[]-S-------E--XXX---
XXXXXXXXXXXXXXXXXXXXXXXXXXXXX-----XX-----------XXXXXXXXXXXXXXXXXXXXXXXXXXXXXXXXXXXXX------XXXXX-----X-------XXXXXXXXXXXXXXXXXX-XXXXXXXXXXX-X