--------------------------------------------------------------------------------------------------------------------------------------------
--------------------------------------------------------------------------------------------------------------------------------------------
----------------------------------------------------------------------------------------------------------------SSSSSSSSSSSSSSSSS-----------
---------------------------------------------------------------------------------------------------------------------------------------XXXXX
-------------------------------------------------------------------------------------X------------------------------------------------------
----------------------------------------------------------------------?------------S-----------------------------------------------E---XX---
--------------------------------------------------------------------------------XS---------XX----------------------------------S---XXX-X----
--XXXX----------------------------------------------------------------------------------------------------------------------------------XX--
-------------SX-----------------------------------------------------------SX--------------------------------------------------SXS------XXX--
--XX---------------------------------------------X--X--X-E------XXX------------S----------S-------------------<>-SSS-------XXXXX------XXXX--
------E--X----------E-------------------------------X-XX<>------------XX---E----------------------------------[]---------------------XXXXX--
--X------XX--------<>----------------------------X--XXXX------------------<>----------------------------------[]---------------------XXXX---
--XX-----XX--------[]E--------------------------EX--XXXXEE----------------[]------E-------------------------E-[]-----------S------XX--XXX---
--XX-XXXXXXXXXXXXXXXXXXXXXXXXXXXXXXXXXXX-XXXXXXXXXXXXXXXXXXXXXXXXXXXXXXXXXXXXXXXXXXXXXX--XXXX----XXX---XXXXXXXXXXXXXXX--XXXX--XXXXXXX-------