--------------------------------------------------------------------------------------------------------------------------------------------
--------------------------------------------------------------------------------------------------------------------------------------------
----------------------------------------SSSSSSSSSSSSSSSS------XSXS----SSS-------------------------------------------------------------------
-----------------------------------------------------------------SS-SSSSS---------XX--------------------------------------------------------
--------------------------------------------------------SS------SS---SSS--------------------------------------------------------------------
------------------------------------------S-S--------------------S-SSSSS--------------------------------------------SSS--------------------S
-------------------------------SX------------------------S--------------------------------------------------------------------------------S-
-----------------------------XXXXX-----------------------S-----------------------XX---------------------------------------------------------
--------------------------------------E--SX-------------SSS------SSSSSSSS--------XX--------------XXX----------------------------SXSX--------
------S-S-------------------X-X------S--SSSQ---------QQQ-------XXXSSS-----------X-------------E------------------E---------------------S----
---------------------------------------S--------E-------------------------------X------------<>-----------------<>-------------E------------
--------------------------------SS-------[]----<>------------------------------XXXXX---------[]-----------------[]--------------------------
----------------E-EE--------X-XSSSX---S-[]-----[]-------------------------------X--X---------[]---------E-------[]--------------------------
XXXXXXXXXXXXXXXXXXXXXXXXXXXX--XXXXXXXXXXXXXXXXXXXXXXXXXXXXXXXX---XXXXXXXXXXXXX--XXXX-XXX-----XXXXX-----XXXXXXXXXXXXXXXXXXXXXXXXXXXXXXXXXXXXX