--------------------------------------------------------------------------------------------------------------------------------------------
--------------------------------------------------------------------------------------------------------------------------------------------
SSXSXSXSXS-----------------E----------------------------------------------------------------------------------------------------------------
--------------------------<]----------------------------------------------------------------------------------------------------------------
---------------------------]----------------------------------------SX----------------------------------------------------------------------
------------SS---------XXXXX-----SS------SQS---------S--------------SX------------------------------S----------------S--------SSSS----------
--------------------------------------------------------------------------------------------------------------------------------------------
-------------S----------XX------------------------------------------------------------------------------------------------------------------
----------SXSSSSS-------------------------------------------E---------------------XX----------------------------SE--------------------------
-QQQQQ---------------------------X-XXX---------------------<>-------------------XXXX---------------SS---------XX-----XXXXXX---S-------------
-----------------------------------------------------------[]-------------------XXXX------------------------XXXX----------------------------
------------------------XXXX-------------------------------[]-----------------XXXXXX------SS-----------------XXX----------------------------
---------------E------------------------------E------SS----[]---------EE----EEXXXXXX------S------------------XXX---------------E--E-------E-
XXXXXXXXXXXXXXXXXXXX--------XXXXXXXX---XXXXXXXXXXXXXXXXX-XXXXX-XX-XX--XXXXXXXXXXXXXXXXXXXXXXXXXX-XXXXX-XXXXXXXXXXXXXXXXX---XXXXXXXXXX-XXXXXX