--------------------------------------------------------------------------------------------------------------------------------------------
--------------------------------------------------------------------------------------------------------------------------------------------
-------------------------------XS----------------------------------------------------------SSSSSSSSSSSSSSSSSSSSS----------------------------
---------------------------------E----------------------------------------------------------SSSSSSSSSSSS------------------------------------
--------------------------------------SXSXSXSX-----------------------------------E----------SSSSSSSSSSSS------------------------------------
---------------------------------XXS---------------------------------SXSX----X--SSSS--------SSSSSSSSSSSS------------------------------------
---------------------------------X-------------X--------------------------------------------------------------------------------------------
----------------------------------------------------X-------------------------------------------------------------SXSX----------------------
---------------------E---------------------------------------------------------------------------------------XSXSX-----------S-SXSX---------
--------------------<>------SSSSSS-----XXXX---------XX------------------------------------<>--SSSSSSSSS------XSSX-----XXX-------------------
----------E---------[]---------------------------XXXXX------------------------------------[]---SSSS-S-------EX------------------------------
---------[]---------[]------[]-------------------XXXXX------------------------------------[]---SSSS---------XXXX--------S-------------------
---EE-E--[]---------[]------X----------S-------E-XXXX-----------------------------S-------[]---SSSS----[E-E---XX---XS-------E------------E--
XXXXXXXXXXXXXXXXXXXXXXXX----XXXXXXXXXXXX--XXXXXXXXXX----------XX----------------------XXXX-XXXXXXXXXXXXXXXXXXXXXXXXXXXXXXXXXXXXXXXXXXXXXXXXX