--------------------------------------------------------------------------------------------------------------------------------------------
--------------------------------------------------------------------------------------------------------------------------------------------
-------------------------------------------------------------------------------------------------------------------XS-----------------------
--------------------------------------------------------------------------------------------------------------------------------------------
-----------------------------------------------------E----------E---------------------------------------------------------SXSXSXSXSX--------
----------------------------------------X------------SS---SSSSSS-----SQ-----------------------SSSQ--S-S----------------SS---SX-------XSX----
---------------------------------------------XX---------------------------------------------------------------------------------------------
------------------------------------------------------------------------------------------------------------------------------XS------------
-------------------------------------------------------S-E--------------SXSX----------------------------------------E----?--E---------------
----------------------------------------------------XXXXXX---XXX-----------------------------EXS----QQQQ--------S--<>------------Q----------
-----------------------------------------------------------------------------------------------------------------E-[]S-----------------E----
------------------------------------------X---------------------------------------------------------------------]--[]------SS---------<>----
-------------------------------------------------------------E-------------------SE-EE-E-----------EEE-----------[][]---SS----E--E-E--[]----
X-------XXXXXX----XXXXXXXXXX-------------------XXXX----XXXXXXXXXXX--XXXXXXXXXXXXXXXXXX-XXX--XXXXXXXXXXXXXXXXXXXXXXXXXXXXXXXXXXXXXXXXXXXXXXXX