--------------------------------------------------------------------------------------------------------------------------------------------
--------------------------------------------------------------------------------------------------------------------------------------------
----------------------------------------------------------------------------------------------------------------SSSXSSSSSSSSSSSSS-----------
--------------------------------------------------------------------------------------------------------------------X-X---------------------
--------------------------------------------------------------------------------------------------------------------------------------------
---------------------------S--------SSSSSSSSSS?S---------------------Q--E?SS-------------SSSS--------S?Q-------------------------------XX---
---------------------------------------------------------------------------------------------------------------X--------------------SX------
-----------------------------E-------------------------------------------------------X--------------------------------------------------X---
----------------SXSX--------?X------------------------S---------------------------EX----------------XSX--------------------------------XXX--
<>------XX------------SS----X-----<>---SS--QSSS---Q--SQS----E-<>---E----SQSQQ----<>-XX----XXX------Q-------------SS---------XXXX------XXXXXX
[]---------------------------------]--------SS-------------<>-[]-----------------[]-XXX-----------------------------------------------XX----
[]--------------------------X-----SS-----------------------[]-[]---S-------------[]-XX------------------------------------------------XX----
[]--------------------------X----SXS--------------------E-[]--[]-----------------[]-XX----------E------------E-------------------XXX--XX----
XXXXXXXXXXXXXXXXXXXXXXXXXXXXXXX-XXXXXXXXXXXXXXXXXXXXXXXXXXXXXXXXX-XX--XXXXXXXXX---X-XXXXXXXXXXXXXXXXXXXXXXXXXXXX---XXX--XXXX----------------