--------------------------------------------------------------------------------------------------------------------------------------------
--------------------------------------------------------------------------------------------------------------------------------------------
--------------------------------------------------------------------------------------------------------------------------------------------
--------------------------------------------------------------------------------------------------------------------------------------------
--------------------------E--------------------------E--------------------------------------------------------------------------------------
XSSSS-------------------S-X-SSS-------XSXSXSX---SX--SSSS-------------------------------------------------------------X----------------------
SSSS-----------------XX----------------------XX---------------------------------------------------------------------XXX---------------------
---------------X----------------------------------------------------------------------------------------------------------------------------
XSX----------XXXXXX------------------------------------S------------------------------------------------------------------------------------
--XX-----------------XXXXX----------------------------X--------------------------------------------------------------------XXXXX--------XXXX
--------------------------------------------------------------------------------------------------------------------------------------XXXX--
--SX--------------------------------------------------------------XXXXX--------------------------------------------------------------XXXX---
--S------------------------S------------------------------------------------------------------------------E--------------------------XXXXX--
---------------------------X----------------------------XXXXXXXXXXX-----XXXXXXXXXXXXXXXXX----XXXX---XXXXXXXXXXXXXXXXX-------------XXXXXXX--X