--------------------------------------------------------------------------------------------------------------------------------------------
--------------------------------------------------------------------------------------------------------------------------------------------
-------------------------------XSX----------------------------------------------------------------------------------------------------------
--------------------------------------------------------------------------------------------------------------------------------------------
--------------------------------------SXSXSXSXSX--------------------------------------------------------------------------------------------
----------------------------X------SS---SX------------X-------------------------------------------------------------------------------------
-------------------------------------------S----------X-------------------------SXSX--------------------------------------------------------
------------------------------------------XSS--------------------------------------X--------------------------------------------------------
--------------------------------E----?--E------------XXX---------------------------------------SX---SX------------------------XX------------
-------------------------------<>---------------S--XXXXX-XXX-----------------E--------------------------------------------------------------
---------------------------->E-[]--------E---------XXXXXXXX--------X------------------------------------------------------------------------
----------------------------]--[]------SS--------XXXXXXXXX--------XXXX----------------------------------------------------------------------
---EE----E------------E------[-[]---SE----------XXXXXXXXXXX------XXXXX-------------------E--------------------------------------------------
XXXXXXXXXXXXXX-XXXXXXXXXXXXXXXXXXXXXXXXX--XXXXXXXXXXXXX-XXXXXXXXXXXXXXXXXXXXXXXXXXXXXXXXX-------XXXXXXXXXXX----XXXXXX---XXXXX--XXXXXXXXX--XX