--------------------------------------------------------------------------------------------------------------------------------------------
------------------------------------------------------------------------------------------------S-------------------------------------------
------------------------------------------------SSSSSSSS--SXS-------------------------S-SSSSSSSSSSSSSSSSSSSSSSSS----------------------------
----------------------------------------------------------------------------------------------SSSSSSSSSS------------------------------------
--------------------------------------------------------------------------------------------S-SSSSSSSSSS------------------------------------
---------------------------S----------------------------SQ------------------------X-----------SSSS------------------------------------------
----------------------------------------------------------------------------------X---------------------------------------------------------
------------------------------XXX-----------------------------------------------XXX--------------------------------------------------------X
------------------SX------------------E---E---------------------------S---------XX-------------------------XXXSX----------------------------
-E------XXX------------S------X------<>--<>E----XE------SSSSSS------------------XX------E-------SS-SSXS-S--X--S--------------------QQQQ-----
<>-------------E----------E>------E--[]--------X<>-----E---------------------XXXXX-----<>-------SSS-------XX------------------------------E-
-]----------------------------X------[]--[]-----[]---------------------------XXXXXX----[]------SSSS-----X-XXXXX-----------------------------
[]----------------EE------E---X------[]-[]--X--X[]-----X-----------E---E---E-XXXXX-----[]---------S--XXXX-X---X----E--E--EE-----------------
XXXXXXXXXXXXXXXXXXXXXXXXXXXX-XXXXXXXXXXXXXXXXXXXXXXXXXXXXXXXXXXXXXXXXXXXXXXXXXXXX-----XXXXXXXXXXXXXXXXXXXXXXXXXXXXXXXXXXXXXXXXXXXXXXXXXXXXXX