--------------------------------------------------------------------------------------------------------------------------------------------
--------------------------------------------------------------------------------------------------------------------------------------------
--------------------------------------------------------------------------------------------------------------------------------------------
--------------------------------------------------------------------------------------------------------------------------------------------
--------------------------------------------------------------------------------------------------------------------------------------------
----------------------------XQQ----SSSSSSQ--------------X------------Q---------------------------------------------SS--------SQ---------SSSS
------------------------------------------------------X--------------------------------------------------------------------E----------------
------------------------------------------------------X-------------------------------------------------------------------------------------
-----------------------------------------------------XX----------------------E----XX--------------------------------------------------------
-------XXX------------------S--Q?--------S-----------XX-----E-----------SX--X----XXX--------------------------------------------------------
-----------------------------------------------------XX-E--<>-----E--E-----XXX-XXXXX--------------------------------------XXXXXX---E-E------
---------------------------------------------------XXXXX---[]----<>---------XXXXXXXX----------------------------------------------SX--------
-----------------------------E-EE--------EEE----EE-XXXXX---[]-[]-[]---------XXX--XXX------------------------------------------------------E-
XXXXXXX--XXXXXXXXXXXXXXXXXXXXX-XXXXXXXXXXXXXXXXXXXXXXXX--XXXXXXXXXXXXXXXXXXXXXX-XXXXX----XXXXXXX-----------XXXXXXXX---X-----------XXXXXXXXXX