--------------------------------------------------------------------------------------------------------------------------------------------
--------------------------------------------------------------------------------------------------------------------------------------------
----------------------------------------------------------------------------------------------------------------SSSSSSSSSSSSSSSSSSSS-----SSS
--------------------------------------------------------------------------------------------------------------------------------------------
--------------------------------------------------------------------------------------------E-----------------------------------------------
------------------------------------SS----SSS-SQ-----------SSS-----------X------------SSSSS----------------------------------S-------------X
--------------------------------------------------------------------------------------S-----------XXEX-------------------------S------------
-----------------------------XX-------------------------------------------------------SSSX--------E---------------------------S---------XXX-
----------E-------------------------------------------------------------SX-------------------------XXXX-----------------------E--------XXXXX
---------<>----------E------X--------------QSS-------SQS-------------------------------X-XXX---------------------------------SXS----XXXXXXXX
---------[]---------<>-----------------------SS-------------------XXXX-----------------------X-XE----------------------------S------XXXXXXXX
---------[]---------[]------------SS-------------------------------------------------X-X----SXSXX------------------------->--------XXXXXXXXX
---------[]---------[]------X-----S-----E--------------------------------------------XSX---SSX---------------E-----E-----[]-----X-XXXXXXXXXX
XXXXXXXXXXXXXXXXXXXXXXXXXXXXX-X-XXXXXXXXXXXXX-X-XXXXXXXX--------XX------------XXXXX-X-XX-XXXXXXXXX-XXXXXXXXXXXXX-XXXXXXXXXXXXXXXXXXXXXXXXXXX