--------------------------------------------------------------------------------------------------------------------------------------------
--------------------------------------------------------------------------------------------------------------------------------------------
--------------------------------------------------------------------------------------------------------------------------------------------
--------------------------------------------------------------------------------------------------------------------------------------------
------------------------------------------XSXSXS--------------------------------------------------------------------------------------------
---S-------------X-------------------------------------------SSSS-----S--SS--------S--SSSSS----------X-------------------------------------S
-----------------------------------------------------------------------------------------------E--XXXX--------SS----------------------------
------------------------------------E----------------------------------------------------------------X----------------------------------S--X
--S------------XXXX-------------------------------------SE--------------SXSX------------------------SXSX------------------------------------
---X----------------------------SSSSS-----------------E-<>----XXXXX--------------------X-XXX-----------------------------------------SSS----
------------X----------------------------------------<>-[]--------------------------XX-------XXXXXXX-----E----------------------------------
-----------------------------------------------------[]-[]--------------------------XX-X------XXX-------------------------------------------
-----E-------------------E-E-E-----------E--E-EE---[][]-[]----------------E-------E--X-X-----XXXXX-----------EEEEE----S---------------------
XXXXXX---XXX---XXXXXXX---XXXXXXXXXXXXXXXXXXXXXXXXXXXXXXXXXXXXXX------XXXXXXXXXXXXXXXXXX--XXXXXXX---XXXXXXXXXXXXXXXXXXXXXXXXXXXXXXXXXXXXXXXXX