---------------------------------------------------------------E----------------------------------------------------------------------------
----------------------------------------------------------X-Q----------------------E--------------------------------------------------------
--------------------------------------------------------------SSSSSSSSSSSSSS------<>--------------------------------------------------------
-------------------------------------------------------------SSSSSSSSSSSSSSS------[]--------------------------------------------------------
------------SX-----------------------------SX-----------SS-----SSSSSSSSSSSSS----------------------------------------------------------------
X-----------SX----Q----------S---------XX------XXX--------------?SSSSSSSSSSS--E----X-----------------------XXX-------------------X----------
-----------------------------------XX--------------------SS---------------------------------------------------------------------------------
---------------------------------------------------------SXXX--------------------X----------------------------------------------------------
---<>-------E--------E----------------------------------SXS--------SXSXSX--------XXX-------------X------------------------------SX----------
---[]-----------SXS-S--X--------------------------------X------?XSSSS-SSSS------X-----------------------------XX----------------------------
?--[]-------SE---------X--------------------------------------------------------X--X--------------------------------------XXXX--------------
---[]------SSS--------XX-------------------------------------------------------XXXXX--------------------------------------X-----------------
---[]------------E--E-X---------------------------------------------E-------E---XXXX--------------------------------------------------------
-XXXXXXXXXXXXXXXXXXXXXXXXXXX----------------------------XXXXXXXXXXXXXXXXXXXXXXXXXXXX------------------------------------XX-------XX-XXXXXXXX