--------------------------------------------------------------------------------------------------------------------------------------------
--------------------------------------------------------------------------------------------------------------------------------------------
--------------------------------------------------------------------------------------------------------------------------------------------
------------------------------------------------------------X-XX----------------------------------------------------------------------------
----------------------------------X---SXSXSXSXSX--------------------------------------------------------------------------------------------
--------------------------------------------------------------------------------------------------------------------------SSSQ--E?SS--------
------------------------XX------------------------------XXXXXE------------------------------------------------------------------------------
------------------------S--X----------------------------------------------------------------------------------------------------------------
--------------------------------E----?--E--------------------------------------------------------------------------------------------E----EX
-------------------SQSS-----X--<>---------------S-----------------E---------X----------------------------E------------<>---E---SS?SQQQQ--<>-
---------------E------------>E-[]------------------E-<>----------<>----------X---------------<>---------<E---------]--[]------S-SX-------[]-
----------------------------]--[]-------E----------[-[]----------[]---------XX---------------[]---------<>--------[---[]---S-S-----------[]-
E-EE------E------------------[-[]---SS----E-EE-E--[]-[]---------------------XXX-------E------[]---------[]------X-X---[]-----------------[]-
XXXXXXXXXXXXXXXXXXXXXXXXXXXXXXXXXXXXXXXXXXXXXXXXXXXXXXX-XXXXXX---XXXXX---XXXXXXX-XXXXXXXXXXXXXXXXXXXXXXXXXXXXXXXX-XXXXXXXXXX-XXXXXXXXXXXXXXX