-----------------------------------------E--------------------------------------------------------------------------------------------------
--------------------------------------SSSSS-------------------------------------------------------------------------------------------------
----------------------------SSSSSSSSSSSSSSSSSSSS------SS------------------------------------------------------------------------------------
-----------------------------------SSSSSSSSSSSSSS------X------------------------------------------------------------------------------------
------------------------------------SSSSSSSSSSSS--------------------------------------------------------------------------------------------
-----------------------------------SSSSSSS------------XX-------------------S------------------X---------------------------------------------
-------------------------------------------S----------X-------------------------------------------------------------------------------------
------------------------------------------SS--------XX--------------------------------------------------------------------------------------
---------------------E----------E-----------S------XXXXX------------------------------------------------------------------------------------
----------E---------<>---------<>-------SSXSSX----XXXXXX------<>--------ES--------XX---------------------------E----------------------------
---------<>---------[]---------[]------ESS--------XXXXXX------[]----------------XXXX-------------------E------<>----------------------------
---------[]---------[]---------[]------SSS-----XXXXXXXXX------[]------------------XX------------------SX------[]----------------------------
----E-E--[]---------[]---------[]------S-----XXXX-XXXXXXX-----[]-----------------XXX--------------------------[]----------------------------
XXXXXXXXXXXXXXXXXXXXXXXXXXXX--XXXXXXXXXXXXXXXXXXXXXXXXXXXXX-XXXXXXXXXXXXXXXXXXXXXXXX------X------------XXXXXXXXXXXXX-XXXXXXXXXXXXXXXXXXXXXXX