--------------------------------------------------------------------------------------------------------------------------------------------
--------------------------------------------------------------------------------------------------------------------------------------------
------------------------------------------------------------------------------------SSSXSXSSSSSSSSSSSS--------S-----------------------------
------------------------------------------------------------------------------------XXXXXXX--------------------X----------------------------
----------------------------------------------------------------------XSX-X-----------------------------------------------------------------
SSS----------------XXXSX-E-------SSSS--------SSQ-------------------X-----------------------------X------------XX--SSSSS----------X----------
---------------------------------------------------------------------------------------------------S----SE----X---------------XX-X----------
-----------------------------------------------------------------------------------------------E--SSS-------XXX------------------X----------
-------------X--------------SX--------------SSX------------------------------------------------------------XXXX-----------------SX-X--------
-QQQQQQ---------------------<X----XXXX-----S------------------SSS----------------------SX--------SXS----X-XXXXXX----------------------------
----------------------------XX-------------------------------------------------------------------?------XXXXXXXX----------XXXX--------------
----------------------------X----------------------------------------------------------<>----<---------XXXXXXXXX---X------X-----------------
---------------E------------X------------------------E-------------------------[E------[]---[]-S----XXXXXXXXXXXX----------------------------
XXXXXXXX--XXXXXXX-----------XXXXXXXXXXXXXXXXXXXXXXXXXXXXXXXX--XXX--XXXXXXXXXXXXXXXXXXXXXXXXXXXXXX-XXXXXXXXXXXXXX----------------------X-X--X