--------------------------------------------------------------------------------------------------------------------------------------------
--------------------------------------------------------------------------------------------------------------------------------------------
------------------------------------------------------------------------------------------------------------------SXSX----------------------
--------------------------------------------------------------------------------------------------------------------------------------------
--------------------------------------------------------------------------------------------------------------------------SXSXSXSX----------
----------X--SXSX-------SSSS------------------------------------------------------------------------------------XQQ----SSS------------------
--------------------------------------------------------XXXX--------------------SX----------------------------------------------------------
------------------------------------------------------------------------------------------------------------------------------XS------------
-------------------------------------------------E---------------------------------------------------------------------------------------XX-
--------------------------------------------Q---<>----------------X-------------------------------------SSS-----S-SSXS------------------XXX-
-------------XXX---------------E---------E------[]---------------X--------------------------------------------E------S----------------XXXXX-
------------------SX----------<>----------------[]---------------XXXXXX--------------------------------------------------------------XXXXXX-
--------------------------S---[]--[]-EE---------[]----------------XXX--------E------E--E------------E--E-----[----E-----SS-E-------E-XXXXXX-
XXX---------XXX---XXXXXXXX-X-XXXXXXXXXXXXXXXXX--XXXXXXXXXXX--XXXXXX------XXXXXXXXXXXXXXXXXXXXXXXXXXXXXXXXXXXXXXXXXXXXXXXXXXXXXXXXXXXXXXXXX--