--------------------------------------------------------------------------------------------------------------------------------------------
--------------------------------------------------------------------------------------------------------------------------------------------
---------------------------------------------------------S------SS--------------------------------------------------------------------------
--------------------------------------------------------------------S-------------------------------E---------------------------------------
--------------------------------------------------------------------S-----SX--------XXXXXXX-----XXXSXSX-------------------------------------
--SSSSS-------------------------------------------------X------SSSSSSX--------------X?--------XX-------XX----------S---------SXS------------
-----------------------------------------------------------------------------------------XXXX-----------------------------------------------
--------------------------------------------------------------------------------------------------------------------------------------------
SE---------S---SXSX----------------------SX-----------------E--------------------XXX--------------------------------------------------------
-----XXX------------------------------------------------?--<>------S---SS--------XX-----S-SS------------------XX----------------------------
-------------------------------------X----------E----------[]-------------------XXX---------------------------------------------------------
-------------------------------------XX---------X----------[]-----------------XXXXXXX-------XS-------------<X-------------------------------
-------------------------E-E---------XX-E-------EE-----E---[]---------EE----EXXXXXXX-----------------------[]-----------------------------E-
XXXXXXXXXXX----XXXXXXXXXXXXXXXXXXXXXXXXXXXXXXXXXXXXXXXXX---XXX-XXXXXXXXXXXXXXXXXXXXXXX----XXX----XXXX-XXXXXXXXXXXXXXXXXX------------X--XXXXX