--------------------------------------------------------------------------------------------------------------------------------------------
--------------------------------------------------------------------------------------------------------------------------------------------
--------------------------------------------------------------------------------------------------------------------------------------------
--------------------------------------------------------------------------------------------------------------------------------------------
--------------------------------------------------------XXXXXX------------------------------------------------------------------------------
--SSSSSS---------X-----------------------------------------------------------------S---------------------------S-----------SSQ--E?S---------
--------------XXXX---------SXXXX------------------------X----------------------SXX--------------------------X-------------------------------
--------------------------------------------------------------------------------S---------------------------S--X----------------------------
---------------XXXXX-----------------------------------------------------------------------------------------------------------------E------
-----XXX-------------------------------------------------------------------SSS----<>-------------------QQSS---E-------<>---S---SS?S---------
XX---------XX------------------------E---------------------------------E---------<[]E--------------E---------<>-------[]------S-S-----------
XX-X----S-SXX------------------------E-------------------------------------------[[]-S----<>-----------------[]-------[]-----S--------------
XX-X----S--XX------------E-----------]-----------EE------------------------E-----[]]ESEE--[]--E--------------[]-X-E---[]--------------------
XXXXXXXXXXXXXX-XXXXXXXXXXXXXXXXXXXXXXXXXXXXXXXXXXXXXXXXXXXXX-XXXXXX-XXXXXXXXXXXXXXXXXXXXXXXXXXXXXXXXXXXXXXXXXXXXXXXXXXXXXXXXXXXXXXXXXXXXXXXX