--------------------------------------------------------------------------------------------------------------------------------------------
--------------------------------------------------------------------------------------------------------------------------------------------
----------------------------------------------------------------------SSSSSSSSSSSSSS--------------------------------------------------------
--------------------------------------------------------------------------------------------------------------------------------------------
-------------------------E------------------------------------------------------------------------------------------------------------------
-----------XX-------S---SSS---------------------------------------------------------------------------------------------S-----SSSSSS--------
-----X-XX--------XX----------------------------------------SX-----------------------------------------------XX------------------------------
----------------------------------------------------------XXX-------------------------------------------------------------------------------
---------------------------S--------------------------------------E----------E----------------------------------------------------S---------
-------------------------XXX----X-------------------X-----X------<>--<>E----<>---Q-Q->--------X--------S-S-----EX-----XXXX-----SSSQ---SS----
--------------------------------------------------XXXX-----------[]--[------[]------[]--------XX------------E-<>----------------------------
--------------------------------------------------XXXX----X------[]--[]-----[]------[]--------XXX-------------[]X---------------------------
------------------------------E-E---SS-----------XXXXX----X--SE--[]-[]------[]------[]--------XXX-------------[]X-----S---------------------
----------------------------XXXXXXXXXXXXXXXXXXXXXXXX----XXXXXXXXXXXXXXXXX--XXXXXXXXXXXXXXXXXXXXXXXXXXXXXXXXXXXXXXXXXXXX--XXXXXXXXXXXXXXXXXXX