--------------------------------------------------------------------------------------------------------------------------------------------
--------------------------------------------------------------------------------------------------------------------------------------------
--------------------------------------------------------------------------------------------------------------------------------------------
--------------------------------------------------------------------------------------------------------------------------------------------
-----------------------E--------------------------------------------------------------------------------------------------------------------
-------------SSSSS----XX-E------------------------------------------------------------------------------------------------------------------
-----------------------------------------------------------------------------------------------------------SXSX-----------------------------
--------------------------------------------------------------------------------------------------------------------------------------------
------------X----------------------------------------------------------E--------------------------------------------------------------------
-QQ--QQ-XX---SS-----------------E--------------QQ----------------------------------------------------------S------------XXX-----------------
-------------------------------<>-------------------------------------------------------------X--XXX---E------------------------------------
-------------------------SS----[]----<---------------------------XXXXXX-----------------------XXXXXX--<>------------------------------------
---------------E-EE------------[]----EE-----EE----E--------------------------------------------X------[]-----------------------E--E-------E-
XXXXXXXX-XXXXXXXXXXXXX------XXXXXXXXXXXXXXXXXXXXXXXXXXXX---------------------XXXXXXXX-------XX--XX----XXXXXXXXXXXXXXXXXX---XXXXXXXXXXXXXXXXX