--------------------------------------------------------------------------------------------------------------------------------------------
--------------------------------------------------------------------------------------------------------------------------------------------
----------------------------------------------------------------------------------------------------------------SSSXSSSSSSSSSS--------------
----------------------------------------------------------------------------------------------------------------X---XXX---------------------
--------------------------------------------------------XXXXXXX-----XXXSXSXX----------------------------------------------------------------
-----------------------------S-S-------------X--------------------------------------------------------------------------------------------X-
------------------------------------------------------------------------------------------------------------------------------------SX----X-
-------------------------------------------X-X------------------E-----------------------------------------------------------------------XSX-
----------------------------X-X-----------XX-----------S-----------------------------------------XXX------------------------------------XXX-
-----------------------XXXXX------------------------X-------S-SSS----------------------------------------XX-------S----------XXX-----XXXXXXX
---------E------------XXXXXX--------------------------------------------------------------------------------------------------------XXXXXXXX
--------<>-----------XXXXXXX--SX-----XX-XXX---------------------XS-------------<>------------XX------------------------------------XXXXXXX-X
--------[]----------XXXXXXXX--S------------------------<-------------E--E------[]-----------------------EX-----------------S------XXXXXXXXXX
XXXXXXXXXXXX----XXXXXXXXXX-X---------------------------XXXXXXXXXXXXXXXXXXXXXXXXXXXXX---X-XXXXXX--------------XXXXXXXXXXXXXXX---X-XXXXXXXX--X