--------------------------------------------------------------------------------------------------------------------------------------------
-------------------------------------------------------E------------------------------------------------------------------------------------
----------------------------SSSSSSSSSSSSSSSSSSSS------<>------------------------------------------------------------------------------------
------------------------------------SSSSSSSSS-SS---XXXXX------------------------------------------------------------------------------------
------------------------------------SSSSSSSSSSSS------------------------------------------------------------------------E-------------------
-----------------X----------------------SSS----E--SXX--X--------------------------------------------------SX------SSSSSS---------X----------
-------------------------------------------S----XX-X-----------------------------------------------------------------------E--XX-X----------
---------------X-X-----------------------SS---------XX--------------------------------------------------------------------------------------
---------------------------S---------S-X-SSSS------XXX--------------------------------------------------------------------------SXSX--------
------------------------------QQ------SSSSXS------XXX-SS----E--------------QSQ--------S-SS---------------------------XXX--------------------
----------X--X-------------------------E----------XX----E--<>-----E--------------<>---------------------------------------XXXXXX-----E------
----------XXXXX-----------------------------------XX-------[]----<>----------------------------------------<-----X-X------X-----------------
---------------------------------------S-----XXXX-XX-------[]----[]------------------------------E-EEE-----[-------X---------------------EEE
---------------------XXXXXXXXXXXXX-XXXXXXXXXXXXXXX-----XXXXXXXXXXXXXXXXXXXXXXXXXXX--XXXXXXXXXXXXXXXXXXXX--------XXXXXXXXXX-----XXXXXXXXXXXXX