---------------------------------------------------------------E----------------------------------------------------------------------------
------------------------------------------------------------Q-------------------------------------------------------------------------------
----------------------------------------------------------------S---SSSSSSSSSSSSSSSS--------------------------------------------------------
-XXXX---------------------------------------------------------SS-ESS----SSS-----------------------------------------------------------------
--------------------------------------------------------SS------<>-S-SSSS-------------------------------------------------------------------
---------------------------------SS--------------------------E-S?S-S--SSSS-Q----------SSSSSS-------------------------------XX---------------
X-------------------------------------------E------------SSSX-------------------------------------------------------XXXXX-------------------
---------------------------------------------------------XXXXX------------------------------------------------------------------------------
-------------------------------------------SXXX---------?X---------SXSX-X----------------------SX---SX-------------------------------------S
--------------------S--------X----XX--------------------X-----------S--Q---------SSS-----XX-----------------------------------------------XX
---------E------------------XXX---------E--------------------------S--------E---------------------------------------------------------------
--------->----------<>------XX--------S-X-------------------S--------------<>---------------------------------------------------------------
---EE---[]----------[]E------X----------X------------E-----SS-------E------[-------------E-------------------SE-----------------------------
XXXXXXXXXXXXXXXXXXXXXXXXXXX-XXXXXXXXXXXXXXXXXXXXXXXXXXXXX-X-XXXXXXXXXXXXX-XX-XXXXXXXXXXXXXXXXXXXXXXXXXXXX---XXXX-------------------------XXX