--------------------------------------------------------------------------------------------------------------------------------------------
--------------------------------------------------------------------------------------------------------------------------------------------
-------------------------------------------------------------------------------------------------------------------XSX----------------------
--------------------------------------------------------------------------------------------------------------------------------------------
--------------XXXXX-------------------------------------------------------------------------------------------------------SXSXSXSXSX--------
SQS----------------XSX-------------------S-------------------------------------------S-----------------XSXSX--------------------------------
-----------------------------------------------------------------------------------X------------------XX------------------------------------
------------------------XXX--------------------------SX----------------------------X------------------------X-----------------XS------------
--------------------------------------------------------------------------------------------------------------------------------------------
SSSSSSSS--------------------SQQQQQQ------SS--------------------------------QQSS------QQQ--------X-----------X------SX-----------------------
-S----------------------------------------------------XX-------------------------------------------------------------S-----------------XX---
-]---------------------XXXX-------------------------XXXX------------------------------------------------------------------------------XXXX--
-----------E-E-E-------XX----------------E-E--E----XXXXXE>--------E----------------------------------------------[]-E---SS-S--E--E-E--XXXX--
XXXXXXXXXXXXXXXXXXXXX--XX---XXXXXXXX---XXXXXXXXXXXXXXXX-XXXXXXXXXXXXXXXXXXXXXXXXXXXXXXXXXXX--XXX----------------XXXXXXXXXXXX---XXXXXXXXXXX--