--------------------------------------------------------------------------------------------------------------------------------------------
--------------------------------Q-----------------------------------------------------------------------------------------------------------
--------------------------------------------------------------------------------------------------------------------------------------------
--------------------------------------------------------------------------------------------------------------------------------------------
--------------------------------------------------------------------------------------------------------------------------------------------
-----------SX-XSX----------------S?SSS----SS?S?Q--------------------------------------------------------------------------------------------
-----------------XX----------SS-------------------------------------------------------------------------------------------------------------
-----------------------------SSXS-----------------------------------------------S-----------------------------------------------------------
------------XX--------------SX---------S----XSX---------------------------------------------------------------------------------------------
----------------------------SX----XXX----S-SS--------S-S->-----------------SQS----<>-----------------------------------------------SSS---<>-
----------------------------XX--------------------------[]X-----------------------[]--------------------------XX-------------------------[]-
---------------------------XXX--S-----------------------[S----<>------------------[]--------------------------XX-------------------------[]-
--------------------------XXXX--S--------------------E--[SX---[---EXE-------------[]------------------------EXXXEE-E------------E--------[]-
------XX--------------------XXXXXXXXXXXXXXXXXXXXXXXXXXXXXXXXXXXXXXXXXXXXXXXXXXXXXXXXXXX--XXX------------X--XXXXXXXXXXXXXXXXXXXXXXXXXXXXXXXXX