--------------------------------------------------------------------------------------------------------------------------------------------
--------------------------------------------------------------------------------------------------------------------------------------------
------------------------------------------------------------------------------------SS------SSSSSSSSSS--------------------------------------
--------------------------------------------------------------------------------------------------------------------------------------------
--------------------------------------------------------------------------------------------------------------------------------------------
----------------X-------------------------------------------------------------------X--S------SSSS--E------------E---XX---------------------
-------------------------------------------------------------------------------SXSXS------------------------------XXXXX---------------------
-------------------------------------------X------------------------------------------------------------------------------------------------
------------------------------------------XE-------------------------------------------------------------E----XX----------------------------
------------------------------------------------------------------X--------S------------E-------SSSSSX--X---XXXX-----------XXXXX--------XXXX
-------------------------------------XXX--------------------------XX-XXX---------------<>-------SSS-----X-XXXXXX---------E-------------XXX--
-----------------------------XX------XXXX-------------------------XXXXXX---------------[]------SSSS-----XXXXXXXX--------XS------------XXX---
--------------------------E----------XX---------------------------XXXX----------------[]--[]-----SS----XXXX-XXXX---------------------XXXX---
X-----X------------------XXX------XXXXXX-----------XXXXXXXXX----XX--XXXXXXXXXXXXXXXX-XXXXXXXXXXXXXXXXXXXXXXXXXXXXXXXXXXXXX----------X-XXXXXX