--------------------------------------------------------------------------------------------------------------------------------------------
--------------------------------------------------------------------------------------------------------------------------------------------
--------------------------------------------------------------------------------------------------------------------------------------------
----------------------------------------------------------------------------------S---------------------------------------------------------
--------------------------------------------------------S-------E---------------EEEE--------------------------------------------------------
---------SSSSS-------------------------------X-----------SSSSXSX---------X------SXXX------------------------------------------------XXS-----
------------------------------------------------------SSSSSS-------E----XX------------------------------------------------------------------
-------------------------------------------X-X----------------------------------------------------------------------------------------------
-------------------------XX----------------E------------SSS--------SX-XXXXX--------S--------------------------------------------------------
----------SS-SS-----------------------------------------XXXX-X-----------------XXX-----------S-----------E------------S---------------------
-------------------------XXX---------XXXXX--------------------------X-----------------------------------<>----------------------------------
------------------------XXXX---X-----XXXXXX----------------X--------------------------------------------[]----------------------------------
--------------EE--------XXXX----------X-------------------SX-E-------------------S-S---------EE-E-------[]----------------------------------
----XX--XXXX--XXXXXXXXXXXXXX--------XX-------X-X--XXXXXX----------------------------XXXXXXXXXXXXXXXXXXXXXXXXX---X-----XXX-----X-----XXXXXXXX