--------------------------------------------------------------------------------------------------------------------------------------------
--------------------------------------------------------------------------------------------------------------------------------------------
--------------------------------------------------------------------------------------------------------------------------------------------
--------------------------------------------------------------------------------------------------------------------------------------------
----------------------------------------------------------------------------------------------SXSXSXSXSX------------------------------------
------------------------------------------?-------------SSS----------------XS-------XQQ----S--S-SX---------------S--------------------------
------------------------XXX---------------------------------------------------------------------------------------------------------SXSX----
--------------------------------------------------------------------------------XX----------------XS---------------------------X------------
----------------------------------------------------------------------------------------E-------E-------------X-XXX----------XXX------------
-------------------S----------------XX------------------SSSQSSS---------------------?--<>---------------------------------E--X-------XXXXXX-
---------------E--------------------------------------<>---------------------X--X----E-[]------------------XXX------------------------------
----------XXXXX---------------------------------------[]-----------------------XXXX-]--[]------SE---------XXXXX----------X----XX------------
-----------X-------------------------------E--E-------[----------------E--------X----[-[]---SS----E--E-EEXXXXXX---------------------XX------
XXXXXXXXXX--XX--XXXXXXXXXXXXXXXXXXXX---XXXXXXXXXXXXXXXXXXXXXXXX---XXXXXXXX-XX-------XXXXXXXXXXXXX-XXXXXXXXXXXXX----------------------------X