--------------------------------------------------------------------------------------------------------------------------------------------
------------S-------------------------------------------------------------------------------------------------------------------------------
SSSSSXSXSXSS-SS-----------------------------------------------------------------------------------------------------------------------------
----------SSSSS-----------------------------------------------------------------------------------------------------------------------------
----------SSSSSSSXSX------------------------------------------------------------------------------------------------------------------------
X------SSSSSSX------------XX----------SXS?--------------------------------------------------------------------------------------------------
---------------S----------X---------------------------------------------------------------------------------------------------------------SX
--------------SS---------XX--------------------------------------------X-------------------------------------SX----------------------------X
----E-----------S------XXXXX-------------------------------------------E---------------------SSSSSSSS--------X------------------------------
---<>----------SS-------XXXX---QQQ--------------------------------------------------------------------------X----XX------------E-----E------
---[]--------S----------XXXX--------------------------------------------------------------------------------X-XXXXX-----------------<>------
---[]------SS--------XXXXXXX-----------------------<>-S----------XXXXXX-------------------------------------XXXXXXX---SS------------[]------
---[]---------EE---EXXXXXXXX-E-----------EEEE------[]-------------------------------------------------------XXXXXXX--SX---EXX-------[]-----E
-XXXXXXXXXXX--XXXXXXXXXXXXXXXXXXXXXXXXXXXXXXXXXXX--XX---------------------------XXXXXXXXXX---XXXXXXXXXXXXX--XXXXXXXXXXXXXXXXXXXXXXXXXXXXXXXX