--------------------------------------------------------------------------------------------------------------------------------------------
--------------------------------------------------------------------------------------------------------------------------------------------
----------------------------------------------------------SXSXSXSXS-------------------------------------------------------------------------
--------------------------------------------------------XXXXXXX-----------------------------------------------------------------------------
--------------------------------------------------------------------------------------------------------------------------------------------
-----------------------------------------------------SS------XX----------------X---------------S--------------S-----------------------------
--------------------------S--------XX---------------------------------------------------XE--------------------------------------------------
----XX---------X----------------------------------------------------------------------------------------------------------------------------
-------------XXX---------------------------------------------------------------XX------------------------------S----------------------------
--XX-----X-----------E-----------------------------------------------XX-------XX--XX------------------------XXXX--------------------S-------
------E--XXXX-------<>--------------------XX---------------------E------------XX-----------------------------------------E-------------XXXX-
-XXX-----XXXXXXX----[]------------------------SX----------------<>------------XX-----------------XX---------------------<>------------------
-XXX-----XXXXX------[]-----E------------------------------------[]-------XXX--XX-----------------------------------EE---[]------------E-----
XXXXXXXXXXXXXXXXXXXXXXXXXXXX---------------------XXXXXXXXXXXXXXXXXXXX--XXXXX--XXXXXX---------------------X-----XXXXXXXXXXXXXXXXXXXXXXXXXXXXX