--------------------------------------------------------------------------------------------------------------------------------------------
---------------------------------------------------------------------SS---------------------------------------------------------------------
SSSSSSSSSSSSSSS-----------------------------------------SSSSSSSSSSSSSSSSSSSSSSSSSSSS--------------------------------------------------------
-------------------------------------------------------------------SSSS---------------------------------------------------------------------
------------------------------------------------------------------SSSSSSSSSS-------------------------------E--------------------------------
--------------------------------------------------------X--S------SSSQ---?Q--------------------SXSXSX---XXXXXXXX----------------------------
--------------------------------------------------------------------------------------------------------------------------------------------
-------------S----------XX------------------------------------------------------------------------------------------------------------------
--------------SSS------XXX----------------------------E-X--<>----------------E----SX-----------XXX------------------------------------------
--------------X-------XXX---?--<>-------------QQQS---<>----[]-----------SXS-S--X-E---XXX----------------------------------------------------
----------------------XXXX-->--[]--------------------[]-?--[]-------SSS---------------------------------------------------------------------
-----------------------XX---]--[]--------------------[]----[]------SSSS-----X-X-------------------------------------------------------------
----------------------------EE-[]---------E-E--------[]----[]-[]---------E--X-X-------------------------------------------------------------
XXXXXXXXXXXXXXXXXXXX------XXXX-XXXXXXXXXXXXXXXXXXXXXXXXX--XXXXXXXXXXXXXXXXXXXXXXXXXX-----------X--------------------------------------------