[
    12794947,
    11764293,
    11758052,
    11584116,
    11652907,
    11659427,
    12441510,
    12732113,
    12265102,
    11488771,
    11856858,
    11518817,
    12546856,
    11602871,
    12462779,
    12055210,
    12093838,
    11960888,
    11738051,
    12562256,
    12168727,
    12162666,
    11290533,
    11629187,
    11565788,
    11602961,
    11417620,
    11543511,
    12375175,
    12299495,
    11579576,
    11811278,
    12542895,
    12084161,
    12155972,
    11067434,
    12684184,
    11962665,
    11993903,
    12482740,
    11812214,
    12441418,
    12411220,
    12445497,
    11559640,
    11792856,
    11931031,
    11652373,
    11159141,
    11609029,
    11576150,
    11664386,
    12097340,
    11958735,
    11501402,
    12082924,
    11930088,
    11907092,
    11979432,
    11701538,
    12548392,
    11821707,
    11534821,
    12208686,
    12413740,
    11766840,
    11872877,
    11963397,
    12399947,
    11833101,
    12056640,
    12174403,
    12076704,
    12543620,
    11822954,
    11440440,
    11555927,
    12200471,
    12063381,
    16962860,
    11955137,
    13174336,
    11908126,
    11874584,
    12480746,
    12847296,
    12143714,
    11546214,
    11759140,
    11925741,
    11810605,
    11512159,
    12674247,
    12030423,
    11786135,
    12132429,
    12689229,
    12054415,
    11904770,
    11756277,
    11067382,
    11579001,
    12862894,
    12133758,
    12785548,
    12443604,
    12375422,
    12296457,
    12938853,
    11803429,
    12072005,
    11999323,
    12008344,
    11517522,
    11636841,
    12053264,
    12037945,
    11891160,
    11807470,
    11703684,
    12258154,
    12771818,
    12351676,
    12291496,
    12135150,
    12176982,
    11353433,
    12075319,
    12195907,
    11807393,
    11991351,
    11951729,
    12172603,
    11936397,
    11562016,
    11844751,
    11814692,
    11933329,
    11795577,
    11790212,
    11679942,
    12084629,
    12106300,
    11568109,
    11960074,
    12320026,
    12362046,
    12172140,
    12478690,
    12244784,
    12173295,
    12426898,
    12060810,
    12974438,
    12752158,
    12162800,
    11800057,
    12340001,
    11634266,
    11671332,
    11521735,
    12088416,
    11980047,
    11947077,
    11944246,
    12039946,
    11689479,
    12216418,
    12356733,
    12160943,
    12261302,
    11738504,
    12551106,
    12327318,
    12167283,
    11843023,
    12312761,
    12507983,
    11700061,
    11724905,
    12141162,
    12555091,
    11804351,
    11606602,
    11547284,
    11621975,
    12666587,
    12916280,
    12286633,
    12606299,
    12404971,
    11566683,
    11561799,
    11527475,
    12138928,
    12319322,
    12503479,
    12162761,
    12264509,
    12303293
]