--------------------------------------------------------------------------------------------------------------------------------------------
--------------------------------------------------------------------------------------------------------------------------------------------
--------------------------------------------------------------------------------------------------------------------------------------------
--------------------------------------------------------------------------------------------------------------------------------------------
----------------------------------SSSSSSS------------------------------------?---Q----------------------------------------------------------
------------------oo--------------oo----------------o---------------------------------------------------------------------------------------
-----------------------------<>-----------------------------------------------------<>------------------------------------------------------
-----------------------------[]-----------------------------------------------------[]------------------------------------------------------
-----------------------------[]-----------------------------------------------------[]------------------------------------------------------
-----------------------------[]-----------------------------------------------------[]------------------------------------------------------
------------------------------------B-------------------------------------------------B-----------------------------------------------------
------------------------------------b-------------------------------------------------b-----------------------------------------------------
--------------------E------------------------------E---------------------------------------------------------------------E------------------
XXXXXXXXXXXXXXXXXXXXXXXXXXXXXXXXXXXXXXXXXXXXXXXXXXXXXXXXXXXXXXXXXXXXXXXXXXXXXXXXXXXXXXXXXXXXXXXXXXXXXXXXXXXXXXXXXXXXXXXXXXXXXXXXXXXXXXXXXXXX