--------------------------------------------------------------------------------------------------------------------------------------------
--------------------------------------------------------------------------------------------------------------------------------------------
-----------------------------------SSSSS---------------------------------------------------------------------------------o------------------
---------------------------SSSS---SSSSSSS-----------------------SSSSS------------------------E--------------SSSSSSS-------------------------
--------------------------SSSS---SSSSSSSS----------------------SSSSSS----------------------S--------------SSSSSSSSSS------------------------
-------------------------SSSS---SSSSSSSSS---------------------SSS---SS--------------------SS-------------SSSSSSSSSSSS-----------------------
------------------------SSS----SSSSSSSSSS---------------------SS----SS--------------------SS-------------SSSSSSSSSSSS-----------------------
-----------------------SSS-----SSSSSSSSSS--------------------SS------SS-------------------SS-------------SSSSSSSSSSSS-----------------------
----------------------SS-------SSSSSSSSSS-------------------SS--------SS------------------SS-------------SSSSSSSSSSSS-----------------------
---------------------SS--------SSSSSSSSSS-------------------S----------SS--------------------------------SSSSSSSSSSSS-----------------------
--------------------SS---------SSSSSSSSSS------------------SS----------SS-------------------------------SSSSSSSSSSSSS-----------------------
XXXXXXXXXXXXXXXXXXXXXXXXXXXXXXXXXXXXXXXXXXXXXXXXXXXXXXXXXXXXXXXXXXXXXXXXXXXXXXXXXXXXXXXXXXXXXXXXXXXXXXXXXXXXXXXXXXXXXXXXXXXXXXXXXXXXXXXXXXXX
XXXXXXXXXXXXXXXXXXXXXXXXXXXXXXXXXXXXXXXXXXXXXXXXXXXXXXXXXXXXXXXXXXXXXXXXXXXXXXXXXXXXXXXXXXXXXXXXXXXXXXXXXXXXXXXXXXXXXXXXXXXXXXXXXXXXXXXXXXXX
XXXXXXXXXXXXXXXXXXXXXXXXXXXXXXXXXXXXXXXXXXXXXXXXXXXXXXXXXXXXXXXXXXXXXXXXXXXXXXXXXXXXXXXXXXXXXXXXXXXXXXXXXXXXXXXXXXXXXXXXXXXXXXXXXXXXXXXXXXXX