--------------------------------------------------------------------------------------------------------------------------------------------
--------------------------------------------------------------------------------------------------------------------------------------------
--------------------------------------------------------------------------------------------------------------------------------------------
---------------------------------------------B----------------------------------------------------------------------------------------------
----------------------SSSSSS---Q---Q--------------------------------------------------------------------------------------------------------
---------------------------------------------b----------------------------------------------------------------------------------------------
---------------------------------------------b----------------------------------------------------------------------------------------------
--------------------------------------------------------------------------------------------------------------------------------------------
-------------------------------------------------------------<>-----------------------------------------------------------------------------
-------------------------------------------------------------[]-----------------------------------------------------------------------------
-------------------------------------------------------------[]-----------------------------------------------------------------------------
--------------------------------------------------------------------------------------------------------------------------------------------
--------------------------------------------------------------------------------------------------------------------------------------------
XXXXXXXXXXXXXXXXXXXXXXXXXXXXXXXXXXXXXXXXXXXXXXXXXXXXXXXXXXXXXXXXXXXXXXXXXXXXXXXXXXXXXXXXXXXXXXXXXXXXXXXXXXXXXXXXXXXXXXXXXXXXXXXXXXXXXXXXXXXX