--------------------------------------------------------------------------------------------------------------------------------------------
--------------------------------------------------------------------------------------------------------------------------------------------
--------------------------------------------------------------------------------------------------------------------------------------------
--------------------------------------------------------------------------------------------------------------------------------------------
--------------------------------------------------------------------------------------------------------------------------------------------
--------------------------------------------------------------------------------------------------------------------------------------------
-------------------------------------------------------------------SS-----------------------------------------------------------------------
-------------------------------------------------------------------SS-----------------------------------------------------------------------
-------------------------------------------------------------------SS-----------------------------------------------------------------------
---------------------?---?---?----S-----Q---------------------------<>-------------------------------SS-------------------------------------
-------------------------------------------------------------------[]-----------------------------------------------------------------------
-------------------------------------------------------------------[]-----------------------------------------------------------------------
-------------------------------------------------------------------[]-----------------------------------------------------------------------
XXXXXXXXXXXXXXXXXXXXXXXXXXXXXXXXXXXXXXXXXXXXXXXXXXXXXXXXXXXXXXXXXXXXXXXXXXXXXXXXXXXXXXXXXXXXXXXXXXXXXXXXXXXXXXXXXXXXXXXXXXXXXXXXXXXXXXXXXXXX