--------------------------------------------------------------------------------------------------------------------------------------------
--------------------------------------------------------------------------------------------------------------------------------------------
--------------------------------------------------------------------------------------------------------------------------------------------
--------------------------------------------------------------------------------------------------------------------------------------------
--------------------------------------------------------------------------------------------------------------------------------------------
---------------------------------------------S----------------------------------------------------------------------------------------------
---------------------------------------------S--?-------------------------------------------------------------------------------------------
---------------------------------------------S----------------------------------------------------------------------------------------------
---------------------------------------------S----------------------------------------------------------------------------------------------
---------------------------------------------S---------S------S------------------S----------------------------------------------------------
----------------------------------------SS--X---------S------S------------------S-----------------------------------------------------------
----------------------------------------X------------SS----SSSS----------------SS-----------------------------------------------------------
---------------------------------XXXXXXX---------SSSSS----SSSSS----------S----S-------------------------------------------------------------
XXXXXXXXXoooXXXEXXXXXXXXXXXXXXXXXXXXXXXXXXXXXXXXXXXXXXXXXXXXXXXXXXXXXXXXXXXXXXXXXXXXXXXXXXXXXXXXXXXXXXXXXXXX--------------------------------