--------------------------------------------------------------------------------------------------------------------------------------------
--------------------------------------------------------------------------------------------------------------------------------------------
------------------------------------------------------------------------------------------------?-------------------------------------------
----------------------------------------------------------------------<>--------------------------------------------------------------------
----------------------------------------------------------------------[]--------------------------------------------------------------------
-------------------------------------------------------------B------------------------------------------------------------------------------
-------------------------------------------------------------b------------------------------------------------------------------------------
-----------------------SSSSSSSSSSSSSSS--------------------------------------------------------------------------E---------------------------
--------------------------------------------------------------------------------------------------------------------------------------------
--------------------------------------------------------------------------------------------------------------------------------------------
----------------------o-----------------------------------------------------------------------------------------------------------?---------
--------------------------------------------------------------------------------------------------------------------------------------------
--------------------------------------------------------------------------------------------------------------------------------------------
XXXXXXXXXXXXXXXXXXXXXXXXXXXXXXXXXXXXXXXXXXXXXXXXXXXXXXXXXXXXXXXXXXXXXXXXXXXXXXXXXXXXXXXXXXXXXXXXXXXXXXXXXXXXXXXXXXXXXXXXXXXXXXXXXXXXXXXXXXXX