--------------------------------------------------------------------------------------------------------------------------------------------
--------------------------------------------------------------------------------------------------------------------------------------------
--------------------------------------------------------------------------------------------------------------------------------------------
--------------------------------------------------------------------------------------------------------------------------------------------
--------------------------------------------------------------------------------------------------------------------------------------------
--------------------------------------------------------------------------------------------------------------------------------------------
--------------------------------------------------------------------------------------------------------------------------------------------
-------------------SSSSS------------------------------------------------------------SSSSS---------------------------------------------------
--------------------------------------------------------------------------------------------------------------------------------------------
-------------------------------<>--------------------------------------------<>-------------------------------------------------------------
-------------------------------[]--------------------------------------------[]-------------------------------------------------------------
-------------------------------[]---------<>---------------------------------[]-------------------------------------------------------------
------------------------------------------[]---------------------------------[]-------------------------------------------------------------
XXXXXXXXXXXXXXXXXXXXXXXXXXXXXXXXXXXXXXXXXXXXXXXXXXXXXXXXXXXXXXXXXXXXXXXXXXXXXXXXXXXXXXXXXXXXXXXXXXXXXXXXXXXXXXXXXXXXXXXXXXXXXXXXXXXXXXXXXXXX