--------------------------------------------------------------------------------------------------------------------------------------------
--------------------------------------------------------------------------------------------------------------------------------------------
--------------------------------------------------------------------------------------------------------------------------------------------
--------------------------------------------------------------------------------------------------------------------------------------------
--------------------------------------------SSSS-----------------------------SSSSS----------------------------------------------------------
--------------------------------------------Q?--?----------------------------Q--------------------------------------------------------------
-------------------SSSSS------?Q?----------------------------------SSSSS-------------------------------B------------------------------------
--------------------------------------------------------------------------------------------------------------------------------------------
-----------------------------------------<>--------------------<>----b----------------------------------------------------------------------
-----------------------------------------[]--------------------[]----b----------------------------------------------------------------------
--------------------------------------------------------------------------E-----------------------------------------------------------------
--------------------------------------------------------------------------------------------------------------------------------------------
-----------------------------------------XXXXXXXXXXXXXXXXXXXXXXXXXXXXXXXXXXXXXXXXXXXXXXXXXXXXXXXXXXXXXXXXXXXXXXXXXXXXXXXXXXXXXXXXXXXXXXXX---
XXXXXXXXXXXXXXXXXXXXXXXXXXXXXXXXXXXXXXXXXXXXXXXXXXXXXXXXXXXXXXXXXXXXXXXXXXXXXXXXXXXXXXXXXXXXXXXXXXXXXXXXXXXXXXXXXXXXXXXXXXXXXXXXXXXXXXXXXXXX