--------------------------------------------------------------------------------------------------------------------------------------------
--------------------------------------------------------------------------------------------------------------------------------------------
--------------------------------------------------------------------------------------------------------------------------------------------
-----------------------------------------------------SS----------------?--------------------------------------------------------------------
-----------------------------------------------------Q-----------------Q--------------------------------------------------------------------
--------------------------------------------------------------------------------------------------------------------------------------------
----------------------------------------------<>---<>---------------------------------------------------<>----------------------------------
----------------------------------------------[]---[]---------------------------------------------------[]----------------------------------
----------------------------------------------[]---[]---------------------------------------------------[]----------------------------------
----------------------------------------------[]---[]---------------------------------------------------[]----------------------------------
----------------------------------------------B-------------------------------------------------------------B-------------------------------
----------------------------------------------b---------------------o---------------------------------------b-------------------------------
-------------------------E----------------------------E------------E------------------------------------------------------------------------
XXXXXXXXXXXXXXXXXXXXXXXXXXXXXXXXXXXXXXXXXXXXXXXXXXXXXXXXXXXXXXXXXXXXXXXXXXXXXXXXXXXXXXXXXXXXXXXXXXXXXXXXXXXXXXXXXXXXXXXXXXXXXXXXXXXXXXXXXXXX