--------------------------------------------------------------------------------------------------------------------------------------------
-------------------SSS----------------------------------------------------------------------------------------------------------------------
-------------------?Q?----------------------------------------------------------------------------------------------------------------------
--------------------------------------------------------------------------------------------------------------------------------------------
--------------------------------------------------------------------------------------------------------------------------------------------
--------------------------------------------------------------------------------------------------------------------------------------------
--------------------------------------------------------------------------------------------------------------------------------------------
--------------------------------------------------------------------------------------------------------------------------------------------
--------------------------------------------------------------------------------------------------------------------------------------------
------------------------------------------------------------------------<>------------------------------------------------------------------
------------------------------------------------------------------------[]------------------------------------------------------------------
----------------------------------------------------------B---------------------------------------------------------------------------------
----------------------------------------------------------b------------------o--------------------------------------------------------------
XXXXXXXXXXXXXXXXXXXXXXXXXXXXXXXXXXXXXXXXXXXXXXXXXXXXXXXXXXXXXXXXXXXXXXXXXXXXXXXXXXXXXXXXXXXXXXXXXXXXXXXXXXXXXXXXXXXXXXXXXXXXXXXXXXXXXXXXXXXX