--------------------------------------------------------------------------------------------------------------------------------------------
--------------------------------------------------------------------------------------------------------------------------------------------
--------------------------------------------------------------------------------------------------------------------------------------------
-------------------------------S------------------------------------------------------------------------------------------------------------
-------------------------------S------------------------------------------------------------------------------------------------------------
-------------------------------S------------------------------------------------------------------------------------------------------------
-------------------------------S------------------------------------------------------------------------------------------------------------
-------------------------------S------------------------------------------------------------------------------------------------------------
-------------------------------S------------------------------------------------------------------------------------------------------------
-------------------------------S------------------------------------------------------------------------------------------------------------
-------------------------------S------------------------------------------------------------------------------------------------------------
-------------------------------S------------------------------------------------------------------------------------------------------------
------------------------------------------XXXXXE--------------------------------------------------------------------------------------------
XXXXXXXXXXXXXXXXXXXXXXXXXXXXXXXXoXXXXXXXXXXXXXXXXXXXXXXXXXXXXXXXXXXXXXXXXXXXXXXXXXXXXXXXXXXXXXXXXXXXXXXXXXXXXXXXXXXXXXXXXXXXXXXXXXXXXXXXXXXX