--------------------------------------------------------------------------------------------------------------------------------------------
----------------------------------------------------------------------------<>--------o-----------------------------------------------------
----------------------------------------------------------------------------[]---<>---------------------------------------------------------
-------------------------------------------EE----------------------------o--[]--E[]---E------------------------------------------E----------
--------------------------EE-------------SSSSS---------------------E------SS[]SSS[]SSSSSSS---------------------------------SSSSSSSS---------
-----------------------o-SSSSS--------o----------------------<>----XXXXXXXXXXXXXXXXXXXX-----------------------------------------------------
----------------o------------------------------------SSS-----[]----XXXXXXXXXXXXXXXXXXXX----o--------------o------o--------------------------
------------o---<>-------------------------------------------[]--o-XXXXXXXXXXXXXXXXXXXX-------------SSSS-----EE---------------<>------------
---------o------[]-<>------<>-------XXX------------<>-------o[]----XXXXXXXXXXXXXXXXXXXXXXX-<>------<>-------SSSSS----o-<>---<>[]---------<>-
----------o--XX-[]-[]------[]------EXXX------------[]---<>--XXXXXXXXXXXXXXXXXXXXXXXXXXXXXX-[]------[]---------------o-o[]---[][]--<>-----[]-
-------------XXXXXXXXXXXXXXXXXXXXXXXXXX-E-------E--[]---[]--XXXXXXXXXXXXXXXXXXXXXXXXXXXXXX-[]-E---E[]------------------[]---[][]--[]-SSo-[]-
XXXXXXXXXXXXXXXXXXXXXXXXXXXXXXXXXXXXXXXXXXXXXXXXXXXXXXXXXXXXXXXXXXXXXXXXXXXXXXXXXXXXXXXXXXXXXXXXXXXXXXXXXXXXXXXXXXXXXXXXXXXXXXXXXXXXXX---[]-
XXXXXXXXXXXXXXXXXXXXXXXXXXXXXXXXXXXXXXXXXXXXXXXXXXXXXXXXXXXXXXXXXXXXXXXXXXXXXXXXXXXXXXXXXXXXXXXXXXXXXXXXXXXXXXXXXXXXXXXXXXXXXXXXXXXXXXXXXXXX
XXXXXXXXXXXXXXXXXXXXXXXXXXXXXXXXXXXXXXXXXXXXXXXXXXXXXXXXXXXXXXXXXXXXXXXXXXXXXXXXXXXXXXXXXXXXXXXXXXXXXXXXXXXXXXXXXXXXXXXXXXXXXXXXXXXXXXXXXXXX
