--------------------------------------------------------------------------------------------------------------------------------------------
--------------------------------------------------------------------------------------------------------------------------------------------
--------------------------------------------------------------------------------------------------------------------------------------------
---------------------------------------------------------------------o----------------------------------------------------------------------
------------------------------------------------------------------------------------------------------------------------------SSS-----------
-----------SSS----------------------------------------o------------SSSSSo--------------------------E-------------------------------EE-------
-------------------------------------o-----------o--------------------------------o---------------SSS-----------------------------SSSSSSSSSS
---------------------------SSS------------o-----------<>-SS-----XXXXXXXX-------------<>----------o------------------------------------------
---------------------EE-o-----------------------------[]------o-XXXXXXXXE------EEo--E[]EE-----<>---------------------------------o------<>--
-------o-E----------SSSS------------<>---------------XXXX----SSSXXXXXXXXXX---SSSSSSSS[]SSS----[]-----SSSSE--------<>---------<>---------[]--
XXXXXXXXXXXXXXXXX--<>-----<><>------[]-------E-----E-XXXX-------XXXXXXXXXXXXXXXXXXXXXXXXXXXXXXXXXXXXXXXXXXXXXXX---[]---------[]---------[]--
XXXXXXXXXXXXXXXXXXX[]-----[][]---XXXXXXXXXXXXXXXXXXXXXXXXXXXXXXXXXXXXXXXXXXXXXXXXXXXXXXXXXXXXXXXXXXXXXXXXXXXXXX---[]-----o-EE[]XXXXXXXXXXXXX
XXXXXXXXXXXXXXXXXXXXXXXXXXXXXXXXXXXXXXXXXXXXXXXXXXXXXXXXXXXXXXXXXXXXXXXXXXXXXXXXXXXXXXXXXXXXXXXXXXXXXXXXXXXXXXXXXXXXXXXXXXXXXXXXXXXXXXXXXXXX
XXXXXXXXXXXXXXXXXXXXXXXXXXXXXXXXXXXXXXXXXXXXXXXXXXXXXXXXXXXXXXXXXXXXXXXXXXXXXXXXXXXXXXXXXXXXXXXXXXXXXXXXXXXXXXXXXXXXXXXXXXXXXXXXXXXXXXXXXXXX
