--------------------------------------------------------------------------------------------------------------------------------------------
----------------------------------------------------<>--------------------------------------------------------------------------------------
----------------------o--o--------------------------[]-<>-----------------------------------------------------------o--------------o--------
-----<>-<>------------------------------------------[]-[]oo--------------------------------------------------------o--------------o----<>---
-----[]-[]o---E--SSS--------E--E--<>---o-----o---SSS[]-[]----------------------------o--E-------------SS--------------o-----SSo-<>----S[]---
-----[]-[]----XXXXXXXXXXXXXXXXSSS-[]SSS---o----E--XXXXXXX-------------------------SSSSSSSS----o-SS<>----------o---------E--E----[]--E--[]---
-----[]-[]----XXXXXXXXXXXXXXXXXXXXXXXXXXXXXXXXXXXXXXXXXXXXXX--------o----o------------<>--<>SS-<>-[]oo-------------XXXXXXXXXXXXXXXXXXXXXXXXX
XXXXXXXXXXXXXXXXXXXXXXXXXXXXXXXXXXXXXXXXXXXXXXXXXXXXXXXXXXXX------SSS----<>-----------[]--[]---[]-[]<>-----XX-----EXXXXXXXXXXXXXXXXXXXXXXXXX
XXXXXXXXXXXXXXXXXXXXXXXXXXXXXXXXXXXXXXXXXXXXXXXXXXXXXXXXXXXX------------o[]------E----[]--[]---[]-[][]-<>--XX----SSXXXXXXXXXXXXXXXXXXXXXXXXX
XXXXXXXXXXXXXXXXXXXXXXXXXXXXXXXXXXXXXXXXXXXXXXXXXXXXXXXXXXXXE-------XXXXXXXXXXXXXXXXXXXXXXXXXXXXXXXXXXX[]--XX------XXXXXXXXXXXXXXXXXXXXXXXXX
XXXXXXXXXXXXXXXXXXXXXXXXXXXXXXXXXXXXXXXXXXXXXXXXXXXXXXXXXXXXXXX-----XXXXXXXXXXXXXXXXXXXXXXXXXXXXXXXXXXX[]E-XXXXXXXXXXXXXXXXXXXXXXXXXXXXXXXXX
XXXXXXXXXXXXXXXXXXXXXXXXXXXXXXXXXXXXXXXXXXXXXXXXXXXXXXXXXXXXXXX--E--XXXXXXXXXXXXXXXXXXXXXXXXXXXXXXXXXXXXXXXXXXXXXXXXXXXXXXXXXXXXXXXXXXXXXXXX
XXXXXXXXXXXXXXXXXXXXXXXXXXXXXXXXXXXXXXXXXXXXXXXXXXXXXXXXXXXXXXXXXXXXXXXXXXXXXXXXXXXXXXXXXXXXXXXXXXXXXXXXXXXXXXXXXXXXXXXXXXXXXXXXXXXXXXXXXXXX
XXXXXXXXXXXXXXXXXXXXXXXXXXXXXXXXXXXXXXXXXXXXXXXXXXXXXXXXXXXXXXXXXXXXXXXXXXXXXXXXXXXXXXXXXXXXXXXXXXXXXXXXXXXXXXXXXXXXXXXXXXXXXXXXXXXXXXXXXXXX
