--------------------------------------------------------------------------------------------------------------------------------------------
--------------------------------------------------------------------------------------------------------------------------------------------
-----------------------------<>-------------------------------------------------------------------------------------------------------------
-----------<>-<>---<>-----<>-[]-----------------------o--------------------------------E----------------------------------------------------
-----------[]-[]---[]-SSSS[]-[]-----------------------<>-----E----------------------SSSSSSSSS-SSS-----------------E-------<>-E--------------
-------o---[]-[]<>XXXXXXXXXXXXXX----------------------[]----SSSSSS----------------------------------------------SSSSSSSSSS[]SSSSS-----------
--------E--[]S[][]XXXXXXXXXXXXXX--------------SS------[]-------------------o--o-----------------------------o---<>--------[]--------o-------
XXXXXXXXXXXXXXXXXXXXXXXXXXXXXXXX----EoEEESS-----E-----[]--------------<>-----<>-----------------XXX-----------o-[]--------[]----------------
XXXXXXXXXXXXXXXXXXXXXXXXXXXXXXXXXXXXXXXXXXXXXXXXXXXXXXXXX-------------[]-----[]-----------------XXX---o---XXXXXXXXXXXXXXXXXXXXXXXo----------
XXXXXXXXXXXXXXXXXXXXXXXXXXXXXXXXXXXXXXXXXXXXXXXXXXXXXXXXX-------<>----[]----XXXXXXXXXXXXXXXXXXXXXXX-------XXXXXXXXXXXXXXXXXXXXXXX-o---SSS---
XXXXXXXXXXXXXXXXXXXXXXXXXXXXXXXXXXXXXXXXXXXXXXXXXXXXXXXXX-------[]-o--[]-o--XXXXXXXXXXXXXXXXXXXXXXX-------XXXXXXXXXXXXXXXXXXXXXXX----E------
XXXXXXXXXXXXXXXXXXXXXXXXXXXXXXXXXXXXXXXXXXXXXXXXXXXXXXXXXXXXXXXXXXXXXXXXXXXXXXXXXXXXXXXXXXXXXXXXXXXXXXXXXXXXXXXXXXXXXXXXXXXXXXXXXE--XXXXXXXX
XXXXXXXXXXXXXXXXXXXXXXXXXXXXXXXXXXXXXXXXXXXXXXXXXXXXXXXXXXXXXXXXXXXXXXXXXXXXXXXXXXXXXXXXXXXXXXXXXXXXXXXXXXXXXXXXXXXXXXXXXXXXXXXXXXXXXXXXXXXX
XXXXXXXXXXXXXXXXXXXXXXXXXXXXXXXXXXXXXXXXXXXXXXXXXXXXXXXXXXXXXXXXXXXXXXXXXXXXXXXXXXXXXXXXXXXXXXXXXXXXXXXXXXXXXXXXXXXXXXXXXXXXXXXXXXXXXXXXXXXX
