--------------------------------------------------------------------------------------------------------------------------------------------
--------------------------------------------------------------------------------------------------------------------<>------o-----------o---
----------------------------------------------------------------------------------------------o-o-------------------[]----<>----------------
------------------------------------------------------------------------------------------------------<>----------oo[]----[]-------------o--
-----------------------------------------o--------------<>------------------------------------------o-[]-----------E[]--E-[]--------------o-
---------------------------------------------oo-<>------[]--------------o--o-----------------------XXXXXXXXXXXXXXXXXXXXXXXXXXXXXXXXXXXXXX---
--------------------------------E---------------[]------[]o-------------------o----------<>----SSE-XXXXXXXXXXXXXXXXXXXXXXXXXXXXXXXXXXXXXX---
------o-----------------E-----SSSSSSSSSSS-------[]----E-[]----------<>----o-----o-------S[]-oXXXXXXXXXXXXXXXXXXXXXXXXXXXXXXXXXXXXXXXXXXXXXXX
------------------o---SSSS-----<>-------XXXXXXXXXXXXXXXXXXXX<>----<>[]-------------------[]--XXXXXXXXXXXXXXXXXXXXXXXXXXXXXXXXXXXXXXXXXXXXXXX
----------------<>-------------[]-------XXXXXXXXXXXXXXXXXXXX[]----[][]o--E--o--o---------[]-EXXXXXXXXXXXXXXXXXXXXXXXXXXXXXXXXXXXXXXXXXXXXXXX
---------o------[]E------------[]-------XXXXXXXXXXXXXXXXXXXX[]----[][]XXXXXXXXXXXXXXXXXXXXXXXXXXXXXXXXXXXXXXXXXXXXXXXXXXXXXXXXXXXXXXXXXXXXXX
---------E-----XXXXXXXXXX----E-[]-------XXXXXXXXXXXXXXXXXXXXXXXXXXXXXXXXXXXXXXXXXXXXXXXXXXXXXXXXXXXXXXXXXXXXXXXXXXXXXXXXXXXXXXXXXXXXXXXXXXXX
XXXXXXXXXXXXXXXXXXXXXXXXXXXXXXXXXXXXXXXXXXXXXXXXXXXXXXXXXXXXXXXXXXXXXXXXXXXXXXXXXXXXXXXXXXXXXXXXXXXXXXXXXXXXXXXXXXXXXXXXXXXXXXXXXXXXXXXXXXXX
XXXXXXXXXXXXXXXXXXXXXXXXXXXXXXXXXXXXXXXXXXXXXXXXXXXXXXXXXXXXXXXXXXXXXXXXXXXXXXXXXXXXXXXXXXXXXXXXXXXXXXXXXXXXXXXXXXXXXXXXXXXXXXXXXXXXXXXXXXXX
