------o-------------------------------------------------------------------------------------------------------------------------------------
--------------------------------------------------------------------------------------------------------------------------------------------
--------o-----------------------------------------------------------------------------------------------------------------------------------
---------<>-----------------------------------------------------EE-E--------------------------------------------------------------------E---
---------[]---------------------E-----E------------------------SSSSSS------------------------------------------------------------------SSS--
XXXXXXXXX[]-------o------SSSSSSSSSSSSSSS----------------------------------------------------------------------------------------------------
XXXXXXXXX[]---------------------------------------------------------------------------------------------------------------------------------
XXXXXXXXXXXX-------------------------------------------------------------o---------------------oo------------o------------------------------
XXXXXXXXXXXX-----o-----<>-------------------------------------------------o--------------------------------------------o------------o------E
XXXXXXXXXXXX----E-E----[]-------------<>-----<>----------------------------o-----o----------------o------E-----<>---------------------o---SS
XXXXXXXXXXXXXXXXXXXXXXXXXXXXXXXXXXXX--[]-----[]S<>---<>---------------------------------------------<><>SSSSo--[]--------------XXXXXXXXXXXXX
XXXXXXXXXXXXXXXXXXXXXXXXXXXXXXXXXXXX--[]-----[]-[]---[]-----E---------------o-----SSSSSS-E----------[][]-------[]----E---------XXXXXXXXXXXXX
XXXXXXXXXXXXXXXXXXXXXXXXXXXXXXXXXXXXXXXXXXXXXXXXXXXXXXXXXXXXXXXXXXXXXXXXXXXXXXXXXXXXXXXXXXXXXXXXXXXXXXXXXXXXXXXXXXXXXXXXXXXXXXXXXXXXXXXXXXXX
XXXXXXXXXXXXXXXXXXXXXXXXXXXXXXXXXXXXXXXXXXXXXXXXXXXXXXXXXXXXXXXXXXXXXXXXXXXXXXXXXXXXXXXXXXXXXXXXXXXXXXXXXXXXXXXXXXXXXXXXXXXXXXXXXXXXXXXXXXXX
