--------------------------------------------------------------------------------------------------------------------------------------------
--------------------------------------------------------------------------------------------------------------------------------------------
--------------------------------------------------------------------------------------------------------------------------------------------
--------------------------------------------------------------------------------------------------------------------------------------------
------------o-o----------------------------------------------------------------------------------------o----------E-E----E------------------
---------E------------------------E-------------------------------------------------------E-----------<>---------SSSSSSSSSS----<>oo---------
--------XXX--------------------SSSSS----------------------------------------------------SSSSSS---<>---[]-----------------------[]-SSSSSS<>--
--------XXX------------------------------------<>----------------o-------------------------------[]---[]-----o------<>-----o---[]-------[]--
XXXXXXXXXXXXXXXXXXXX-------------------------o-[]-------E--------------------<>---------XXXXXXXXXXXXXXXXXXXXXXXXX---[]---XXXXXXXXXXXXXXXXXXX
XXXXXXXXXXXXXXXXXXXX---<>--o---<>----o---------[]---XXXXXXXX-----------------[]---<>----XXXXXXXXXXXXXXXXXXXXXXXXXXXXXXXXXXXXXXXXXXXXXXXXXXXX
XXXXXXXXXXXXXXXXXXXX---[]---E--[]-------E------[]---XXXXXXXXSSS------E-------[]<>-[]----XXXXXXXXXXXXXXXXXXXXXXXXXXXXXXXXXXXXXXXXXXXXXXXXXXXX
XXXXXXXXXXXXXXXXXXXXXXXXXXXXXXXXXXXXXXXXXXXXXXXXXXXXXXXXXXXX---E---XXXE-----E[][]-[]----XXXXXXXXXXXXXXXXXXXXXXXXXXXXXXXXXXXXXXXXXXXXXXXXXXXX
XXXXXXXXXXXXXXXXXXXXXXXXXXXXXXXXXXXXXXXXXXXXXXXXXXXXXXXXXXXXXXXXXXXXXXXXXXXXXXXXXXXXXXXXXXXXXXXXXXXXXXXXXXXXXXXXXXXXXXXXXXXXXXXXXXXXXXXXXXXX
XXXXXXXXXXXXXXXXXXXXXXXXXXXXXXXXXXXXXXXXXXXXXXXXXXXXXXXXXXXXXXXXXXXXXXXXXXXXXXXXXXXXXXXXXXXXXXXXXXXXXXXXXXXXXXXXXXXXXXXXXXXXXXXXXXXXXXXXXXXX
