--------------------------------------------------------------------------------------------------------------------------------------------
------------------------------o-----o-------------------------------------------------------------------------------------------------------
-------------o-------------------<>---------------------------------------------------------------------------------------------------------
----------o-------------o----E---[]E--EEo--------------EE-----------------------------------------------------------------------------------
-----------o-------------SSSSSSSS[]SSSSS<>S-----------SSSSSS-----o--------------------------------------------------------------------------
-----<>---------------EEE---XXXXXXXXXX--[]<>--------------------------------------------------------SS---------------------------------EE---
-----[]--E--E-SSS-----XXXXXXXXXXXXXXXX--[][]-E---<>----------<>------o-----------EE----------------------------------------------SSSSSSSSS--
XXXXXXXXXXXXXXXXXXXX--XXXXXXXXXXXXXXXX--[][]SSSSS[]----------[]---------------SSSSSS------------------------------------------------------SS
XXXXXXXXXXXXXXXXXXXX--XXXXXXXXXXXXXXXXXXXXXXXXXXXXXXXXXXXXXXXXXXXXX--------o------<>------------o----------------o--------------------------
XXXXXXXXXXXXXXXXXXXXXXXXXXXXXXXXXXXXXXXXXXXXXXXXXXXXXXXXXXXXXXXXXXX---------------[]----------o------<><>----------<>E---------<>-------<>--
XXXXXXXXXXXXXXXXXXXXXXXXXXXXXXXXXXXXXXXXXXXXXXXXXXXXXXXXXXXXXXXXXXX------------<>-[]o-o--------------[][]-<><>-----[]SSS-------[]-------[]--
XXXXXXXXXXXXXXXXXXXXXXXXXXXXXXXXXXXXXXXXXXXXXXXXXXXXXXXXXXXXXXXXXXXXXXX--------[]-[]-----E------SSSS-[][]-[][]-----[]----E----E[]-------[]--
XXXXXXXXXXXXXXXXXXXXXXXXXXXXXXXXXXXXXXXXXXXXXXXXXXXXXXXXXXXXXXXXXXXXXXXXXXXXXXXXXXXXXXXXXXXXXXXXXXXXXXXXXXXXXXXXXXXXXXXXXXXXXXXXXXXXXXXXXXXX
XXXXXXXXXXXXXXXXXXXXXXXXXXXXXXXXXXXXXXXXXXXXXXXXXXXXXXXXXXXXXXXXXXXXXXXXXXXXXXXXXXXXXXXXXXXXXXXXXXXXXXXXXXXXXXXXXXXXXXXXXXXXXXXXXXXXXXXXXXXX
