------------------------------------------------------------------------------o-------------------------------------------------------------
------------------------------------------------------o----------oo-------------------------------------------------------------------------
---------------------------------------o-------------------<>--<>---------------------------------------------------------------------------
-----------------------o----------------<>-----------------[]--[]---------------------------------------------------------------------------
--------------------------------------<>[]SSSS--<>---------[]--[]SSSSSS------o----------------------<>--oo----------------------------------
----------<>-----------------EE-------[][]------[]SS-------[]--[]----------XXXX----------o----o-----[]o-E-E---------------------------------
----------[]----------------SSSS------[][]-----XXXXXXXXXXXXXXXXXXXXXXXXXXXXXXXX----------<>---------[]-SSSSS--------------------------------
--------o-[]-----------E---E----XXXXXXXXXXXXXXXXXXXXXXXXXXXXXXXXXXXXXXXXXXXXXXX-oE-------[]-XXXXXXXXXXXXXXX<>-------------o-----------------
XXXXXXXXXXXX--------<>-XXXXXXXXXXXXXXXXXXXXXXXXXXXXXXXXXXXXXXXXXXXXXXXXXXXXXXXXXXXXXXXXXXXXXXXXXXXXXXXXXXXX[]------<>-o----o----------------
XXXXXXXXXXXX--------[]-XXXXXXXXXXXXXXXXXXXXXXXXXXXXXXXXXXXXXXXXXXXXXXXXXXXXXXXXXXXXXXXXXXXXXXXXXXXXXXXXXXXX[]---<>-[]<>-SSSS-----------o----
XXXXXXXXXXXX----EE--[]-XXXXXXXXXXXXXXXXXXXXXXXXXXXXXXXXXXXXXXXXXXXXXXXXXXXXXXXXXXXXXXXXXXXXXXXXXXXXXXXXXXXX[]---[]E[][]---------E-E-o-------
XXXXXXXXXXXXXXXXXXXXXXXXXXXXXXXXXXXXXXXXXXXXXXXXXXXXXXXXXXXXXXXXXXXXXXXXXXXXXXXXXXXXXXXXXXXXXXXXXXXXXXXXXXXXXXXXXXXXXXXXXXXXXXXXXXXXXXXXXXXX
XXXXXXXXXXXXXXXXXXXXXXXXXXXXXXXXXXXXXXXXXXXXXXXXXXXXXXXXXXXXXXXXXXXXXXXXXXXXXXXXXXXXXXXXXXXXXXXXXXXXXXXXXXXXXXXXXXXXXXXXXXXXXXXXXXXXXXXXXXXX
XXXXXXXXXXXXXXXXXXXXXXXXXXXXXXXXXXXXXXXXXXXXXXXXXXXXXXXXXXXXXXXXXXXXXXXXXXXXXXXXXXXXXXXXXXXXXXXXXXXXXXXXXXXXXXXXXXXXXXXXXXXXXXXXXXXXXXXXXXXX
