--------------------------------------------------------------------------------------------------------------------------------------------
--------------------------------------------------------------------------------------------------------------------------------------------
--------------------------------------------------------------------------------------------------------------------------------------------
--------------------------E--------------------E--------------------------------------------------------------------------------------------
------------------------SSSSSS---------------SSSS----------------------------------------------------------------------------------------o--
------o------------------------SSSSS-------------------------------------------------o---o--------------E-----------------------------------
---------<>--o-------<>-----------------------------E----------------------------------------------o---SSS-SSSSS-----o--------------------E-
-------o-[]--<>----<>[]---------------------------SSSS-o------------o----SS----------SSS-<>-o----------------------E-----<>o-------------XXX
XXXXXXXX-[]--[]-o-o[][]-----------------------------------------------<>-------------<>--[]<>-------------------SSSSS--o-[]--------------XXX
XXXXXXXXXXXXXXXXXXXXXXX---------<>--------------<>----<>------E------E[]<>----------E[]--[][]----------------------------[]---------E----XXX
XXXXXXXXXXXXXXXXXXXXXXX---------[]--------------[]----[]E-E--SSSSSSSSS[][]----------XXXXXXXXXXXXXXXXXXXXXXXXXXXXXXXXXXXXXXXXX----XXXXXXXXXXX
XXXXXXXXXXXXXXXXXXXXXXX-------E-[]---XXXXXXXXXXXXXXXXXXXXXXXXXX-------[][]------o---XXXXXXXXXXXXXXXXXXXXXXXXXXXXXXXXXXXXXXXXX----XXXXXXXXXXX
XXXXXXXXXXXXXXXXXXXXXXXXXXXXXXXXXXXXXXXXXXXXXXXXXXXXXXXXXXXXXXXXXXXXXXXXXXXXXXXXXXXXXXXXXXXXXXXXXXXXXXXXXXXXXXXXXXXXXXXXXXXXXXXXXXXXXXXXXXXX
XXXXXXXXXXXXXXXXXXXXXXXXXXXXXXXXXXXXXXXXXXXXXXXXXXXXXXXXXXXXXXXXXXXXXXXXXXXXXXXXXXXXXXXXXXXXXXXXXXXXXXXXXXXXXXXXXXXXXXXXXXXXXXXXXXXXXXXXXXXX
