--------------------------------------------------------------------------------------------------------------------------------------------
-----------------------------------------------------------------------------------------------------------------------------------o----o---
---------------------------------------------------------------------------------------------------------------------------o--------o--<>---
---------------o-E----------------------------------------------------o----------------------------------------------------------------[]---
----------o----SSSSSS----o----o-------------------------------o-------------------------------------E-E--------------<>-o-----E-----SS-[]---
---------<>------------------o---------------------------------------------------SSSS--------------SSSSS-SS----------[]-SSS-<>SXXXXXXXXXXXXX
---------[]----------------------------E--------o----------------E-----------------------------o---------------------[]-----[]-XXXXXXXXXXXXX
------<>-[]---------<>----o----<>-SSS<>SS---------------------E-SSS--o-Eo-----o-------------------------XXX-----SSSXXXXXXXXXXXXXXXXXXXXXXXXX
------[]-[]--oXX----[]----E---E[]o---[]-----S<>----------o-XXXXXXXXXXXXXXX---------------------SSS------XXX----E---XXXXXXXXXXXXXXXXXXXXXXXXX
XXXXXXXXXXXXXXXXXXXXXXXXXXXXXXXXXXXXXXXX-----[]E-----------XXXXXXXXXXXXXXX------------------------------XXXXXXXXXXXXXXXXXXXXXXXXXXXXXXXXXXXX
XXXXXXXXXXXXXXXXXXXXXXXXXXXXXXXXXXXXXXXXXXXXXXXXX----------XXXXXXXXXXXXXXX--------------------XXXXXXXXXXXXXXXXXXXXXXXXXXXXXXXXXXXXXXXXXXXXXX
XXXXXXXXXXXXXXXXXXXXXXXXXXXXXXXXXXXXXXXXXXXXXXXXX-E-o------XXXXXXXXXXXXXXX--E--------------XXXXXXXXXXXXXXXXXXXXXXXXXXXXXXXXXXXXXXXXXXXXXXXXX
XXXXXXXXXXXXXXXXXXXXXXXXXXXXXXXXXXXXXXXXXXXXXXXXXXXXXXXXXXXXXXXXXXXXXXXXXXXXXXXXXXXXXXXXXXXXXXXXXXXXXXXXXXXXXXXXXXXXXXXXXXXXXXXXXXXXXXXXXXXX
XXXXXXXXXXXXXXXXXXXXXXXXXXXXXXXXXXXXXXXXXXXXXXXXXXXXXXXXXXXXXXXXXXXXXXXXXXXXXXXXXXXXXXXXXXXXXXXXXXXXXXXXXXXXXXXXXXXXXXXXXXXXXXXXXXXXXXXXXXXX
