--------------------------------------------------------------------------------------------------------------------------------------------
-----------------------------------------------------------------------------------------------------------------------------------o--------
----------------------------------------------------------------------------------------------------------------------------------------<>--
---------------o-<>------------------------------------------------------------------------------------------------------------------o--[]--
-----------------[]-----------------------------------------------------------------------------------------------------------------E---[]SS
-------o-------SS[]--------------E-----------------------------------------------o---------------SSS----------------------<>-------XXXXXXXXX
-----------------[]o------o----SSSSSS----------------------------------------------------------SS-------------------------[]<>-----XXXXXXXXX
XXXXXXXXXXXXXXXXXXXXXX---------------------------------------------E----o------<>------------------------------------o----[][]-----XXXXXXXXX
XXXXXXXXXXXXXXXXXXXXXX----<>--------------------------------------SSS----------[]--------------------<>-------------------[][]----EXXXXXXXXX
XXXXXXXXXXXXXXXXXXXXXX----[]------------------------------------------------E--[]SSS----------------S[]SSS---------<>--SSXXXXXXXXXXXXXXXXXXX
XXXXXXXXXXXXXXXXXXXXXX--oo[]--E------SS--------<>---------<>--------------XXXXXXXXX---------XXXXXXXXX[]------------[]----XXXXXXXXXXXXXXXXXXX
XXXXXXXXXXXXXXXXXXXXXXXXXXXXXXXXXXXXXXXXXXSSE--[]-oo-oE--o[]-o--------o---XXXXXXXXX---------XXXXXXXXX[]---E--XXXXXXXXXXXXXXXXXXXXXXXXXXXXXXX
XXXXXXXXXXXXXXXXXXXXXXXXXXXXXXXXXXXXXXXXXXXXXXXXXXXXXXXXXXXXXXXXXXXXXXXXXXXXXXXXXXXXXXXXXXXXXXXXXXXXXXXXXXXXXXXXXXXXXXXXXXXXXXXXXXXXXXXXXXXX
XXXXXXXXXXXXXXXXXXXXXXXXXXXXXXXXXXXXXXXXXXXXXXXXXXXXXXXXXXXXXXXXXXXXXXXXXXXXXXXXXXXXXXXXXXXXXXXXXXXXXXXXXXXXXXXXXXXXXXXXXXXXXXXXXXXXXXXXXXXX
