--------------------------------------------------------------------------------------------------------------------------------------------
----------------------------------------------o-----------o--oo-<>--------------------------------------------------------------------------
------------------------------------<>--------------------------[]-------<>-----------------------------------------------------------------
-------------------------------o----[]-EoE-----------o------E---[]-------[]-----------------------------------------------------------------
---------------------------------o--[]SSSSS-o---------E---SSSSSS[]-------[]E--------------------------------------SSS-----------------------
-------------------------------XXXXXXXXXXXXXXXXXXXXXXXXXXXXXXXXXXXXXXXXXXXXXXXXXXX---E------------------------------------------------------
-----------o---o--<>-----------XXXXXXXXXXXXXXXXXXXXXXXXXXXXXXXXXXXXXXXXXXXXXXXXXXXSSSSS-------------------EE--SS----------------------------
---------o----o---[]-------SSSSXXXXXXXXXXXXXXXXXXXXXXXXXXXXXXXXXXXXXXXXXXXXXXXXXXX----<>--------------o--SSSS------------o--------------o---
XXXXXXXXX---------[]<>XXXXXXXXXXXXXXXXXXXXXXXXXXXXXXXXXXXXXXXXXXXXXXXXXXXXXXXXXXXX----[]--------<>---<>--<>-----------<>--------------------
XXXXXXXXX-----SS--[][]XXXXXXXXXXXXXXXXXXXXXXXXXXXXXXXXXXXXXXXXXXXXXXXXXXXXXXXXXXXXXXXXXXXX<>----[]---[]--[]-----------[]-<>-----------------
XXXXXXXXXXXXXXXXXXXXXXXXXXXXXXXXXXXXXXXXXXXXXXXXXXXXXXXXXXXXXXXXXXXXXXXXXXXXXXXXXXXXXXXXXX[]----[]---[]--[]--<>-------[]-[]--------<>o---o--
XXXXXXXXXXXXXXXXXXXXXXXXXXXXXXXXXXXXXXXXXXXXXXXXXXXXXXXXXXXXXXXXXXXXXXXXXXXXXXXXXXXXXXXXXXXXXXE-[]---[]-E[]--[]-E-----[]o[]--------[]--E----
XXXXXXXXXXXXXXXXXXXXXXXXXXXXXXXXXXXXXXXXXXXXXXXXXXXXXXXXXXXXXXXXXXXXXXXXXXXXXXXXXXXXXXXXXXXXXXXXXXXXXXXXXXXXXXXXXXXXXXXXXXXXXXXXXXXXXXXXXXXX
XXXXXXXXXXXXXXXXXXXXXXXXXXXXXXXXXXXXXXXXXXXXXXXXXXXXXXXXXXXXXXXXXXXXXXXXXXXXXXXXXXXXXXXXXXXXXXXXXXXXXXXXXXXXXXXXXXXXXXXXXXXXXXXXXXXXXXXXXXXX
