--------------------------------------------------------------------------------------------------------------------------------------------
---------------------------------------------------------------------------------------------------------------------------------------o----
--------------------------------------------------------------------------------------------------------------------------------------------
--------------------------------------------------------E---------------------------------------------------------------------------------o-
--------------------------------------------o----------SSSSS---------------------E-----------------------------------------------E----<>--<>
-------------------------------------------------------------------------------SSSSS--------------------------------------------SSS---[]--[]
------------------------------------------------o<>----------------------------------------------------------------------------XXXXXXXXXXXXX
-----------------------------o-------------------[]-----------o--------------------------------------------o-------------------XXXXXXXXXXXXX
------o----------------o----------o--o-o----XXXXXXXXXXX------------------------------------------------<>--<>--<>------<>------XXXXXXXXXXXXX
----------------<>o--------------o-<>-------XXXXXXXXXXX--------------------------------o------<>-<>----[]--[]--[]EEE<>-[]--E---XXXXXXXXXXXXX
----------o---<>[]------<>---------[]-------XXXXXXXXXXX------o---------SSS-<>---<>------------[]-[]---o[]--[]--[]SSS[]XXXXXXXXXXXXXXXXXXXXXX
---------E-E--[][]-----E[]---------[]E------XXXXXXXXXXX-----E--oE--E-------[]-o-[]------------[]-[]----[]XXXX--[]---[]XXXXXXXXXXXXXXXXXXXXXX
XXXXXXXXXXXXXXXXXXXXXXXXXXXXXXXXXXXXXXXXXXXXXXXXXXXXXXXXXXXXXXXXXXXXXXXXXXXXXXXXXXXXXXXXXXXXXXXXXXXXXXXXXXXXXXXXXXXXXXXXXXXXXXXXXXXXXXXXXXXX
XXXXXXXXXXXXXXXXXXXXXXXXXXXXXXXXXXXXXXXXXXXXXXXXXXXXXXXXXXXXXXXXXXXXXXXXXXXXXXXXXXXXXXXXXXXXXXXXXXXXXXXXXXXXXXXXXXXXXXXXXXXXXXXXXXXXXXXXXXXX
