--------------------------------------------------------------------------------------------------------------------------------------------
--------------------------------------------------------------------------------------------------------------------------------------------
-------------------------------------------------------------------------------------------------------------------------o------------------
-------------------------o------o----------o------o--------o-----------------------------------------------------------------o--------------
----------------------------------------------E-o--o<>-<>-----<>-<>-----------------------------------------------------o---<>--------<>--<>
-----------------------------o---------------SSSSS<>[]-[]-----[]o[]-----------------------------------------------E-E-------[]o-------[]--[]
----------------------------------o-E---o----<>---[][]-[]-<><>[]-[]---------------SSSSSS-----------o--------E---SSSSSS------[]-E----E-[]--[]
--------o-------------o---------ESSSSSSEE-o--[]---[][]-[]-[][][]-[]-E-E---------------------------------<>SSSSS-------XXXXXXXXXXXXXXXXXXXXXX
-------------------------XXXXXXXXXXXXXXXXXXXXXXXXXXXXXXXXXXXXXXXXXXXXXX---o-----SS-------------o-----o--[]------------XXXXXXXXXXXXXXXXXXXXXX
------------------------oXXXXXXXXXXXXXXXXXXXXXXXXXXXXXXXXXXXXXXXXXXXXXX---<>----------------<>------o---[]------------XXXXXXXXXXXXXXXXXXXXXX
-----------o-----o-E-----XXXXXXXXXXXXXXXXXXXXXXXXXXXXXXXXXXXXXXXXXXXXXX---[]SSSo----------E-[]-----E--E-[]------------XXXXXXXXXXXXXXXXXXXXXX
--------------E-XXXXXXXXXXXXXXXXXXXXXXXXXXXXXXXXXXXXXXXXXXXXXXXXXXXXXXXXXXXXXXXXXXXXXXXXXXXXXXXXXXXXXXXXXXXXXXXXXXXXXXXXXXXXXXXXXXXXXXXXXXXX
XXXXXXXXXXXXXXXXXXXXXXXXXXXXXXXXXXXXXXXXXXXXXXXXXXXXXXXXXXXXXXXXXXXXXXXXXXXXXXXXXXXXXXXXXXXXXXXXXXXXXXXXXXXXXXXXXXXXXXXXXXXXXXXXXXXXXXXXXXXX
XXXXXXXXXXXXXXXXXXXXXXXXXXXXXXXXXXXXXXXXXXXXXXXXXXXXXXXXXXXXXXXXXXXXXXXXXXXXXXXXXXXXXXXXXXXXXXXXXXXXXXXXXXXXXXXXXXXXXXXXXXXXXXXXXXXXXXXXXXXX
