--------------------------------------------------------------------------------------------------------------------------------------------
--------------------------------------------------------------------------------------------------------------------------------------------
--------------------------------------------------------------------------------------------------------------------------------------------
--------------------------------------------------------------------------------------------------------------------------------------------
-------------------------------------------------------------------------SSSSSS--------------------------SS-----------------------------SSSS
--------------------------------------------------------------------------------------------------------------------------------------------
--------------------SS----------------------o----------------------SS-----------------------------------------------------------------------
---------------------------------------o-------------<>-------o----------------------------------------o-----------------------E------------
------------SSSSS-------------------------o----------[]-----o----o----o--------------o---o--SS----o--------------------------SSSS-----------
-------EE-E----------------------------<>--o---------[]----<>-----------------------<>SSSS--------------------------<>---o-----------o------
XXXXXXXXXXXXXX----------<>---o------EE-[]----------o-[]--<>[]---------<>----------<>[]---------------------<>-------[]----------------------
XXXXXXXXXXXXXX---E----E-[]EXXXXXXXXXXXXXXXXXXXXXXXXXXXXXX[][]S--------[]----------[][]-----E---------------[]-o-----[]-E---E-XXX-SSE--------
XXXXXXXXXXXXXXXXXXXXXXXXXXXXXXXXXXXXXXXXXXXXXXXXXXXXXXXXXXXXXXXXXXXXXXXXXXXXXXXXXXXXXXXXXXXXXXXXXXXXXXXXXXXXXXXXXXXXXXXXXXXXXXXXXXXXXXXXXXXX
XXXXXXXXXXXXXXXXXXXXXXXXXXXXXXXXXXXXXXXXXXXXXXXXXXXXXXXXXXXXXXXXXXXXXXXXXXXXXXXXXXXXXXXXXXXXXXXXXXXXXXXXXXXXXXXXXXXXXXXXXXXXXXXXXXXXXXXXXXXX
