--------------------------------------------------------------------------oo-----------------------------------------o----------------------
------------------------------------------------------------------------------------<>-<>---------------------------o-----------------------
---------------------------------------------------------------------<>-------------[]-[]------------------------------------------------o--
--------------------------------------------------------------o----E-[]--o--o--o--E-[]-[]-------o---------------o----------E-----E---EE----o
------------------------------------------------------------------SSS[]-----Eo--SSSS[]S[]--E-----------------------------SSSSSSSSSSSSSSS----
-------------------------------------------------------------o-XXXXXXXXXXXXXXXXXXXXXXXXXXSSSSSSS------------XXXXXXXXXXXXXXXXXXX-------------
------<>------------SS-------------------------------------E-SSXXXXXXXXXXXXXXXXXXXXXXXXXX---------------o--SXXXXXXXXXXXXXXXXXXX---------E---
------[]--<>----------------------o---------------o--------XXXXXXXXXXXXXXXXXXXXXXXXXXXXXX-----------E-------XXXXXXXXXXXXXXXXXXXXXXXXXXXXXXXX
------[]-E[]-------o-------o-----<>------------o-o---------XXXXXXXXXXXXXXXXXXXXXXXXXXXXXXXXXXXXXXXXXXXXXXXXXXXXXXXXXXXXXXXXXXXXXXXXXXXXXXXXX
XXXXXXXXXXXXX-------------o------[]---------<>--------<>---XXXXXXXXXXXXXXXXXXXXXXXXXXXXXXXXXXXXXXXXXXXXXXXXXXXXXXXXXXXXXXXXXXXXXXXXXXXXXXXXX
XXXXXXXXXXXXX-----o-----o-------S[]SSSSSS---[]----EE--[]---XXXXXXXXXXXXXXXXXXXXXXXXXXXXXXXXXXXXXXXXXXXXXXXXXXXXXXXXXXXXXXXXXXXXXXXXXXXXXXXXX
XXXXXXXXXXXXX--------------------[]-------E-[]XXXXXXXXXXXXXXXXXXXXXXXXXXXXXXXXXXXXXXXXXXXXXXXXXXXXXXXXXXXXXXXXXXXXXXXXXXXXXXXXXXXXXXXXXXXXXX
XXXXXXXXXXXXXXXXXXXXXXXXXXXXXXXXXXXXXXXXXXXXXXXXXXXXXXXXXXXXXXXXXXXXXXXXXXXXXXXXXXXXXXXXXXXXXXXXXXXXXXXXXXXXXXXXXXXXXXXXXXXXXXXXXXXXXXXXXXXX
XXXXXXXXXXXXXXXXXXXXXXXXXXXXXXXXXXXXXXXXXXXXXXXXXXXXXXXXXXXXXXXXXXXXXXXXXXXXXXXXXXXXXXXXXXXXXXXXXXXXXXXXXXXXXXXXXXXXXXXXXXXXXXXXXXXXXXXXXXXX
