-------------------------------------------------------------------------------------------------------------------------------------------o
---------------------------------------------------------------------------------------------------------------------------------------o----
--------------------------------------------------------------------------------------------------------------------------------------------
-------------------------------------------------------------------------------------------------------------------------o------------------
-----------------------------------------------SS-------------------------------------------------------------------------------E-oE--oEoo--
-------------------------------------------------SS---------------------------------------------------------------------o------SSXXXXXXXXXXX
---------<>-------E-------------------------------------------------------------------------------------------------------E------XXXXXXXXXXX
---------[]o<>-SSSSSSS---------------------------------------------------------oo--o------o----------SS------------------XXXXXXXXXXXXXXXXXXX
---------[]-[]------------------o--------o----------EE---------------<>o------EE-E-----------------o------------<>-------XXXXXXXXXXXXXXXXXXX
---------[]-[]E-------------oo---------------------SSSSSSSSSSSSS---SS[]S----SSSSSSSS----------------------------[]o--o---XXXXXXXXXXXXXXXXXXX
XXXXXXXXXXXXXXXXXX-------------------------<>------------------------[]---<>--------SSSS--<>----------------<>--[]---SSXXXXXXXXXXXXXXXXXXXXX
XXXXXXXXXXXXXXXXXX------------------E------[]S-------------------E---[]---[]--------------[]-E--------------[]--[]-----XXXXXXXXXXXXXXXXXXXXX
XXXXXXXXXXXXXXXXXXXXXXXXXXXXXXXXXXXXXXXXXXXXXXXXXXXXXXXXXXXXXXXXXXXXXXXXXXXXXXXXXXXXXXXXXXXXXXXXXXXXXXXXXXXXXXXXXXXXXXXXXXXXXXXXXXXXXXXXXXXX
XXXXXXXXXXXXXXXXXXXXXXXXXXXXXXXXXXXXXXXXXXXXXXXXXXXXXXXXXXXXXXXXXXXXXXXXXXXXXXXXXXXXXXXXXXXXXXXXXXXXXXXXXXXXXXXXXXXXXXXXXXXXXXXXXXXXXXXXXXXX
