--------------------------------------------------------------------------------------------------------------------------------------------
--------------------------------------------------------------------------------------------------------------------------------------------
--------------------------------------------------------------------------------------------------------------------------------------------
--------------------------------------------------------------------------------------------------------------------------------------------
--------------------------------SS---------------------------------------------------SSSSSS-------------------------------------------------
--------------------------E---<>------------------------------------------------------------------------------------------------------------
-----------------------o-SSS--[]----o--o-------------------SSSSS-------SSSS---o-<>-<>-------SS--------------SSS-----------------------------
---------------------o----<>--[]-------E-------------------------------------o--[]-[]------------------------------o---------------o------o-
-------------------o------[]-o[]------XXXXXX----------o------<>--------------E--[]-[]------o-------------------o----<>----------------------
-------------<>------XXXXXXXXXXXX-----XXXXXX<>---------------[]<>-----------XXXXXXXXX---------------------XXXX------[]------o---S<>---------
-------------[]------XXXXXXXXXXXX-----XXXXXX[]-----E--E------[][]-----------XXXXXXXXX------------------<>-XXXX------[]-o-----E---[]----<>---
---------E---[]------XXXXXXXXXXXXXXXXXXXXXXX[]-SSSSSSSSSo----[][]-----------XXXXXXXXX-----------EE-----[]-XXXX---SSS[]---E--SSSS-[]----[]---
XXXXXXXXXXXXXXXXXXXXXXXXXXXXXXXXXXXXXXXXXXXXXXXXXXXXXXXXXXXXXXXXXXXXXXXXXXXXXXXXXXXXXXXXXXXXXXXXXXXXXXXXXXXXXXXXXXXXXXXXXXXXXXXXXXXXXXXXXXXX
XXXXXXXXXXXXXXXXXXXXXXXXXXXXXXXXXXXXXXXXXXXXXXXXXXXXXXXXXXXXXXXXXXXXXXXXXXXXXXXXXXXXXXXXXXXXXXXXXXXXXXXXXXXXXXXXXXXXXXXXXXXXXXXXXXXXXXXXXXXX
