--------------------------------------------------------------------------------------------------------------------------------------------
--------------------------------------------------------------------------------------------------------------------------------------------
--------------------------------------------------------------------------------------------------------------------------------------------
-----<>-------------------------------------------------------------------------------------------------------------------------------------
-----[]--------------------------------------SSS-----------------------------------------------------------SS-------------------------------
-----[]------------------------------------------------------------------------------------------<>-----------------------------------------
-----[]-----------------------------------------o--------------------------------------------<>--[]-----------------------------------------
XXXXXXX----------------o----------------------------<>-----------------------------------EE--[]-E[]--------------E----<>------SSS-----------
XXXXXXXo--------Eo----------------<>-------o-------o[]-o--------------o---------o----XXXXXXXXXXXXXXXXXXXXXXXXXXXXX----[]----------------E---
XXXXXXXXXXXX---SSS----------------[]-------------o<>[]----o--------o-----------------XXXXXXXXXXXXXXXXXXXXXXXXXXXXX-Eo-[]----------o----SSSSS
XXXXXXXXXXXX----------------------[]--------------[][]--E---Eo------------<>---------XXXXXXXXXXXXXXXXXXXXXXXXXXXXXXXX-[]----------------<><>
XXXXXXXXXXXX---------E--E------E--[]---EEXXXXXXXXXXXXXXXXXXXXXX--E--------[]E-E---o--XXXXXXXXXXXXXXXXXXXXXXXXXXXXXXXXXXX----------------[][]
XXXXXXXXXXXXXXXXXXXXXXXXXXXXXXXXXXXXXXXXXXXXXXXXXXXXXXXXXXXXXXXXXXXXXXXXXXXXXXXXXXXXXXXXXXXXXXXXXXXXXXXXXXXXXXXXXXXXXXXXXXXXXXXXXXXXXXXXXXXX
XXXXXXXXXXXXXXXXXXXXXXXXXXXXXXXXXXXXXXXXXXXXXXXXXXXXXXXXXXXXXXXXXXXXXXXXXXXXXXXXXXXXXXXXXXXXXXXXXXXXXXXXXXXXXXXXXXXXXXXXXXXXXXXXXXXXXXXXXXXX
