--------------------------------------------------------------------------------------------------------------------------------------------
--------------------------------------------------------------------------------------------------------------------------------------------
--------------------------------------------------------------------------------------------------------------------------------------------
--------------------------------------------------------------------------------------------------------------------o--<>---o------o--------
-----------------------------------SSS---------------------------------------------------------------------------------[]-o-E-E-------E----S
----------------------------------------------------EE-----------------------------<>---------------------------o------[]SSSSSSSXXXXXXXXXXXX
--------<>------------------------------o-----o---SSSSS----------------------------[]SS-o--------------------------<>--[]-------XXXXXXXXXXXX
--------[]-----------<>-----------------------<>---------------------------o---o---[]---------------------------E--[]-XXXXXXXXXXXXXXXXXXXXXX
--------[]-----------[]--o--------------------[]------------E-----------o-----o----[]---E-------<>---o---------XXXXXXXXXXXXXXXXXXXXXXXXXXXXX
--------[]-----E-o---[]--------E--E----E-<>---[]---<>--o-oSSSSS----------<>------XXXXXXXX-------[]--o----------XXXXXXXXXXXXXXXXXXXXXXXXXXXXX
XXXXXXXXXXXXXXXXXXXXXXXXXXXXXXXXXXXXXXXXX[]--o[]---[]--------------------[]------XXXXXXXX-------[]SS-----------XXXXXXXXXXXXXXXXXXXXXXXXXXXXX
XXXXXXXXXXXXXXXXXXXXXXXXXXXXXXXXXXXXXXXXXXXXXXXXXX-[]-------------E-E-E--[]-E---EXXXXXXXX-oo----[]-------------XXXXXXXXXXXXXXXXXXXXXXXXXXXXX
XXXXXXXXXXXXXXXXXXXXXXXXXXXXXXXXXXXXXXXXXXXXXXXXXXXXXXXXXXXXXXXXXXXXXXXXXXXXXXXXXXXXXXXXXXXXXXXXXXXXXXXXXXXXXXXXXXXXXXXXXXXXXXXXXXXXXXXXXXXX
XXXXXXXXXXXXXXXXXXXXXXXXXXXXXXXXXXXXXXXXXXXXXXXXXXXXXXXXXXXXXXXXXXXXXXXXXXXXXXXXXXXXXXXXXXXXXXXXXXXXXXXXXXXXXXXXXXXXXXXXXXXXXXXXXXXXXXXXXXXX
