--------------------------------------------------------------------------------------------------------------------------------------------
----------------------------------------------------------------------------------------------------------------------------------<>--------
------o----------------------------------------------------------------------------------------------------------------------o--o-[]--------
-----------------------------------------------E----------------------------------------------------------------------------------[]--------
----------------------------------------------SSS---------------------<>-------------------------------o----E--o---------------E--[]-SSSSS-S
------EXXXXXXXXXXXX---------------o-----------XXX----o----------------[]-oSSSSS----------------------------SSSSSSS---------XXXXXXXXXXXXXXXXX
XXXXXXXXXXXXXXXXXXX--------<>-----------------XXX---------o----------XXXXXXX---------------------------<>------------------XXXXXXXXXXXXXXXXX
XXXXXXXXXXXXXXXXXXX----E---[]-E---------------XXX-----------SS-E---SSXXXXXXX-------------o-------------[]----------o---XXXXXXXXXXXXXXXXXXXXX
XXXXXXXXXXXXXXXXXXXXXXXXXXXXXXX----------XXXXXXXXo------------SSSS---XXXXXXX----o----------------------[]--------------XXXXXXXXXXXXXXXXXXXXX
XXXXXXXXXXXXXXXXXXXXXXXXXXXXXXX----------XXXXXXXXXXXXXXXXXXXXXXXXXXXXXXXXXXXXXXX----o---------------XXXXXXXXXXXXXXXXXXXXXXXXXXXXXXXXXXXXXXXX
XXXXXXXXXXXXXXXXXXXXXXXXXXXXXXXXXXXX-----XXXXXXXXXXXXXXXXXXXXXXXXXXXXXXXXXXXXXXX---o--<>-------o----XXXXXXXXXXXXXXXXXXXXXXXXXXXXXXXXXXXXXXXX
XXXXXXXXXXXXXXXXXXXXXXXXXXXXXXXXXXXXXXXXXXXXXXXXXXXXXXXXXXXXXXXXXXXXXXXXXXXXXXXX------[]----E--E----XXXXXXXXXXXXXXXXXXXXXXXXXXXXXXXXXXXXXXXX
XXXXXXXXXXXXXXXXXXXXXXXXXXXXXXXXXXXXXXXXXXXXXXXXXXXXXXXXXXXXXXXXXXXXXXXXXXXXXXXXXXXXXXXXXXXXXXXXXXXXXXXXXXXXXXXXXXXXXXXXXXXXXXXXXXXXXXXXXXXX
XXXXXXXXXXXXXXXXXXXXXXXXXXXXXXXXXXXXXXXXXXXXXXXXXXXXXXXXXXXXXXXXXXXXXXXXXXXXXXXXXXXXXXXXXXXXXXXXXXXXXXXXXXXXXXXXXXXXXXXXXXXXXXXXXXXXXXXXXXXX
