--------------------------------------------------------------------------------------------------------------------------------------------
--------------------------------------------------------------------------------------------------------------------------------------------
--------------------------------------------------------------------------------------------------------------------------------------------
--------------------------------------------------------------------------------------------------------------------------------------------
-----------------------------------------------------------------------------------------------------E--------------------------------------
-------E-----o--------------------------------------------------------------------------------------SSSSS-----------------------------------
XXXXXXXXXXX--------o------------------------------------------------------------------------------------------------------------------------
XXXXXXXXXXX----o----------------------------------------------------------------------------SS--o--------o---o------o-----------------------
XXXXXXXXXXX-----o-o------SSS-----<>--o------------------------------------o-------------------------------o------------E-----<>-------------
XXXXXXXXXXX--E-------E-----------[]-------------------o--------------------<>------------o--------o-------------------SSSSSSo[]-----o--o----
XXXXXXXXXXXXXXXXXXXXXXXXXXX-----E[]oE--------E---<>-<>-------------o-------[]--<>--------------------------------------------[]-------------
XXXXXXXXXXXXXXXXXXXXXXXXXXXXXXXXXXXXXX------XXXX-[]E[]---------o-------o---[]-E[]--------------E-E-----------E---------------[]--E---o------
XXXXXXXXXXXXXXXXXXXXXXXXXXXXXXXXXXXXXX------XXXXXXXXXXXX---SSSXX---XXXXXXXXXXXXXXXXXXXXXXXXXXXXXXXXXXXXXXXXXXX-SS<>-XXXXXXXXXXXXXXXXXXXXX---
XXXXXXXXXXXXXXXXXXXXXXXXXXXXXXXXXXXXXXo--o--XXXXXXXXXXXX------XX---XXXXXXXXXXXXXXXXXXXXXXXXXXXXXXXXXXXXXXXXXXX---[]-XXXXXXXXXXXXXXXXXXXXX-o-
