--------------------------------------------------------------------------------------------------------------------------------------o-----
------------------------------------------------------------------------------------------------------------------------------------------o-
------------------------------------------------------------------------------------------------------------------------------<>------------
-----------------------------------------o------------------------------------------------------------------------------------[]o--o--------
--------------------------------------------E------------E-E--------------E--------------------<>-------E-E--o--EE--SS---o----[]-----SS----E
----------------------------------SSSSSSSSSSSS--------SSSSSSSo-----------SSS-------------------[]-----SSSSSSSSSSSSS-----XXXXXXXXXXXXXXXXXXXX
--------------------------------SS-<>------------o------------o--------------------------------[]o----------------------XXXXXXXXXXXXXXXXXXXX
----------------------SSSS-----o---[]---------------------------SS-----------------------------[]---------------------E-XXXXXXXXXXXXXXXXXXXX
----------<>o--<>-------------<>---[]-XXXXXX---o-----------------<>---S<>----o---o----o-o-----XXXXXXXXXXXXXXXXXXXXXXXXXXXXXXXXXXXXXXXXXXXXXX
----------[]---[]---SS----SSSS[]---[]-XXXXXX--E------------------[]----[]---------<>--------o-XXXXXXXXXXXXXXXXXXXXXXXXXXXXXXXXXXXXXXXXXXXXXX
----------[]---[]-o--XXXXXXXXXXXXXXXXXXXXXXXXXXXXXXXXXXXXXXXXXXX-[]--<>[]-------o-[]----------XXXXXXXXXXXXXXXXXXXXXXXXXXXXXXXXXXXXXXXXXXXXXX
------Eo--[]---[]----XXXXXXXXXXXXXXXXXXXXXXXXXXXXXXXXXXXXXXXXXXX-[]--[][]----E----[]-----o----XXXXXXXXXXXXXXXXXXXXXXXXXXXXXXXXXXXXXXXXXXXXXX
XXXXXXXXXXXXXXXXXXXXXXXXXXXXXXXXXXXXXXXXXXXXXXXXXXXXXXXXXXXXXXXXXXXXXXXXXXXXXXXXXXXXXXXXXXXXXXXXXXXXXXXXXXXXXXXXXXXXXXXXXXXXXXXXXXXXXXXXXXXX
XXXXXXXXXXXXXXXXXXXXXXXXXXXXXXXXXXXXXXXXXXXXXXXXXXXXXXXXXXXXXXXXXXXXXXXXXXXXXXXXXXXXXXXXXXXXXXXXXXXXXXXXXXXXXXXXXXXXXXXXXXXXXXXXXXXXXXXXXXXX
