--------------------------------------------------------------------------------------------------------------------------------------------
----------------------o---------------------------------------------------------------------------------------------------------------------
--------------------------------------------------------------------------------------------------------------------------------------------
----------------o-o<>-----------------------------------------------------------------------------------------------------------------------
-------------o----S[]EEE------------o------------------------------------o---------o-----o----o---------------------------------------------
---------o--o--XXXXXXXXX---<>SSS----<>------<>---o------------------------------------------------------------------------------------------
------o----<>--XXXXXXXXX---[]-------[]------[]--<>EE-<>-<>-----------------SS--------------------o------------------------------------------
--------E--[]--XXXXXXXXX--o[]---<>-E[]------[]--[]SSS[]-[]------------------------------o-SS--------------o-----<>-<>-------<>--------------
XXXXXXXXXXXXXXXXXXXXXXXX---[]---[]SS[]SSE---[]--[]---[]-[]------------<>--E--oE------------------EE-<>---------S[]S[]<>---o-[]------------o-
XXXXXXXXXXXXXXXXXXXXXXXXXXXXXXXXXXXXXXXXXXXXXXXXXXX--[]-[]----SS------[]XXXXXXXXXXXXXXXXXXXXXXXXXXXo[]--<><>----[]-[][]--<>-[]--------------
XXXXXXXXXXXXXXXXXXXXXXXXXXXXXXXXXXXXXXXXXXXXXXXXXXXXXXXXXXXX----<>--o-[]XXXXXXXXXXXXXXXXXXXXXXXXXXX-[]--[][]----[]-[][]--[]-[]-------o------
XXXXXXXXXXXXXXXXXXXXXXXXXXXXXXXXXXXXXXXXXXXXXXXXXXXXXXXXXXXXo---[]----[]XXXXXXXXXXXXXXXXXXXXXXXXXXXXXXXXXXXXXXXXXXXXXXXXXXXXXX--E--E------E-
XXXXXXXXXXXXXXXXXXXXXXXXXXXXXXXXXXXXXXXXXXXXXXXXXXXXXXXXXXXXXXXXXXXXXXXXXXXXXXXXXXXXXXXXXXXXXXXXXXXXXXXXXXXXXXXXXXXXXXXXXXXXXXXXXXXXXXXXXXXX
XXXXXXXXXXXXXXXXXXXXXXXXXXXXXXXXXXXXXXXXXXXXXXXXXXXXXXXXXXXXXXXXXXXXXXXXXXXXXXXXXXXXXXXXXXXXXXXXXXXXXXXXXXXXXXXXXXXXXXXXXXXXXXXXXXXXXXXXXXXX
