----------------------------------------------------------------------------------------------------------------------------o---------------
-----------------------------------------------------------------------------------------------------------------------------o--------------
--------------------------------------------o----------------------------------------------o----------------------------------<>------------
------------------------------------------o-----------------------------------------<>------<>-<>-------------o---------------[]---------E--
----------------E--------------E----------------------------------------------------[]------[]-[]-E------E-SS--o<>o---<>-SS-E-[]--SSSSSSSSSS
----------o---SSSSSS---------oSSSS----o--o---------------------E-E-----E-------SS---[]-----E[]S[]SSS-XXXXXXX----[]----[]-XXXXXXX------------
-------------o------o-------------SSSSSSSS-----o------------SSSSSSSSSSSSS----SS----E[]---SXXXXXXXXXXXXXXXXXX----[]-o--[]-XXXXXXX------------
--------o-----------------------------XXXXXXXX------SSSS---------------------XXXXXXXXXXXXXXXXXXXXXXXXXXXXXXX----[]----[]EXXXXXXX------------
------------E--------E----------------XXXXXXXX-----o------<>-----------<>----XXXXXXXXXXXXXXXXXXXXXXXXXXXXXXXXXXXXXXXXXXXXXXXXXXX-------<>---
XXXXXXXXXXXXXXXXXXXXXXXXXXXXXXXXXXXXXXXXXXXXXX------------[]-----------[]----XXXXXXXXXXXXXXXXXXXXXXXXXXXXXXXXXXXXXXXXXXXXXXXXXXXXXXX<>-[]---
XXXXXXXXXXXXXXXXXXXXXXXXXXXXXXXXXXXXXXXXXXXXXX----------o-[]-<>--------[]E-E-XXXXXXXXXXXXXXXXXXXXXXXXXXXXXXXXXXXXXXXXXXXXXXXXXXXXXXX[]-[]---
XXXXXXXXXXXXXXXXXXXXXXXXXXXXXXXXXXXXXXXXXXXXXXXXXX--------[]-[]------XXXXXXXXXXXXXXXXXXXXXXXXXXXXXXXXXXXXXXXXXXXXXXXXXXXXXXXXXXXXXXX[]-[]---
XXXXXXXXXXXXXXXXXXXXXXXXXXXXXXXXXXXXXXXXXXXXXXXXXXXXXXXXXXXXXXXXXXXXXXXXXXXXXXXXXXXXXXXXXXXXXXXXXXXXXXXXXXXXXXXXXXXXXXXXXXXXXXXXXXXXXXXXXXXX
XXXXXXXXXXXXXXXXXXXXXXXXXXXXXXXXXXXXXXXXXXXXXXXXXXXXXXXXXXXXXXXXXXXXXXXXXXXXXXXXXXXXXXXXXXXXXXXXXXXXXXXXXXXXXXXXXXXXXXXXXXXXXXXXXXXXXXXXXXXX
