--------------------------------------------------------------------------------------------------------------------------------------------
------<>------------------------------------------------------------------------------------------------------------------------------------
------[]------------------------------------------------------------------------------------------------------------------------------------
------[]---------------------------------------------------------EE-------------------------------------------------------------o-----------
------[]----------------------------o-------------------------SSSSSSS-----------------------------------------------------------------------
XXXXXXXXX--oo-----o-o--o-----------------------------------------------------------------------------------------------------<>-SS----------
XXXXXXXXXo------o------------------------------------------------------------------------------------------------------------[]--------o----
XXXXXXXXX---<>-------SSSS--------o---------o-------------------------------------------------o-----------------o------------o[]----SSSo-----
XXXXXXXXX--E[]-----------Eo-----E------o--------------o----------<>-----------<>--------------------------------------------XXXXXXXXX-------
XXXXXXXXXXXXXXXXXXXXXXXXXXXXXXXXXXXXX---------------------<>-----[]----------o[]--o-------E--------------------<>o----------XXXXXXXXX-------
XXXXXXXXXXXXXXXXXXXXXXXXXXXXXXXXXXXXXo------o-------------[]-----[]-----------[]-------SSSSSSS---<>----<>------[]--<>SS<>---XXXXXXXXX------E
XXXXXXXXXXXXXXXXXXXXXXXXXXXXXXXXXXXXX---SSS--------------E[]-----[]---E-o-----[]E----------------[]-o--[]-----E[]--[]--[]--EXXXXXXXXXXXXXXXX
XXXXXXXXXXXXXXXXXXXXXXXXXXXXXXXXXXXXXXXXXXXXXXXXXXXXXXXXXXXXXXXXXXXXXXXXXXXXXXXXXXXXXXXXXXXXXXXXXXXXXXXXXXXXXXXXXXXXXXXXXXXXXXXXXXXXXXXXXXXX
XXXXXXXXXXXXXXXXXXXXXXXXXXXXXXXXXXXXXXXXXXXXXXXXXXXXXXXXXXXXXXXXXXXXXXXXXXXXXXXXXXXXXXXXXXXXXXXXXXXXXXXXXXXXXXXXXXXXXXXXXXXXXXXXXXXXXXXXXXXX
