--------------------------------------------------------------------------------------------------------------------------------------------
--------------------------------------------------------------------------------------------------------------------------------------------
------------------------------------------------------------------------------------------------------------------oo-------------o-------o--
-------------------o----------------------------------------------------------------------------------o--E------<>--------------------------
--------------------SS-------------------------SSS------------------------------------------------------SSSSSSSS[]------EEo---<>------------
----------------------------------o-----o-----------------------------------SS-----------------------o-o--------[]SSSSSSSSSSSS[]------------
-------------------E------------ESSoE----<>--o------------------------------------------------------------------[]------------[]---SS--SSSS-
-----------o---XXXXXXXX--o------XXXXXXXXX[]-----------------EE-----------EE-----o---------SS-----o-------XXXXXXXXXXXXXXXXXXXXXXXXXXXXXXXXX--
----------<>---XXXXXXXX---------XXXXXXXXX[]----<>----------SSSSSSS-----SSSSS----------------o---XXXXXXXXXXXXXXXXXXXXXXXXXXXXXXXXXXXXXXXXXXXX
----------[]---XXXXXXXX-----<>--XXXXXXXXX[]-o--[]-----E--o-------------------------------o------XXXXXXXXXXXXXXXXXXXXXXXXXXXXXXXXXXXXXXXXXXXX
----------[]-EoXXXXXXXXE-E--[]--XXXXXXXXXXXXXXXXXXXXXXXX----------------------<>----------------XXXXXXXXXXXXXXXXXXXXXXXXXXXXXXXXXXXXXXXXXXXX
XXXXXXXXXXXXXXXXXXXXXXXXXXXXXXXXXXXXXXXXXXXXXXXXXXXXXXXX----------------------[]---E---o-----oo-XXXXXXXXXXXXXXXXXXXXXXXXXXXXXXXXXXXXXXXXXXXX
XXXXXXXXXXXXXXXXXXXXXXXXXXXXXXXXXXXXXXXXXXXXXXXXXXXXXXXXXXXXXXXXXXXXXXXXXXXXXXXXXXXXXXXXXXXXXXXXXXXXXXXXXXXXXXXXXXXXXXXXXXXXXXXXXXXXXXXXXXXX
XXXXXXXXXXXXXXXXXXXXXXXXXXXXXXXXXXXXXXXXXXXXXXXXXXXXXXXXXXXXXXXXXXXXXXXXXXXXXXXXXXXXXXXXXXXXXXXXXXXXXXXXXXXXXXXXXXXXXXXXXXXXXXXXXXXXXXXXXXXX
