---------------------o----------------------------------------------------------------------------------------------------------------------
--------------------------------------------------------------------------------------------------------------------------------------------
--------------------------------------------------------------------------------------------------------------------------------------------
-----------------------------------E--------------------------------------------------------------------------------------------------------
---------------------SSSS------SSSSSSS----------------------E-----SSS-----------------------------------------------------------------------
-------------------XXXXXX---------------------------o------SSSSSSS----------------------------------------------------SS--------------------
-------------------XXXXXX-----------------------------------<>------------------------------------------------------------------------------
----------------o-EXXXXXX-<>--<>---<>------<>----o----------[]-------------------o-------o----------o----SS---------------------------------
-----<>---------XXXXXXXXX-[]E-[]---[]-----E[]---------<>----[]-------------o--------SSSS-----------------------o---o-------o----------------
-----[]---------XXXXXXXXXXXXX-[]---[]----SS[]---------[]----[]-----------------------------------SS--------------------------o-----<>--<>---
-----[]---------XXXXXXXXXXXXX-[]---[]-E----[]--ESS-XXXXXXXXXXXXXXXX-------<>---------------------<>-------------o--------------o<>-[]o-[]---
-----[]--------EXXXXXXXXXXXXXXXXXXXXXXXXXXXXXXXXXXXXXXXXXXXXXXXXXXX---E---[]EE-----------E------E[]-----o---------------E---o---[]-[]--[]---
XXXXXXXXXXXXXXXXXXXXXXXXXXXXXXXXXXXXXXXXXXXXXXXXXXXXXXXXXXXXXXXXXXXXXXXXXXXXXXXXXXXXXXXXXXXXXXXXXXXXXXXXXXXXXXXXXXXXXXXXXXXXXXXXXXXXXXXXXXXX
XXXXXXXXXXXXXXXXXXXXXXXXXXXXXXXXXXXXXXXXXXXXXXXXXXXXXXXXXXXXXXXXXXXXXXXXXXXXXXXXXXXXXXXXXXXXXXXXXXXXXXXXXXXXXXXXXXXXXXXXXXXXXXXXXXXXXXXXXXXX
