----------------------------------------------------------------oo------o-------------------------------------------------------------------
---------------------------------------------------------<>-<>---------------<>----o--o-----------------------------------------------------
---------------------------------------------------------[]-[]---------------[]-----<>------------------------------------------------------
-------------------------EE------------------------------[]-[]------o--------[]E----[]-------------------------------------------------E----
------------------------SSSSS----------E---EE-EE-E-----SS[]S[]SS-----------SS[]SSSSE[]-----------------SS--------EE-EE----------------SSS---
-------------------------------o--SSSSSSSSSSSSSSSSS-<>-XXXXXXXXXXXXXXXXXXXXXXXXXXXXXXX-EE------------------EE---SSSSSSS<>-------------------
--------------------------------------------<>------[]-XXXXXXXXXXXXXXXXXXXXXXXXXXXXXXXXXX--o------<>------SSSS---------[]---------o-------o-
----------o----o---SS-----------------------[]---XXXXXXXXXXXXXXXXXXXXXXXXXXXXXXXXXXXXXXXX---------[]-oo----------------[]SSS-------<>-<>----
XXXXXXXXE-----------------------------------[]---XXXXXXXXXXXXXXXXXXXXXXXXXXXXXXXXXXXXXXXX-----E---[]EE-----------------[]--------SS[]S[]<>--
XXXXXXXXXXXXX-------------------------------[]---XXXXXXXXXXXXXXXXXXXXXXXXXXXXXXXXXXXXXXXXXXXXXXXXXXXXXXXXXXXXXXXXXXXXXXXXXXXXXXXXXX[]-[][]--
XXXXXXXXXXXXXXXXXXXXXXXXXXXXXXXXXXXXXXXXXXXXXXXXXXXXXXXXXXXXXXXXXXXXXXXXXXXXXXXXXXXXXXXXXXXXXXXXXXXXXXXXXXXXXXXXXXXXXXXXXXXXXXXXXXXXXXXXXXXX
XXXXXXXXXXXXXXXXXXXXXXXXXXXXXXXXXXXXXXXXXXXXXXXXXXXXXXXXXXXXXXXXXXXXXXXXXXXXXXXXXXXXXXXXXXXXXXXXXXXXXXXXXXXXXXXXXXXXXXXXXXXXXXXXXXXXXXXXXXXX
XXXXXXXXXXXXXXXXXXXXXXXXXXXXXXXXXXXXXXXXXXXXXXXXXXXXXXXXXXXXXXXXXXXXXXXXXXXXXXXXXXXXXXXXXXXXXXXXXXXXXXXXXXXXXXXXXXXXXXXXXXXXXXXXXXXXXXXXXXXX
XXXXXXXXXXXXXXXXXXXXXXXXXXXXXXXXXXXXXXXXXXXXXXXXXXXXXXXXXXXXXXXXXXXXXXXXXXXXXXXXXXXXXXXXXXXXXXXXXXXXXXXXXXXXXXXXXXXXXXXXXXXXXXXXXXXXXXXXXXXX
