---------------------o----------------------------------------------------------------------------------------------------------------------
----------o--------<>--------oo-------------------------------------------------------------------------------------------------------------
-------o-o<>---o---[]-------<>-<>--------------------------------------------------------------------------------------------------------o--
----------[]-----<>[]-------[]-[]E-----EE-EE------------------------------------------------------------------------------------------------
------E---[]SS-E-[][]-------[]S[]SSS--SSSSSSS-----------------------------------------------------E-E---------------------------------------
XXXXXXXXXXXXXXXXXXXXXXXXXXXXXXXXXXXXXXXX--------------------------------------o--------------SSSSSSSSSSS-------------------oE-o--E----------
XXXXXXXXXXXXXXXXXXXXXXXXXXXXXXXXXXXXXXXX---------------------------------------------oo------------------------------------SSSSSSSSS--------
XXXXXXXXXXXXXXXXXXXXXXXXXXXXXXXXXXXXXXXX--<>-----------o------------------------o--------o---------------------------------<>-----------XXXX
XXXXXXXXXXXXXXXXXXXXXXXXXXXXXXXXXXXXXXXXXX[]---SSS-----<>-------<>o---<>------------------------------<>----------SSS-E----[]-------E---XXXX
XXXXXXXXXXXXXXXXXXXXXXXXXXXXXXXXXXXXXXXXXX[]------SS---[]-------[]---E[]-----oE-----------------------[]--------------XXXXXXXXXXXXXXXXXXXXXX
XXXXXXXXXXXXXXXXXXXXXXXXXXXXXXXXXXXXXXXXXX[]--o--------[]--o-SS-[]---XXXXXXXXXXXXXXXXXXX-----<>-------[]--------------XXXXXXXXXXXXXXXXXXXXXX
XXXXXXXXXXXXXXXXXXXXXXXXXXXXXXXXXXXXXXXXXXXXXE---------[]------E[]-E-XXXXXXXXXXXXXXXXXXXE----[]-------[]o---E---------XXXXXXXXXXXXXXXXXXXXXX
XXXXXXXXXXXXXXXXXXXXXXXXXXXXXXXXXXXXXXXXXXXXXXXXXXXXXXXXXXXXXXXXXXXXXXXXXXXXXXXXXXXXXXXXXXXXXXXXXXXXXXXXXXXXXXXXXXXXXXXXXXXXXXXXXXXXXXXXXXXX
XXXXXXXXXXXXXXXXXXXXXXXXXXXXXXXXXXXXXXXXXXXXXXXXXXXXXXXXXXXXXXXXXXXXXXXXXXXXXXXXXXXXXXXXXXXXXXXXXXXXXXXXXXXXXXXXXXXXXXXXXXXXXXXXXXXXXXXXXXXX
