---------------------------------------------------o------------------------------------------------------------------------------o-----o---
--------------------------------------------------------------------------------------------------------------------------------------------
-------------------------------------------<>----------------------------<>-----<>----------------<>------------------------o---------o-<>o-
-------------------------------------------[]---o--------------o------o--[]----E[]-------o--o-o---[]--------------------------------oo--[]EE
---------------<>----SS<>--------------o--S[]----SSS--E--E---SS---o------[]--SSS[]SSS-------------[]---------o--------SS----SS----SS----[]SS
-----<>o-------[]------[]<>---------<>---XXXXXXXXXXXXXXXXXXXXXXXXXXXXXXXXXXXXXXXXX---------<>--E--[]-----o---------o--XXXXXXXXXXXXXXXXXXXX--
-----[]--------[]------[][]---------[]---XXXXXXXXXXXXXXXXXXXXXXXXXXXXXXXXXXXXXXXXX---------[]--XXXXX---SS-------o--XXXXXXXXXXXXXXXXXXXXXXXXX
-----[]---E----[]SS----[][]--------E[]---XXXXXXXXXXXXXXXXXXXXXXXXXXXXXXXXXXXXXXXXX---EE----[]--XXXXX-------SS------XXXXXXXXXXXXXXXXXXXXXXXXX
XXXXXXXXXXXXXXXXXXXXXXXXXXXXXXXXXXXXXX-E-XXXXXXXXXXXXXXXXXXXXXXXXXXXXXXXXXXXXXXXXXXXXXXXXXXXXXXXXXXX----------E----XXXXXXXXXXXXXXXXXXXXXXXXX
XXXXXXXXXXXXXXXXXXXXXXXXXXXXXXXXXXXXXXXXXXXXXXXXXXXXXXXXXXXXXXXXXXXXXXXXXXXXXXXXXXXXXXXXXXXXXXXXXXXXXXXXXXXXXXXXXXXXXXXXXXXXXXXXXXXXXXXXXXXX
XXXXXXXXXXXXXXXXXXXXXXXXXXXXXXXXXXXXXXXXXXXXXXXXXXXXXXXXXXXXXXXXXXXXXXXXXXXXXXXXXXXXXXXXXXXXXXXXXXXXXXXXXXXXXXXXXXXXXXXXXXXXXXXXXXXXXXXXXXXX
XXXXXXXXXXXXXXXXXXXXXXXXXXXXXXXXXXXXXXXXXXXXXXXXXXXXXXXXXXXXXXXXXXXXXXXXXXXXXXXXXXXXXXXXXXXXXXXXXXXXXXXXXXXXXXXXXXXXXXXXXXXXXXXXXXXXXXXXXXXX
XXXXXXXXXXXXXXXXXXXXXXXXXXXXXXXXXXXXXXXXXXXXXXXXXXXXXXXXXXXXXXXXXXXXXXXXXXXXXXXXXXXXXXXXXXXXXXXXXXXXXXXXXXXXXXXXXXXXXXXXXXXXXXXXXXXXXXXXXXXX
XXXXXXXXXXXXXXXXXXXXXXXXXXXXXXXXXXXXXXXXXXXXXXXXXXXXXXXXXXXXXXXXXXXXXXXXXXXXXXXXXXXXXXXXXXXXXXXXXXXXXXXXXXXXXXXXXXXXXXXXXXXXXXXXXXXXXXXXXXXX
