---------------------------------------o----------------------------------------------------------------------------------------------------
--------------------------------------------------------------------------------------------------------------------------------------------
------------------------o--o--o---------------<>-<>o-------------------o--------------------------------------------------------------------
-------------------o---------------o-----<>-o-[]-[]<>-E----E--------------------------------------------------------------------------------
---------------------------E---o-E----SSS[]---[]-[][]SSSSSSSSS----------------------------------------------------------------------------ES
------------------<>---<>-XXXXXXXXXXXXXXXXXXXXXXXXXXXXXXXXX--------<>SS---o-------------------SSS---------------------------------------XXXX
------------------[]EE-[]-XXXXXXXXXXXXXXXXXXXXXXXXXXXXXXXXX--------[]----EE---SS--------------------------------------------------------XXXX
------------XXXXXXXXXXXXXXXXXXXXXXXXXXXXXXXXXXXXXXXXXXXXXXX--------[]XXXXXXXXXXXX-----o--SSSS------------o---------------------------<>-XXXX
--------o---XXXXXXXXXXXXXXXXXXXXXXXXXXXXXXXXXXXXXXXXXXXXXXXXXXXXXXXXXXXXXXXXXXXXX-<>---<><>-------SSSSSS--------o-------<>----o------[]EXXXX
---------<>-XXXXXXXXXXXXXXXXXXXXXXXXXXXXXXXXXXXXXXXXXXXXXXXXXXXXXXXXXXXXXXXXXXXXXE[]---[][]----<>------<>---------------[]----------XXXXXXXX
--------E[]EXXXXXXXXXXXXXXXXXXXXXXXXXXXXXXXXXXXXXXXXXXXXXXXXXXXXXXXXXXXXXXXXXXXXXXXX-o-[][]----[]------[]---Eo----------[]-------o--XXXXXXXX
XXXXXXXXXXXXXXXXXXXXXXXXXXXXXXXXXXXXXXXXXXXXXXXXXXXXXXXXXXXXXXXXXXXXXXXXXXXXXXXXXXXX--E[][]---XXXXXXXXXXXXXXXXE-E-------[]o-----EXXXXXXXXXXX
XXXXXXXXXXXXXXXXXXXXXXXXXXXXXXXXXXXXXXXXXXXXXXXXXXXXXXXXXXXXXXXXXXXXXXXXXXXXXXXXXXXXXXXXXXXXXXXXXXXXXXXXXXXXXXXXXXXXXXXXXXXXXXXXXXXXXXXXXXXX
XXXXXXXXXXXXXXXXXXXXXXXXXXXXXXXXXXXXXXXXXXXXXXXXXXXXXXXXXXXXXXXXXXXXXXXXXXXXXXXXXXXXXXXXXXXXXXXXXXXXXXXXXXXXXXXXXXXXXXXXXXXXXXXXXXXXXXXXXXXX
