--------------------------------------------------------------------------------------------------------------------------------------------
--------------------------------------------------------------------------------------------------------------------------------------------
--------------------------------------------------------------------------------------------------------------------------------------------
----------------------o-----------------------------------------------------------------------------------------------------------------o---
-------------<>---o<>---<>----o---------------------------------------------------oo--------SSSSS-------------------------------------------
-------------[]o---[]---[]------------<>EE-EE--------------o-----------o--------------------------------------o-----------------------------
--------o----[]----[]-E-[]EE---------S[]SSSSSS--EEo-----o-------o---------------o---------------------------------<>----------------------XX
-------------[]SSE-[]SSS[]SSS-----o--XXXXXXXXXXXXXXXXXXXXX-------------------o------SSSSSSSo-----------o----------[]-------EE---o--------SXX
---------o-XXXXXXXXXXXXXXXXXXXXXXXXXXXXXXXXXXXXXXXXXXXXXXX------------SS<>---<>XXXXXXXX----------------SSSo--<>---[]-----SSSSS--------oXXXXX
-----------XXXXXXXXXXXXXXXXXXXXXXXXXXXXXXXXXXXXXXXXXXXXXXX-E-EE---E-----[]---[]XXXXXXXX----E----------E-----E[]XXXXXXXXXXXXXXX--<>-----XXXXX
-----------XXXXXXXXXXXXXXXXXXXXXXXXXXXXXXXXXXXXXXXXXXXXXXXXXXXXXXXXXXXXXXXXXXXXXXXXXXXXXXXXXXXXXXXXXXXXXXXXXXXXXXXXXXXXXXXXXXX--[]-<>E-XXXXX
XXXXXXXXXXXXXXXXXXXXXXXXXXXXXXXXXXXXXXXXXXXXXXXXXXXXXXXXXXXXXXXXXXXXXXXXXXXXXXXXXXXXXXXXXXXXXXXXXXXXXXXXXXXXXXXXXXXXXXXXXXXXXX--[]E[]SSXXXXX
XXXXXXXXXXXXXXXXXXXXXXXXXXXXXXXXXXXXXXXXXXXXXXXXXXXXXXXXXXXXXXXXXXXXXXXXXXXXXXXXXXXXXXXXXXXXXXXXXXXXXXXXXXXXXXXXXXXXXXXXXXXXXXXXXXXXXXXXXXXX
XXXXXXXXXXXXXXXXXXXXXXXXXXXXXXXXXXXXXXXXXXXXXXXXXXXXXXXXXXXXXXXXXXXXXXXXXXXXXXXXXXXXXXXXXXXXXXXXXXXXXXXXXXXXXXXXXXXXXXXXXXXXXXXXXXXXXXXXXXXX
