--------------------------------------------------------------------------------------------------------------------------------------------
--------------------------------------------------------------------------------------------------------------------------------------------
----------------------------------------------------------------------------------------------------------------o---------------------------
--------------------------------------------------------------<>--------------------------------------------------------o------------------o
--------------------------------o-----o------------o-o----E-E-[]----------------o--E---------o---SS---------------o-----------------------SS
-------o-------------------------<><>-------SSS-----<>--XXXXXXXX------------<>---SSSS----------------<>---------------------o---------------
---------------------------------[][]----SS----o----[]--XXXXXXXX------------[]--------o-----E-E----<>[]---------------E---------o--------oXX
-----------------o---------------[][]-------------SS[]S-XXXXXXXX------------[]---<>-----<>-SSSSS---[][]E--E-----XXXXXXXXXX--------<>--o---XX
--------o----------<>------<>----[][]------------XXXXXXXXXXXXXXX--SSSo------[]---[]-----[]---------[][]SSSSSS---XXXXXXXXXX--<>----[]--<>--XX
------o------------[]----<>[]--oXXXXXXXXXXXXXXXXXXXXXXXXXXXXXXXXXXXXXXXXXXXXXXXXXXXXXXXXXXXXXXXXXXXXXXXXXXXXXXXXXXXXXXXXXX--[]-E--[]o-[]--XX
XXXXXXXXX----<>---S[]----[][]---XXXXXXXXXXXXXXXXXXXXXXXXXXXXXXXXXXXXXXXXXXXXXXXXXXXXXXXXXXXXXXXXXXXXXXXXXXXXXXXXXXXXXXXXXXXXXXXXXXXXXXXXXXXX
XXXXXXXXX----[]----[]---E[][]S--XXXXXXXXXXXXXXXXXXXXXXXXXXXXXXXXXXXXXXXXXXXXXXXXXXXXXXXXXXXXXXXXXXXXXXXXXXXXXXXXXXXXXXXXXXXXXXXXXXXXXXXXXXXX
XXXXXXXXXXXXXXXXXXXXXXXXXXXXXXXXXXXXXXXXXXXXXXXXXXXXXXXXXXXXXXXXXXXXXXXXXXXXXXXXXXXXXXXXXXXXXXXXXXXXXXXXXXXXXXXXXXXXXXXXXXXXXXXXXXXXXXXXXXXX
XXXXXXXXXXXXXXXXXXXXXXXXXXXXXXXXXXXXXXXXXXXXXXXXXXXXXXXXXXXXXXXXXXXXXXXXXXXXXXXXXXXXXXXXXXXXXXXXXXXXXXXXXXXXXXXXXXXXXXXXXXXXXXXXXXXXXXXXXXXX
