--------------------------------------------------------------------------------------------------------------------------------------------
--------------------------------------------------------------------------------------------------------------------------------------------
--------------------------------------------------------------------------o-----------------------------------------------------------------
--------------------------------<>-----------------------------------<>o----o------o----------EE--------------------------------------------
--------------------------------[]--------------------------o---o-SSS[]----------------------SSSSSSSSSS------------------------------E------
--------------------------------[]-----------------------------o-----[]S-------------o----o<>--------------------------------o-SSSSSSSSS----
--------------------------------[]SSSS--E-SS-----<>-----<>-----------[]------o-------------[]--------<>-------<>-<>-----------------------<>
--------------<>--------------XXXXXXXXXXX--------[]----S[]SSSS-<>-XXXXXXXXX-----o----------[]--------[]-------[]-[]----<>-----------------[]
-------E------[]-<>-----------XXXXXXXXXXX------E-[]-----[]-----[]-XXXXXXXXXXXXXXXXXXXXXXXXXXXXXXXX---[]-o-----[]-[]----[]---SS----------<>[]
XXXXXXXXX----o[]-[]---<>--<>--XXXXXXXXXXXXXXXXXXXXXXXXXXXXXXXXXXXXXXXXXXXXXXXXXXXXXXXXXXXXXXXXXXXX---[]-E-----[]-[]----[]o--------------[][]
XXXXXXXXX-----[]-[]-o-[]-S[]o-XXXXXXXXXXXXXXXXXXXXXXXXXXXXXXXXXXXXXXXXXXXXXXXXXXXXXXXXXXXXXXXXXXXXXXXXXXXXXXXXXXXXXXXXXXXXXXXXXXXXXXXXXXXXXX
XXXXXXXXXXXXXXXXXXXXXXXXXXXXXXXXXXXXXXXXXXXXXXXXXXXXXXXXXXXXXXXXXXXXXXXXXXXXXXXXXXXXXXXXXXXXXXXXXXXXXXXXXXXXXXXXXXXXXXXXXXXXXXXXXXXXXXXXXXXX
XXXXXXXXXXXXXXXXXXXXXXXXXXXXXXXXXXXXXXXXXXXXXXXXXXXXXXXXXXXXXXXXXXXXXXXXXXXXXXXXXXXXXXXXXXXXXXXXXXXXXXXXXXXXXXXXXXXXXXXXXXXXXXXXXXXXXXXXXXXX
XXXXXXXXXXXXXXXXXXXXXXXXXXXXXXXXXXXXXXXXXXXXXXXXXXXXXXXXXXXXXXXXXXXXXXXXXXXXXXXXXXXXXXXXXXXXXXXXXXXXXXXXXXXXXXXXXXXXXXXXXXXXXXXXXXXXXXXXXXXX
