--------------------------------------------------------------------------------------------------------------------------------------------
---------------------------------------------<>---------------------------------------------------------------------------------------------
------------o--<>-------o--------------------[]---------------------------------------------------------------------------------------------
-------o-------[]----o--<>--E-o---o----o-----[]-----------------------------------------E---------------------------------------------------
-------------SS[]------S[]SSSS-SS--E--------o[]----------------------SS----------------SSS---------SSSS----------------SS-------------------
----------XXXXXXXXXXXXXXXXXXXXXXXXXXXXXXXXXXXXXX--o-----o-----------------------------------------------------------------------------------
--------o-XXXXXXXXXXXXXXXXXXXXXXXXXXXXXXXXXXXXXXo------------------------------o----------------o-------------------------------------------
----------XXXXXXXXXXXXXXXXXXXXXXXXXXXXXXXXXXXXXX-----------SSSS---------------------E------<>-E-----<>---o-E--------------------o----SS-----
XXXXXXXXXXXXXXXXXXXXXXXXXXXXXXXXXXXXXXXXXXXXXXXX---------E--------------o--<>------SSS-----[]SSSSS--[]----SSS--------<>-------oSSSS---------
XXXXXXXXXXXXXXXXXXXXXXXXXXXXXXXXXXXXXXXXXXXXXXXXXXXXXXXXXXXXXX-------------[]--------------[]XXXXXXXXX---------------[]-----oo--------------
XXXXXXXXXXXXXXXXXXXXXXXXXXXXXXXXXXXXXXXXXXXXXXXXXXXXXXXXXXXXXX-SS---XXXX---[]---E----------[]XXXXXXXXX--------<>-----[]-<>o<>-----------<>--
XXXXXXXXXXXXXXXXXXXXXXXXXXXXXXXXXXXXXXXXXXXXXXXXXXXXXXXXXXXXXX---XXXXXXX---[]-XXXXXXXXXXXXXXXXXXXXXXXX--------[]-----[]-[]-[]-----------[]--
XXXXXXXXXXXXXXXXXXXXXXXXXXXXXXXXXXXXXXXXXXXXXXXXXXXXXXXXXXXXXXXXXXXXXXXXXXXXXXXXXXXXXXXXXXXXXXXXXXXXXXXXXXXXXXXXXXXXXXXXXXXXXXXXXXXXXXXXXXXX
XXXXXXXXXXXXXXXXXXXXXXXXXXXXXXXXXXXXXXXXXXXXXXXXXXXXXXXXXXXXXXXXXXXXXXXXXXXXXXXXXXXXXXXXXXXXXXXXXXXXXXXXXXXXXXXXXXXXXXXXXXXXXXXXXXXXXXXXXXXX
