----------------------------------------------------------------------------------------------------------------------------o---------------
-----------------------------------------------------------------------------------------------------<>----------------------------<>---o---
-------------------------------------------------------------------------------------<>-----o--------[]-o----<>-------<>-----------[]-------
-------<>o---------------------------------------------------------------------------[]o-oo-E-----<>E[]------[]o------[]-----------[]-------
-------[]---<>o-------------------SSS----------------------EEE--------------oo-------[]SSS-SSS---S[]S[]SSSS--[]-------[]-----E---SS[]o----SS
-------[]---[]-------------------------------------------SSSSSSS---------------o----XXXXXXXXXXXXXXXXXXXXXXXXXXXXXXXXXXXXXXXXXXXXXXXXXXXXXXXX
-------[]---[]-o---------o----------------------------------<>----------------------XXXXXXXXXXXXXXXXXXXXXXXXXXXXXXXXXXXXXXXXXXXXXXXXXXXXXXXX
XXXXXXXXXXXXXXXX---------------<>---------------------------[]-------------------SSSXXXXXXXXXXXXXXXXXXXXXXXXXXXXXXXXXXXXXXXXXXXXXXXXXXXXXXXX
XXXXXXXXXXXXXXXX------<>---<>S-[]-----------<>------o-----XXXX--------------XXXXXXXXXXXXXXXXXXXXXXXXXXXXXXXXXXXXXXXXXXXXXXXXXXXXXXXXXXXXXXXX
XXXXXXXXXXXXXXXX<>----[]--o[]--[]-----------[]--<><>-<>-o-XXXX-------o--o---XXXXXXXXXXXXXXXXXXXXXXXXXXXXXXXXXXXXXXXXXXXXXXXXXXXXXXXXXXXXXXXX
XXXXXXXXXXXXXXXX[]-E--[]---[]--[]-----------[]--[][]-[]---XXXX--------<>----XXXXXXXXXXXXXXXXXXXXXXXXXXXXXXXXXXXXXXXXXXXXXXXXXXXXXXXXXXXXXXXX
XXXXXXXXXXXXXXXXXXXXXXXXXXXXXXXXXXXXXXXX--o-[]--[][]-[]---XXXXXXXX----[]----XXXXXXXXXXXXXXXXXXXXXXXXXXXXXXXXXXXXXXXXXXXXXXXXXXXXXXXXXXXXXXXX
XXXXXXXXXXXXXXXXXXXXXXXXXXXXXXXXXXXXXXXXXXXXXXXXXXXXXXXXXXXXXXXXXXXXXXXXXXXXXXXXXXXXXXXXXXXXXXXXXXXXXXXXXXXXXXXXXXXXXXXXXXXXXXXXXXXXXXXXXXXX
XXXXXXXXXXXXXXXXXXXXXXXXXXXXXXXXXXXXXXXXXXXXXXXXXXXXXXXXXXXXXXXXXXXXXXXXXXXXXXXXXXXXXXXXXXXXXXXXXXXXXXXXXXXXXXXXXXXXXXXXXXXXXXXXXXXXXXXXXXXX
