---------------------------------------------------------------------------------------------o----------------------------------------------
--------------------------------------------------------------------------------------------------------------------------------------------
---------------------------------------------------------------------------------------<>------------------------------------------------o--
--------------------------------------------------------------------------------------E[]--E------------------------------------------------
-----------------------------------------------o------oo-----E---SS------------------SS[]SSSSSo------------------o--------------o-----------
---------------------------------------E--E--------o-------oSSS-o---------E-----E------[]-XXXX-------SSSS-----------o-------SS-o-SS---------
---------------------------EE-------SSSSSSSS------------o--------<>-SXXXXXXXXXXXXXXXXXXXXXXXXX-------------------<>--<>-----<>-S<>-----SSSSS
------<>----------<>---oSSSSSSSSSS-----------<>E--SSSSSSS--E-----[]E-XXXXXXXXXXXXXXXXXXXXXXXXXXXXX---------o-<>E-[]--[]-----[]--[]---XXXXXXX
------[]----------[]-------------------------[]XXXXXXXXXXXXXXXXXXXXXXXXXXXXXXXXXXXXXXXXXXXXXXXXXXX-----------[]XXXXXXXXXXXXXXXXXXXXXXXXXXXXX
------[]---------o[]-------------------------[]XXXXXXXXXXXXXXXXXXXXXXXXXXXXXXXXXXXXXXXXXXXXXXXXXXX-EE-----o--[]XXXXXXXXXXXXXXXXXXXXXXXXXXXXX
------[]-----E----[]--o------------E---------[]XXXXXXXXXXXXXXXXXXXXXXXXXXXXXXXXXXXXXXXXXXXXXXXXXXXXXXXXXXXXXXXXXXXXXXXXXXXXXXXXXXXXXXXXXXXXX
XXXXXXXXXXXXXXXXXXXXXXXXXXXXXXXXXXXXXXXXXXXXXXXXXXXXXXXXXXXXXXXXXXXXXXXXXXXXXXXXXXXXXXXXXXXXXXXXXXXXXXXXXXXXXXXXXXXXXXXXXXXXXXXXXXXXXXXXXXXX
XXXXXXXXXXXXXXXXXXXXXXXXXXXXXXXXXXXXXXXXXXXXXXXXXXXXXXXXXXXXXXXXXXXXXXXXXXXXXXXXXXXXXXXXXXXXXXXXXXXXXXXXXXXXXXXXXXXXXXXXXXXXXXXXXXXXXXXXXXXX
XXXXXXXXXXXXXXXXXXXXXXXXXXXXXXXXXXXXXXXXXXXXXXXXXXXXXXXXXXXXXXXXXXXXXXXXXXXXXXXXXXXXXXXXXXXXXXXXXXXXXXXXXXXXXXXXXXXXXXXXXXXXXXXXXXXXXXXXXXXX
