--------------------------------------------------------------------------------------------------------------------------------------------
--------------------------------------------------------------------------------------------------------------------------------------------
-------o--------------------------------------------------------------------------------------------------------------o-<>---o-----------o--
--------------------------------------------------------------------------------------------------------------------<>--[]------o-----------
-------E-----E-------------------------------------------------E------------------------------------------<>--------[]--[]------Eo-----o----
XXXXXXXXXXXXXX-<>---------------------------------------------SSS--------------------------------------<>-[]-<>----XXXXXXXXXXXXXXXXXXXXXXXXX
XXXXXXXXXXXXXX-[]--o-SSSS--------------------------------o--<>-<>-------SS-----------------------------[]-[]-[]----XXXXXXXXXXXXXXXXXXXXXXXXX
XXXXXXXXXXXXXX-[]------------------------------------------E[]-[]<>---o--------------------------------[]E[]E[]----XXXXXXXXXXXXXXXXXXXXXXXXX
XXXXXXXXXXXXXX-[]--E--------------o----------------------SSS[]-[][]------------------------SSSS--<>---XXXXXXXXXXXXXXXXXXXXXXXXXXXXXXXXXXXXXX
XXXXXXXXXXXXXXXXXXXXXXXX----oo-------------------------SS---[]-[][]o-----------<>-<>-------------[]---XXXXXXXXXXXXXXXXXXXXXXXXXXXXXXXXXXXXXX
XXXXXXXXXXXXXXXXXXXXXXXX----SS--------o------------XXXXXXXXXXXXXXXX------------[]-[]---------<>--[]---XXXXXXXXXXXXXXXXXXXXXXXXXXXXXXXXXXXXXX
XXXXXXXXXXXXXXXXXXXXXXXX------------o--E----E------XXXXXXXXXXXXXXXX------------[]S[]---------[]--[]---XXXXXXXXXXXXXXXXXXXXXXXXXXXXXXXXXXXXXX
XXXXXXXXXXXXXXXXXXXXXXXXXXXXXXXXXXXXXXXXXXXXXXXXXXXXXXXXXXXXXXXXXXXXXXXXXXXXXXXXXXXXXXXXXXXXXXXXXXXXXXXXXXXXXXXXXXXXXXXXXXXXXXXXXXXXXXXXXXXX
XXXXXXXXXXXXXXXXXXXXXXXXXXXXXXXXXXXXXXXXXXXXXXXXXXXXXXXXXXXXXXXXXXXXXXXXXXXXXXXXXXXXXXXXXXXXXXXXXXXXXXXXXXXXXXXXXXXXXXXXXXXXXXXXXXXXXXXXXXXX
