--------------------------------------------------------------------------------------------------------------------------------------------
------------------------------------------------------------------------------------------------------------------------------------o-----<>
-----------------------------------------------------------------------------------------------------------------------------------o-<>---[]
-------<>-----------------E---------------------------------------------------------------------------------------------------E----E-[]---[]
-----<>[]------o-----<>--SSSS---EE-----------------------------o--o---------------------E-----<>--------o-----------------oSSSSSSSSSS[]---[]
-----[][]-----------E[]--------<>SSSSS------------------------------SS-----------------SSSS---[]--------------------E-E---<>XXXXXXXXXXXXXXXX
-----[][]---E---SSSSS[]--------[]----<>------<>-------<><>-------XXXXXXXX---------------------[]---<>----o---------<>SSSSS[]XXXXXXXXXXXXXXXX
XXXXXXXXXXXXXXXXXXXXXXXXXXXXXXXXXXX<>[]------[]-------[][]---SSXXXXXXXXXX---o-------------XXXXXX--E[]o-E----------o[]-----[]XXXXXXXXXXXXXXXX
XXXXXXXXXXXXXXXXXXXXXXXXXXXXXXXXXXX[][]------[]-------[][]-----XXXXXXXXXX<>--o----o-------XXXXXXXXXXXXXXXXXX-------[]----XXXXXXXXXXXXXXXXXXX
XXXXXXXXXXXXXXXXXXXXXXXXXXXXXXXXXXX[][]o-E---[]SS-E---[][]--E--XXXXXXXXXX[]----o--E-------XXXXXXXXXXXXXXXXXXE-o-o--[]----XXXXXXXXXXXXXXXXXXX
XXXXXXXXXXXXXXXXXXXXXXXXXXXXXXXXXXXXXXXXXXXXXXXXXXXXXXXXXXXXXXXXXXXXXXXXXXXXXXXXXXXXXE----XXXXXXXXXXXXXXXXXXXXXXXXXXXXXXXXXXXXXXXXXXXXXXXXXX
XXXXXXXXXXXXXXXXXXXXXXXXXXXXXXXXXXXXXXXXXXXXXXXXXXXXXXXXXXXXXXXXXXXXXXXXXXXXXXXXXXXXXXXXXXXXXXXXXXXXXXXXXXXXXXXXXXXXXXXXXXXXXXXXXXXXXXXXXXXX
XXXXXXXXXXXXXXXXXXXXXXXXXXXXXXXXXXXXXXXXXXXXXXXXXXXXXXXXXXXXXXXXXXXXXXXXXXXXXXXXXXXXXXXXXXXXXXXXXXXXXXXXXXXXXXXXXXXXXXXXXXXXXXXXXXXXXXXXXXXX
XXXXXXXXXXXXXXXXXXXXXXXXXXXXXXXXXXXXXXXXXXXXXXXXXXXXXXXXXXXXXXXXXXXXXXXXXXXXXXXXXXXXXXXXXXXXXXXXXXXXXXXXXXXXXXXXXXXXXXXXXXXXXXXXXXXXXXXXXXXX
