--------------------------------------------------------------------------------------------------------------------------------------------
--------------------------------------------------------------------------------------------------------------------------------------------
--------------------------------------------------------------------------------------------------------------------------------------------
-------------------------------------------------------------------------------------E----------------------E-------------------------------
------------------------------------------------------------------------------------SSSS-------o---------SSSSS------------------------------
-----------------------------------------------------------------------------------------------------------------o------------------------SS
---------------------------------------E---E----o-E--------------------------------------------------o--------o-------------------------o---
------------<>---------------------SSSSSSSSSSSSSSSSS-------------------------o-SS---------o---<>---------------SSSS---------o<>-o-----------
------------[]------EE----------------------------------XXXXXXXX------<>----------------------[]-E-----------------SSSS------[]o------------
------------[]----SSSSSSS----------------------------E--XXXXXXXX------[]--------------------XXXXXXXXXXXXXXXXXXXXXXXX---------[]---<>--------
------E-----[]-E------------o---SSS-------------XXXXXXXXXXXXXXXX----<>[]-----------<>-------XXXXXXXXXXXXXXXXXXXXXXXX---------[]---[]-E-o----
XXXXXXXXXXXXXXXXXXXX----------------------------XXXXXXXXXXXXXXXX----[][]-----------[]-------XXXXXXXXXXXXXXXXXXXXXXXX---XXXXXXXXXXXXXXXXXXXXX
XXXXXXXXXXXXXXXXXXXXXXXXXXXXXXXXXXXXXXXXXXXXXXXXXXXXXXXXXXXXXXXXXXXXXXXXXXXXXXXXXXXXXXXXXXXXXXXXXXXXXXXXXXXXXXXXXXXXXXXXXXXXXXXXXXXXXXXXXXXX
XXXXXXXXXXXXXXXXXXXXXXXXXXXXXXXXXXXXXXXXXXXXXXXXXXXXXXXXXXXXXXXXXXXXXXXXXXXXXXXXXXXXXXXXXXXXXXXXXXXXXXXXXXXXXXXXXXXXXXXXXXXXXXXXXXXXXXXXXXXX
