--------------------------------------------------------------------------------------------------------------------------------------------
---------o----o-----------------------------------------------------------------------------------------------------------------------------
--------------------------------------------------------------------------------------------------------------------------------------------
-------<>-----------------------------------------------------------------------------------------------------------------------------------
-------[]----------------------------------------E-E-E----------------------------------------------------------o-o-------------------------
------E[]------------o-----------------------SSSSSSSSSS------------------------------------------------------------------<>-----------------
XXXXXXXXXXXXXXX---------o----o------o--E----------------------------------------------------------------------------E-E--[]-<>--------------
XXXXXXXXXXXXXXX-o-----o-----------Eo--SSSSS---------------o----------------------------o------o-----o--------SS--SSSSSSSS[]S[]----o-o-------
XXXXXXXXXXXXXXX----------EE-E-XXXXXXXXXX---<>------<>---o----<>-------------------------oo------------<>---o----E--------[]-[]--E-----oo-oSS
XXXXXXXXXXXXXXX--o---SSSSSSSSSXXXXXXXXXXXXX[]------[]--------[]----------<>---------------o-----------[]--------XXXXXXXXXXXXXXXXXXXXX-------
XXXXXXXXXXXXXXXXXXXXXXXXXXXXXXXXXXXXXXXXXXX[]------[]<>------[]-E--o---<>[]o---<>-----------o--o-EEE--[]--------XXXXXXXXXXXXXXXXXXXXX-------
XXXXXXXXXXXXXXXXXXXXXXXXXXXXXXXXXXXXXXXXXXX[]------[][]-----S[]SSS-----[][]----[]------------E-SSSSSSS[]-------SXXXXXXXXXXXXXXXXXXXXXE------
XXXXXXXXXXXXXXXXXXXXXXXXXXXXXXXXXXXXXXXXXXXXXXXXXXXXXXXXXXXXXXXXXXXXXXXXXXXXXXXXXXXXXXXXXXXXXXXXXXXXXXXXXXXXXXXXXXXXXXXXXXXXXXXXXXXXXXXXXXXX
XXXXXXXXXXXXXXXXXXXXXXXXXXXXXXXXXXXXXXXXXXXXXXXXXXXXXXXXXXXXXXXXXXXXXXXXXXXXXXXXXXXXXXXXXXXXXXXXXXXXXXXXXXXXXXXXXXXXXXXXXXXXXXXXXXXXXXXXXXXX
