--------------------------------------------------------------------------------------------------------------------------------------------
--------------------------------------------------------------------------------------------------------------------------------------------
-----<>------------------------------------------------------------------------------------------------------------<>-------------o---------
-----[]-------------------------------------------E------------------------------------o---o-----------o-----------[]------------<>---------
-----[]----E--------------------o----------------SSSS--------o-------------------------E----------E-----<>-----<>--[]--SS------o-[]---------
-----[]XXXXX----o---------<>-----------------------------E------E-----------------SSSSSSSSS--<>SSSSSS---[]-----[]--[]--------E---[]---------
XXXXXXXXXXXX--------<>o---[]---------------------------SSSSSSSSSSS----o------EE-------------E[]---------[]-E---[]-XXXXXXXXXXSSSS-[]---E--E--
XXXXXXXXXXXX--------[]----[]-----------------SSS----<>--------------------SSS<>S-----XXXXXXXXXXXXXX---o-[]SSS--[]SXXXXXXXXXX--XXXXXoSSSSSSSS
XXXXXXXXXXXX-----EE-[]----[]--o-E-------------------[]-------------<>--------[]------XXXXXXXXXXXXXXXXXXXXXXXXXXXXXXXXXXXXXXXXXXXXXX---------
XXXXXXXXXXXXXXXXXXXXXXXXXXXXXXXXXXXX----------------[]----XXXX-----[]--o-----[]-<>---XXXXXXXXXXXXXXXXXXXXXXXXXXXXXXXXXXXXXXXXXXXXXX---------
XXXXXXXXXXXXXXXXXXXXXXXXXXXXXXXXXXXX--------o-------[]E---XXXX----E[]--------[]-[]---XXXXXXXXXXXXXXXXXXXXXXXXXXXXXXXXXXXXXXXXXXXXXXXX-------
XXXXXXXXXXXXXXXXXXXXXXXXXXXXXXXXXXXX--oo-E-------XXXXXXXXXXXXXXXXXXXXXXXXXXXXXXXXXXXXXXXXXXXXXXXXXXXXXXXXXXXXXXXXXXXXXXXXXXXXXXXXXXXXXXXXXXX
XXXXXXXXXXXXXXXXXXXXXXXXXXXXXXXXXXXXXXXXXXXXXXXXXXXXXXXXXXXXXXXXXXXXXXXXXXXXXXXXXXXXXXXXXXXXXXXXXXXXXXXXXXXXXXXXXXXXXXXXXXXXXXXXXXXXXXXXXXXX
XXXXXXXXXXXXXXXXXXXXXXXXXXXXXXXXXXXXXXXXXXXXXXXXXXXXXXXXXXXXXXXXXXXXXXXXXXXXXXXXXXXXXXXXXXXXXXXXXXXXXXXXXXXXXXXXXXXXXXXXXXXXXXXXXXXXXXXXXXXX
