-------------------------------------------------------------------------------------------------------------------------------------------o
------------------------------oo------------o-------------------------------------------------------------------------------o-----o---------
--------------------------------o-------------<>--------------------------------------------------------------------------------------------
-----------------------------E--E-------------[]----------------------------------------------------------------------------------E---------
-------------------o-------SSSSSSSSS----------[]---------------------------------------------------SSS----------------------SSSSSSSS--<><>-E
----------<>-----------SS--XXXXXX------------E[]EE-E-------------------------------------E---EE----------o---------------o------------[][]-X
-----<>--o[]-o<>-SSS-------XXXXXXXXXXXXXXXXXXXXXXXXX-o-----<>S------------------------SSSS<>SSSS-------SS----------------XXXXXXXXXXXXX[][]SX
-----[]---[]--[]---------<>XXXXXXXXXXXXXXXXXXXXXXXXX-<>----[]---oo-----oSS-----<>---<>----[]----------------------------EXXXXXXXXXXXXXXXXXXX
-----[]---[]--[]---------[]XXXXXXXXXXXXXXXXXXXXXXXXX-[]----[]---<>----o-----SSS[]---[]XXXXXXX---------------XX-o---o---XXXXXXXXXXXXXXXXXXXXX
XXXXXXXXXXXXXXXXXXXXXXXXXXXXXXXXXXXXXXXXXXXXXXXXXXXX-[]----[]---[]-----E-------[]-XXXXXXXXXXX---------------XX---------XXXXXXXXXXXXXXXXXXXXX
XXXXXXXXXXXXXXXXXXXXXXXXXXXXXXXXXXXXXXXXXXXXXXXXXXXXXXXXXXXXXXXXXXXXXXXXXXXXXXXXXXXXXXXXXXXXXXXXXXXXXXXXXXXXXX---------XXXXXXXXXXXXXXXXXXXXX
XXXXXXXXXXXXXXXXXXXXXXXXXXXXXXXXXXXXXXXXXXXXXXXXXXXXXXXXXXXXXXXXXXXXXXXXXXXXXXXXXXXXXXXXXXXXXXXXXXXXXXXXXXXXXX---E-----XXXXXXXXXXXXXXXXXXXXX
XXXXXXXXXXXXXXXXXXXXXXXXXXXXXXXXXXXXXXXXXXXXXXXXXXXXXXXXXXXXXXXXXXXXXXXXXXXXXXXXXXXXXXXXXXXXXXXXXXXXXXXXXXXXXXXXXXXXXXXXXXXXXXXXXXXXXXXXXXXX
XXXXXXXXXXXXXXXXXXXXXXXXXXXXXXXXXXXXXXXXXXXXXXXXXXXXXXXXXXXXXXXXXXXXXXXXXXXXXXXXXXXXXXXXXXXXXXXXXXXXXXXXXXXXXXXXXXXXXXXXXXXXXXXXXXXXXXXXXXXX
