------------------------------------------------------------------------------------------------------------------------o-------------------
-----------------------------------------------------------------------<>-----o--------------o-<>--------------------------o--o-------------
---------------------------------------------------------------o-------[]------<>--------------[]--------------<>------o-------------o------
-----------------------EE-E---------------------------------------<>---[]---E<>[]--------------[]---o-E--------[]-E---------o---------------
----------------------SSSSSS-----------------------------------SS-[]SSS[]SSSS[][]-----------SS-[]-SSSSSSS--SSo-[]SSS--------S<>SSSSS--------
------------------------------------------------------o-----XXXXXXXXXXXXXXX--[][]-E------SSXXXXXXXXXXXXXXXXXXXXXX---o-XXXXXXX[]---XXXXXXXXXX
------------------------------o-----------------------SSS---XXXXXXXXXXXXXXXXXXXXXXX-o----<>XXXXXXXXXXXXXXXXXXXXXX-----XXXXXXXXXXXXXXXXXXXXXX
-------------o----<>----------<>---<>o<>-----------------E--XXXXXXXXXXXXXXXXXXXXXXX--EE--[]XXXXXXXXXXXXXXXXXXXXXXXXXXXXXXXXXXXXXXXXXXXXXXXXX
------------------[]<>--------[]---[]-[]------EE-E-EXXXXXXXXXXXXXXXXXXXXXXXXXXXXXXXXXXXXXXXXXXXXXXXXXXXXXXXXXXXXXXXXXXXXXXXXXXXXXXXXXXXXXXXX
-------oo--------o[][]--------[]--o[]-[]-----SSSSSSSXXXXXXXXXXXXXXXXXXXXXXXXXXXXXXXXXXXXXXXXXXXXXXXXXXXXXXXXXXXXXXXXXXXXXXXXXXXXXXXXXXXXXXXX
------E-----------[][]--------[]---[]-[]---E--<>----XXXXXXXXXXXXXXXXXXXXXXXXXXXXXXXXXXXXXXXXXXXXXXXXXXXXXXXXXXXXXXXXXXXXXXXXXXXXXXXXXXXXXXXX
XXXXXXXXXXXXXXXXXXXXXXXXXXXXXXXXXXXXXXXXXXXXX-[]----XXXXXXXXXXXXXXXXXXXXXXXXXXXXXXXXXXXXXXXXXXXXXXXXXXXXXXXXXXXXXXXXXXXXXXXXXXXXXXXXXXXXXXXX
XXXXXXXXXXXXXXXXXXXXXXXXXXXXXXXXXXXXXXXXXXXXXXXXXXXXXXXXXXXXXXXXXXXXXXXXXXXXXXXXXXXXXXXXXXXXXXXXXXXXXXXXXXXXXXXXXXXXXXXXXXXXXXXXXXXXXXXXXXXX
XXXXXXXXXXXXXXXXXXXXXXXXXXXXXXXXXXXXXXXXXXXXXXXXXXXXXXXXXXXXXXXXXXXXXXXXXXXXXXXXXXXXXXXXXXXXXXXXXXXXXXXXXXXXXXXXXXXXXXXXXXXXXXXXXXXXXXXXXXXX
