--------------------------------------------------------------------------------o----------------o------------------------------------------
----------------------------------------------------------------------------------------------o<>-------------------------------------------
-----------------------------------o----------------o------------------------------------------[]-------------------------------------------
--------o-------------------------------<>-----o<>----------------------------------<>---------[]-<>----------------------------------------
------o---------EE----E-E----o----------[]------[]----------------------------E---E-[]---------[]-[]E-------------------------E---------EEo-
---------------SSSSo-SSSSSS---XXXXXXXXXXXXXXXXXXXXXXX---o--------------------XXXXXXXXXXXXXXXXXXXXXXXXX-------------o--------SSSS-----SSSSSSS
--------------E-------------E-XXXXXXXXXXXXXXXXXXXXXXX----------------o-------XXXXXXXXXXXXXXXXXXXXXXXXX-----------------------<><>-----------
XXXXXXXXXXXXXXXXXXXXXXXXXXXXXXXXXXXXXXXXXXXXXXXXXXXXX-----o--SS----EEE-------XXXXXXXXXXXXXXXXXXXXXXXXXSSSS----------------<>-[][]-----------
XXXXXXXXXXXXXXXXXXXXXXXXXXXXXXXXXXXXXXXXXXXXXXXXXXXXX-E--SSSS-----XXXXXXXXXXXXXXXXXXXXXXXXXXXXXXXXXXXX-------<>-----------[]-[][]----<>-----
XXXXXXXXXXXXXXXXXXXXXXXXXXXXXXXXXXXXXXXXXXXXXXXXXXXXXXXXXXXXXX----XXXXXXXXXXXXXXXXXXXXXXXXXXXXXXXXXXXXXX--E--[]E-----E----[]-[][]E---[]-XXXX
XXXXXXXXXXXXXXXXXXXXXXXXXXXXXXXXXXXXXXXXXXXXXXXXXXXXXXXXXXXXXX--<>XXXXXXXXXXXXXXXXXXXXXXXXXXXXXXXXXXXXXXXXXXXXXXXXXXXXXXXXXXXXXXXXXXXXXXXXXX
XXXXXXXXXXXXXXXXXXXXXXXXXXXXXXXXXXXXXXXXXXXXXXXXXXXXXXXXXXXXXX--[]XXXXXXXXXXXXXXXXXXXXXXXXXXXXXXXXXXXXXXXXXXXXXXXXXXXXXXXXXXXXXXXXXXXXXXXXXX
XXXXXXXXXXXXXXXXXXXXXXXXXXXXXXXXXXXXXXXXXXXXXXXXXXXXXXXXXXXXXXXXXXXXXXXXXXXXXXXXXXXXXXXXXXXXXXXXXXXXXXXXXXXXXXXXXXXXXXXXXXXXXXXXXXXXXXXXXXXX
XXXXXXXXXXXXXXXXXXXXXXXXXXXXXXXXXXXXXXXXXXXXXXXXXXXXXXXXXXXXXXXXXXXXXXXXXXXXXXXXXXXXXXXXXXXXXXXXXXXXXXXXXXXXXXXXXXXXXXXXXXXXXXXXXXXXXXXXXXXX
