----------------------------------------------------------------o------------------------------o----o----------o--------------------o------o
----------------------o------o-------------------o------o-----------------------------------------------------------------------<>----------
--------------<>---o---o-----------------------------------------o---------------------------------------o----------------------[]-----o--o-
--------------[]------------------------<>------------oE------E----E--------------------o----o--o--E---oE-------------<>o-----<>[]---E<>---E
-----------SSS[]SS----------------------[]-------E----SSSSSSSSSSS-SSSS-------------o------o----E--SSSSSSSS<>--E---E---[]-Eo---[][]SSSS[]-ESS
--------------[]--------E---EXX---SSSS-E[]o--<>XXXXXXXXXXXXXXXXXXXX--------o-o----------------XXXXXXXXX---[]--XXXXXXXXXXXXXXXXXXXXXXXXXXXXXX
-----------XXXXXXXXXXXXXXXXXXXXXXXXXXXXX[]-SS[]XXXXXXXXXXXXXXXXXXXX------E--ESS-----E-o-------XXXXXXXXX---[]--XXXXXXXXXXXXXXXXXXXXXXXXXXXXXX
------o----XXXXXXXXXXXXXXXXXXXXXXXXXXXXXXXXXXXXXXXXXXXXXXXXXXXXXXXXXXXXXXXXXXXXXXXXXXXXXXXXXXXXXXXXXXXXXXXXXXXXXXXXXXXXXXXXXXXXXXXXXXXXXXXXX
------<>---XXXXXXXXXXXXXXXXXXXXXXXXXXXXXXXXXXXXXXXXXXXXXXXXXXXXXXXXXXXXXXXXXXXXXXXXXXXXXXXXXXXXXXXXXXXXXXXXXXXXXXXXXXXXXXXXXXXXXXXXXXXXXXXXX
------[]---XXXXXXXXXXXXXXXXXXXXXXXXXXXXXXXXXXXXXXXXXXXXXXXXXXXXXXXXXXXXXXXXXXXXXXXXXXXXXXXXXXXXXXXXXXXXXXXXXXXXXXXXXXXXXXXXXXXXXXXXXXXXXXXXX
XXXXXXXXXXXXXXXXXXXXXXXXXXXXXXXXXXXXXXXXXXXXXXXXXXXXXXXXXXXXXXXXXXXXXXXXXXXXXXXXXXXXXXXXXXXXXXXXXXXXXXXXXXXXXXXXXXXXXXXXXXXXXXXXXXXXXXXXXXXX
XXXXXXXXXXXXXXXXXXXXXXXXXXXXXXXXXXXXXXXXXXXXXXXXXXXXXXXXXXXXXXXXXXXXXXXXXXXXXXXXXXXXXXXXXXXXXXXXXXXXXXXXXXXXXXXXXXXXXXXXXXXXXXXXXXXXXXXXXXXX
XXXXXXXXXXXXXXXXXXXXXXXXXXXXXXXXXXXXXXXXXXXXXXXXXXXXXXXXXXXXXXXXXXXXXXXXXXXXXXXXXXXXXXXXXXXXXXXXXXXXXXXXXXXXXXXXXXXXXXXXXXXXXXXXXXXXXXXXXXXX
XXXXXXXXXXXXXXXXXXXXXXXXXXXXXXXXXXXXXXXXXXXXXXXXXXXXXXXXXXXXXXXXXXXXXXXXXXXXXXXXXXXXXXXXXXXXXXXXXXXXXXXXXXXXXXXXXXXXXXXXXXXXXXXXXXXXXXXXXXXX
