----------------------------------------------------------------------------------------------------------------------------------------------------------
----------------------------------------------------------------------------------------------------------------------------------------------------------
----------------------------------------------------------------------------------------------------------------------------------------------------------
----------------------------------------------------------------------------------------------------------------------------------------------------------
-------------------------------------------------o--------------------o----------------------------------------------------o------------------------------
--------------------o--o-----ooo------o---------o-----------o-------o-----------o----o--oo--------------------------------o--o----o-----------------------
----------oo-o--ooo-------------o----o--o-------------o--o---o------------------------o---o-------oooo-------oo--------o--------oo-o-----o-o--------------
---------o---------o-------o------ooo--o-o----?--?--o---o-oo---------o????-----o-oo--------o------------X---o-----------oo---XX??S??-S--------------------
--------o---o-----------X-??-SSS???--------o------------------------------S-SX-------XSS??------o-------------XXX?--------------------X-X-----------------
-------S?X?S-?-----------------------------?X-----oo---?-----------------------------------?X-------------???S--------------------------------------------
---------------------------------------------------S-?----------?------------------------------?--------------------?-------------------------------------
----------------------------------------------XXXX--------------------XXXX----------------------------XXXX----------------XXXXXXXXXXXX--------------------
--------------XXXXXXXXXXXXXXXXXXXXXXXXXXXX----XXXX--------XXXX----XXXXXXXXXXXXXXXXXXXXXXXX--------XXXXXXXX----XXXX----XXXXXXXXXXXXXXXXXXXXXXXX----XXXXXXXX
XXXXXXXXXXXXXXXXXXXXXXXXXXXXXXXXXXXXXXXXXXXXXXXXXX----XXXXXXXX----XXXXXXXXXXXXXXXXXXXXXXXXXXXX----XXXXXXXXXXXXXXXX----XXXXXXXXXXXXXXXXXXXXXXXX----XXXXXXXX
