----------------------------------------------------------------------------------------------------------------------------------------------------------
----------------------------------------------------------------------------------------------------------------------------------------------------------
----------------------------------------------------------------------------------------------------------------------------------------------------------
----------------------------------------------------------------------------------------------------------------------------------------------------------
----------------------------o--------------------------------------------------oo------------------o-------------------o----------------------------------
---------------------------------------o-----------------------------o--------o--o-----o-o---------------------o--------oo------oo------------------------
---------oo------oo--o---o--------------oo-------o------------------------o----------------------oo-ooo-oo----------------o--------o----------------------
-----------oo-------o-----??X?o-----o------o---oo-oo-------oo-----X?S?oo----o-------------o-------S-----------??X---------------XSo--o-----o--------------
--------?X-----o---o---o----------------?X------------S?XX-----------------o------o---X----o-------------X------------------------S-XX----o---------------
----------?X?-S----------------o--------------S??-X?-S----o----?X-----S--?--X--------?-------o-XS---------oooo--------------------------------------------
------------------------------X??S--------------------------------------------------------S?X-------------XXX-----S--?----------------X-S-----------------
--------------------------XXXX------------------------------------XXXX--------XXXX----------------XXXX--------XXXX----XXXXXXXXXXXX------------------------
XXXXXXXXXX----------------XXXX--------XXXX------------XXXX--------XXXX--------XXXX----XXXX--------XXXXXXXX----XXXX----XXXXXXXXXXXXXXXX--------------------
XXXXXXXXXXXXXXXXXXXXXXXXXXXXXX----XXXXXXXXXXXXXXXXXXXXXXXX----XXXXXXXXXXXXXXXXXXXXXXXXXXXX----XXXXXXXXXXXX----XXXX----XXXXXXXXXXXXXXXX----XXXXXXXXXXXXXXXX
