----------------------------------------------------------------------------------------------------------------------------------------------------------
----------------------------------------------------------------------------------------------------------------------------------------------------------
----------------------------------------------------------------------------------------------------------------------------------------------------------
----------------------------------------------------------------------------------------------------------------------------------------------------------
---------------------o----------------------------o-o-----------------o--o--------------------------------------------------------------------------------
----------o------o-o--o--o---o---------------------------------------------------------------------o----------o-------------------------------------------
--------------------o-------o-o------------------o-o-----o---------------------oooo---o-oo------------o-o---------------------------o---------------------
-----------o---------------X??--------oo----o---o---?-?----o-o-----o--S?--?X--------------o---------o----o--oo--o-----ooo--------ooo--o---o---------------
---------oSS?----------S-?--------------ooS-?--S?---------o-o-----------------o-------?-S?XX?-S?-?--------S---SX-S-o---------------------o-o--------------
------------------------------SS-S----------------------------o-----oo--------------?X------------------?---------?S------------?--?-?-o------------------
------S-S?------------------------?XS----------------------------?SXS?------------------------------------------------------------------------------------
--------------XXXXXXXX----XXXX--------------------XXXXXXXX------------XXXXXXXX--------------------------------------------XXXX----------------XXXXXXXXXXXX
XXXXXX----XXXXXXXXXXXXXXXXXXXX------------XXXXXXXXXXXXXXXX------------XXXXXXXX--------XXXXXXXXXXXXXXXX----XXXXXXXX--------XXXX----------------XXXXXXXXXXXX
XXXXXX----XXXXXXXXXXXXXXXXXXXXXXXX--------XXXXXXXXXXXXXXXX------------XXXXXXXXXXXXXXXXXXXXXXXXXXXXXXXXXXXXXXXXXXXXXXXXXXXXXXXXXXXXXXXX--------XXXXXXXXXXXX
