----------------------------------------------------------------------------------------------------------------------------------------------------------
----------------------------------------------------------------------------------------------------------------------------------------------------------
----------------------------------------------------------------------------------------------------------------------------------------------------------
----------------------------------------------------------------------------------------------------------------------------------------------------------
-----------------------------------------o-----------------------------------------------------------o--------o-------------------------------------------
---------o-----------------------------oo----------------o----oo--------------oo------o--o--------oo------o----o-o----------------------------------------
------------------o-o---------o-------------------------o------------------------------oo--o-o--o---o-o----o-o-------------------o-------o----------------
-------------------o-----?------o---------------oo----X-------?X?So---oo--------oo--o-?-SXo---S---------?-----?-?-----o------o------------oo--------------
------?XXS-oo------------------??S---o---------o------------o------o-o------X----X-?XX--------------------S------------o---X-?----oo----------------------
----------o--o---------------o--------------------oo-------o----------SXS-----------------S-XX--------------------------o------?SS----??S-----------------
------------SX?-----------XSXS---------------??-?SS-S--------X----X-XX--------------------------------------------------------------S---------------------
----------------------XXXX------------XXXX------------XXXX----XXXX--------------------XXXX----XXXXXXXXXXXX----XXXX----------------------------------------
XXXXXXXXXX------------XXXX----XXXX----XXXX------------XXXX----XXXX--------XXXXXXXXXXXXXXXX----XXXXXXXXXXXXXXXXXXXX--------XXXX------------XXXX------------
XXXXXXXXXX--------XXXXXXXX----XXXX----XXXX------------XXXX----XXXX----XXXXXXXXXXXXXXXXXXXXXXXXXXXXXXXXXXXXXXXXXXXXXXXX----XXXXXXXX----XXXXXXXXXXXXXXXXXXXX
