----------------------------------------------------------------------------------------------------------------------------------------------------------
----------------------------------------------------------------------------------------------------------------------------------------------------------
----------------------------------------------------------------------------------------------------------------------------------------------------------
----------------------------------------------------------------------------------------------------------------------------------------------------------
--------------------o----------------------------------------------------------o-o-----------------------------o----------o-------------------------------
-------------------o--------o--------------------o----------o---------------o---o-------o------------------------------------o----------oo----------------
---------o-----------ooo---o-----------oo------------------------o--------------------o-----------------------o------------o------o-----------------------
-------o----------------o----o-------------------S--------o--o-------ooo-o----X--?-------o--------o----------o???Xo---o-o---X---oo-ooo--------------------
------o-o-------S--------o-X??o-o---oo-------------o--------------oo--------------o---?S-Xoo--X------------------------o-------o----?-----o---------------
------???So------------??--------o?-?--------------------------??---o---------------------?-SS-----oo--------------------o----S?S?---------o--------------
----------XS??----------------??XX----------------??--------------XSSX-?X-----------?X-------------X------X-??--------?-----------------------------------
------------------XXXX----------------XXXX----XXXX------------------------XXXXXXXX----------------------------XXXX--------XXXX--------XXXX----------------
--------------XXXXXXXX----XXXX--------XXXX----XXXX----XXXXXXXX------------XXXXXXXX----XXXX----XXXX----XXXX----XXXXXXXX----XXXX----XXXXXXXX----------------
XXXXXXXXXX----XXXXXXXXXXXXXXXX----XXXXXXXX----XXXX----XXXXXXXXXXXX--------XXXXXXXX----XXXXXXXXXXXX----XXXX----XXXXXXXX----XXXXXXXXXXXXXXXX----XXXXXXXXXXXX
