----------------------------------------------------------------------------------------------------------------------------------------------------------
----------------------------------------------------------------------------------------------------------------------------------------------------------
----------------------------------------------------------------------------------------------------------------------------------------------------------
----------------------------------------------------------------------------------------------------------------------------------------------------------
------------------------------------------------------------------------------o----------o-------------------------o--ooo---------------------------------
----------o-----------------------o-oo------------------------------------------------o-----------o--o-------ooo---------o-----------------o--------------
-------o-o---------o--o------o------------o------o------------o----o-oo-o---o--oo------------------oo-------o-------------o------o-o----------------------
--------o-S-S-------o---------oo-------oo-----o-o-o--o---o-o--X?S??-?X-o----------------X?-o--------------?-X?S????SS---------o-o--??--S------------------
------S-X-----?----------?--o-----X------o----?S?X-o--?-----o-----------------------------o-----o--------o------------------?-----------------------------
--------------------------XSX-?-?X----o---?X?-------------o-----------S?-?X?-X---------------------------?--------------------X--S------------------------
--------------------------------------------------S???----X--S------------------------------XXSXS---------------------------------------------------------
----------XXXX------------------------------------------------XXXXXXXX--------XXXX----XXXX--------XXXX----XXXXXXXXXXXXXXXX--------XXXXXXXXXXXXXXXXXXXXXXXX
XXXXXXXXXXXXXXXXXXXXXXXXXX--------XXXX--------XXXX----XXXX----XXXXXXXX--------XXXX----XXXX--------XXXX----XXXXXXXXXXXXXXXXXXXX----XXXXXXXXXXXXXXXXXXXXXXXX
XXXXXXXXXXXXXXXXXXXXXXXXXXXXXXXXXXXXXX----XXXXXXXX----XXXX----XXXXXXXXXXXXXXXXXXXX----XXXX--------XXXXXXXXXXXXXXXXXXXXXXXXXXXXXXXXXXXXXXXXXXXXXXXXXXXXXXXX
