----------------------------------------------------------------------------------------------------------------------------------------------------------
----------------------------------------------------------------------------------------------------------------------------------------------------------
----------------------------------------------------------------------------------------------------------------------------------------------------------
----------------------------------------------------------------------------------------------------------------------------------------------------------
---------oo-o----------------o-----o-----------------------------------o----------------------------------------------------------------------------------
--------o----------------------------------------o--------------------o--o------------------------o----------oo-----o------------o-o----------------------
------------------------------------------------o----------------------------o----------oo-------o-o-----------o-------ooo------o-o--o--------------------
-------XX???S?-o----o-----???S--------oo-o----?-?Xo--------------------S-?------------------oo?S-S---o--SS?S-----o----o-------X-?X----?----o--------------
--------------o--------------------------------------o-------oo---o--o---------oo-o---??S?oo-------?----------?-?--S?-------------X?S?----o---------------
--------------XS--oo----------o-o-------o---------XX-SX---ooo-----?X?S------?Xo----?------S-XS------------------------------------------------------------
------------------------------?SX-------------------------------?-----------------------------------------------------------------------------------------
XXXXXXXXXXXXXX------------XXXX----XXXX--------XXXX--------------------XXXX--------------------XXXX----XXXXXXXX----------------XXXX----XXXX----XXXXXXXXXXXX
XXXXXXXXXXXXXX------------XXXX----XXXX--------XXXX--------------------XXXX------------XXXX----XXXXXXXXXXXXXXXXXXXXXXXX--------XXXXXXXXXXXX----XXXXXXXXXXXX
XXXXXXXXXXXXXXXXXX----XXXXXXXX----XXXX--------XXXXXXXXXXXX--------XXXXXXXXXXXX----XXXXXXXXXXXXXXXXXXXXXXXXXXXXXXXXXXXXXXXXXXXXXXXXXXXXXXXX----XXXXXXXXXXXX
