----------------------------------------------------------------------------------------------------------------------------------------------------------
----------------------------------------------------------------------------------------------------------------------------------------------------------
----------------------------------------------------------------------------------------------------------------------------------------------------------
----------------------------------------------------------------------------------------------------------------------------------------------------------
-------------------------------------oo------------------------------------------o----------------------------------------o------o------------------------
------------------ooo---------oo--o-----o---------------o------------o--------ooo--o-o---------------o----o--oo----------------------------o--------------
-----------o---------------------------o-o-o-------------------o---oo------------------------------oo-o-o-------------o-o-------o-------------------------
---------oo-o--------o--o--ooo--o----------------o---o-?-Xo-oo--------o-------?----------------------------o---o------------???X??o-----------------------
------?XX?-XS?-oo-------------??X?--------o-o--------------o-------??X-o-----------------oo----------------S?-SS?S--o--o-o------------??------------------
--------------?-------o----------------------X-oo-oo-------------------S??--o-----------o-------------------------o---------------------------------------
----------------------X?-?-?-?----------------?X?S--?X--------------------?S??--------??-SXXXS??-S----------------S---------------SXX---------------------
----------------------------------XXXXXXXX------------XXXX----XXXX------------XXXX----------------XXXX--------------------XXXXXXXX------------XXXXXXXXXXXX
XXXXXXXXXXXXXX----XXXX--------XXXXXXXXXXXX------------XXXX----XXXXXXXX--------XXXXXXXX------------XXXX----XXXXXXXX--------XXXXXXXX----XXXXXXXXXXXXXXXXXXXX
XXXXXXXXXXXXXXXXXXXXXX--------XXXXXXXXXXXXXXXX--------XXXX----XXXXXXXXXXXX----XXXXXXXX------------XXXXXXXXXXXXXXXX----XXXXXXXXXXXX----XXXXXXXXXXXXXXXXXXXX
