----------------------------------------------------------------------------------------------------------------------------------------------------------
----------------------------------------------------------------------------------------------------------------------------------------------------------
----------------------------------------------------------------------------------------------------------------------------------------------------------
----------------------------------------------------------------------------------------------------------------------------------------------------------
----------------------------------------------------------------------------------------------------------------------------------------------------------
-------------------o----------o--o-------------------------------------o-o---o-oo----------------o--------------------------------------------------------
------------------o-o-------------------o---------------o-----o---o--------------o------o-----------o--------------------o--------------------------------
----------o--o------------------SX-----o-o-------o----o---------------o----o--------------oo-o----o--------------------oo-o-o----oo-----------------------
---------o------oo----------o------?--o------o-o-------o--oo--------ooS-SS-??S---?oo-o---o---------o---------ooo-----o---------oo--SX---------------------
-------S?X-o--S-SX------?-???X------------o-o---o-oo---?----oo----?-??--------------XXS-??------------?--S--X??-XX----------?-?S-?----S-?--o--------------
----------S?X--------------------------------X-?XSXX?X------------------------------------X?-?------------------------------------------------------------
------------------------------XXXX------------------------------------------------------------------------------------------------------------------------
------------------XXXX--------XXXXXXXX--------------------------------XXXXXXXXXXXX------------XXXX--------------------------------XXXX--------XXXXXXXXXXXX
XXXXXXXXXX----XXXXXXXXXXXXXXXXXXXXXXXXXXXX------------XXXX----XXXXXXXXXXXXXXXXXXXXXXXXXXXX----XXXXXXXXXXXXXXXXXXXX----XXXXXXXXXXXXXXXXXXXX----XXXXXXXXXXXX
