----------------------------------------------------------------------------------------------------------------------------------------------------------
----------------------------------------------------------------------------------------------------------------------------------------------------------
----------------------------------------------------------------------------------------------------------------------------------------------------------
----------------------------------------------------------------------------------------------------------------------------------------------------------
------------------oo-----------------------------------------------------------------------------------------------------------------------o--------------
---------o----------o-o---------------------o----------------------------------ooo--------o----------------------------------o----------------------------
--------o------------o---o---o----o--o-o----------ooo---------------oo--------o-------o--o---------oo------------------------------------oo---------------
----------oo--o---S-----------o---------------------------oo------------o----------------------------o-------oo-----------------oo-o----------------------
------X?X?----XS?X-------?--o--o------o-o--S----oo------------o-------o-----------------o--?-S------------------------ooo----S------o---------------------
--------------------------?-XS-?XS?-S-------------SX?----o--o----?-???----------------?--?---------------?--o--o--X------o--------o---S-------------------
-----------SSS--------------------------------SSS?----?-X-------------X?X-S-------S?-?--------SX-----------?X-?S?X-------------XS?X-XX--------------------
------------------XXXX--------------------------------------------------------------------------------------------------------------------XXXXXXXXXXXXXXXX
XXXXXXXXXX----XXXXXXXXXXXX----------------XXXX--------------------------------XXXX--------XXXX----XXXX--------------------XXXX------------XXXXXXXXXXXXXXXX
XXXXXXXXXX----XXXXXXXXXXXXXXXXXXXXXXXXXXXXXXXX----XXXX--------XXXXXXXX--------XXXX----XXXXXXXX----XXXXXXXX--------XXXX----XXXX--------XXXXXXXXXXXXXXXXXXXX
