----------------------------------------------------------------------------------------------------------------------------------------------------------
----------------------------------------------------------------------------------------------------------------------------------------------------------
----------------------------------------------------------------------------------------------------------------------------------------------------------
----------------------------------------------------------------------------------------------------------------------------------------------------------
------------------------------------------o---------------oo--------------o----oo--------------------------oo--------------o------------------------------
--------oo---------oo---------------------------------------o--------------------o---------------o------------o-------------------------------------------
------------------o------------------------o------oo-------------------------o------------oo--o--------------o---------oooo-------------------------------
------???Xo------o---o------o-----o---o--o---?-----------------------o--o--------?------oo------?----------S?X-----------------o--o-o---------------------
----------?--S---------------ooo-------oo-------o-S??S------------SX??oo-----------o---------------o-o-oo-----S??-??-X-----------o-o------o---------------
--------------??X--------?----??-S-------------o-o-----?--------------?X-?----------------??-?------o-o---------------SS--------o-------o--o--------------
---------------------------?SS----?------?------S--------------?XS----------------S?S?-?S?------------------------------------S--S-?X---------------------
XXXXXXXXXX--------------------------------XXXX------------XXXX------------XXXXXXXX------------XXXX--------XXXX------------XXXX----------------------------
XXXXXXXXXXXXXX----XXXX--------------------XXXX----XXXX----XXXX----XXXX----XXXXXXXX------------XXXX--------XXXXXXXXXXXX----XXXX----------------------------
XXXXXXXXXXXXXXXXXXXXXXXXXX----XXXX--------XXXX----XXXXXXXXXXXX----XXXXXXXXXXXXXXXX--------XXXXXXXX--------XXXXXXXXXXXXXXXXXXXX----------------XXXXXXXXXXXX
