----------------------------------------------------------------------------------------------------------------------------------------------------------
----------------------------------------------------------------------------------------------------------------------------------------------------------
----------------------------------------------------------------------------------------------------------------------------------------------------------
----------------------------------------------------------------------------------------------------------------------------------------------------------
----------o-------------o-------------------------------------------------------o-------o--------------------------------------------o--------------------
---------o---o--------------------------o---oo------------o--------------------o------o--o-----------o----------------------------------------------------
--------o--o---------------------------o--o----o-o--o----o---------------o----o--------o----------ooo-----------------------------oo--o----o--------------
----------?-?X------o--SS---oo-----------o------o----o-----oo--------o-----------So---?S??------------------o----------o--?XS?-----??---o-----------------
--------SX--------o--o--------------------X?-X----o----o--?-----------o-o--?S--------------------------o---o-oo---------o------o--------------------------
-----------------o-o----------o---------------X?-S?-?X-??-------------?-??-----------o----oo-o----------X----------------o-------o------------------------
--------------XX-?---------X?XSX---------------------------------?SXSS---------------S----?-?X------------XSSXSS-?------?-----SS??------------------------
----------XXXX--------XXXX--------XXXX----------------------------------------XXXX----XXXX----XXXX------------------------XXXX----XXXX--------------------
XXXXXXXXXXXXXX--------XXXX--------XXXXXXXXXXXX------------XXXX------------XXXXXXXX----XXXX----XXXXXXXX------------XXXX----XXXX----XXXXXXXXXXXX----XXXXXXXX
XXXXXXXXXXXXXX--------XXXX--------XXXXXXXXXXXXXXXXXXXXXXXXXXXX--------XXXXXXXXXXXX----XXXX----XXXXXXXXXXXX--------XXXX----XXXX----XXXXXXXXXXXX----XXXXXXXX
