----------------------------------------------------------------------------------------------------------------------------------------------------------
----------------------------------------------------------------------------------------------------------------------------------------------------------
----------------------------------------------------------------------------------------------------------------------------------------------------------
----------------------------------------------------------------------------------------------------------------------------------------------------------
------------------------------oo---------------------------------------------------o------------------------------------------o-oo-o----------------------
----------oo--------o---------------------o--------o-------oo--------------------------------o--------o-----------------o---------o-----------------------
-----------------o-----------o----o------------o-o--oo----o----o--oo-o---------------------o-------o--------oo-oo-----------------------------------------
-------------------o-o------o-SS?------o-----X-?X?o------o---oS-?-----o---------o---?-----o---o--o------------o--------o-oo----??????Xo---o---------------
---------oXXXS?-?------------------------o--------?SXX------S-------o-?-??--------------o-X??X----o-oo-----?X--S------------SX-------------o--------------
----------------------o---?-----------o-o--------------------------?X-----X??--o---------o----???X-------------------o------------------------------------
-------??X--------------S-----------------------------?--------------------------------X?--------------------------X--------------------------------------
------------------------------XXXX--------XXXXXXXX------------XXXX----------------XXXX----------------XXXX--------------------XXXXXXXX--------------------
XXXXXX----XXXXXXXXXXXX--------XXXX--------XXXXXXXXXXXX----XXXXXXXX----XXXX--------XXXX----XXXX--------XXXXXXXXXXXX----XXXXXXXXXXXXXXXXXXXX----XXXXXXXXXXXX
XXXXXX----XXXXXXXXXXXX----XXXXXXXXXXXX----XXXXXXXXXXXX----XXXXXXXXXXXXXXXXXXXX----XXXX----XXXXXXXXXXXXXXXXXXXXXXXX----XXXXXXXXXXXXXXXXXXXXXXXXXXXXXXXXXXXX
