----------------------------------------------------------------------------------------------------------------------------------------------------------
----------------------------------------------------------------------------------------------------------------------------------------------------------
----------------------------------------------------------------------------------------------------------------------------------------------------------
----------------------------------------------------------------------------------------------------------------------------------------------------------
-----------------------o-----------------------------------------------o-----------------------------------------------oo---------------------------------
-------o--oo-----o--o-o-----------------------------------------------o-----------------------------------o-----------o--o--------o--------o--------------
---------o---------o------------o------o----------o----------------------------------------------------o-----o------------o------o------------------------
-------------o-------o-?SX--oo----o-----------------------------------S??----o----o----o----------o---o---X--?oo---oo-----X--S--------X---o---------------
------SX??-?--------------o---o------oo-o--------o?S-??----oo----o--o----------oo----o--------------o--------------??-----------o-X--?--------------------
------------------------------S-?-------------??-S-----------o---?---o-----?-----o----o--oo-----------------------------------SS?X------------------------
--------------------------X-??------------X-?S---------------X----X?-?-------------?--S--X?SSX?XX??-----------X-S?----------------------------------------
--------------XXXX----XXXX--------------------------------------------XXXX--------------------------------XXXX--------XXXXXXXX--------XXXX----XXXXXXXXXXXX
XXXXXXXXXXXXXXXXXXXXXXXXXX------------------------XXXXXXXX------------XXXX----------------------------XXXXXXXX----XXXXXXXXXXXX----XXXXXXXXXXXXXXXXXXXXXXXX
XXXXXXXXXXXXXXXXXXXXXXXXXX----XXXXXXXXXXXX----XXXXXXXXXXXX----XXXX----XXXXXXXX------------------------XXXXXXXX----XXXXXXXXXXXXXXXXXXXXXXXXXXXXXXXXXXXXXXXX
