----------------------------------------------------------------------------------------------------------------------------------------------------------
----------------------------------------------------------------------------------------------------------------------------------------------------------
----------------------------------------------------------------------------------------------------------------------------------------------------------
----------------------------------------------------------------------------------------------------------------------------------------------------------
------------o-----------------------------------------o---------------------------------------------------------------o-oo---------o----------------------
----------oo------o----------o--------------------oo--------------------------------------o------------------------o--------------o-----------------------
--------------o----ooo----------------------o----------o--o-----------o-o---o-----o----------------ooo-----------------o----o----o--o---o-oo--------------
--------o-?-X-------?-------o-o-------o---------o-?S?SX----o---------------------o--S--o---o------------------o-----------o-------???X--------------------
---------------------------S?X-o--------oo-------o----------o--?X-------------o-o--------oS?X?X--------?-?---o-o--?S?-----------o-------------------------
----------------------------------SXX--o----------------------------o--???-?---o------??SS-------------------------------------?-X----?S------------------
-------XXS--------------------S?X?------------S-XX----------------?-X?-----------?-------------------------X-?--?-----------------------------------------
XXXXXX----XXXX----XXXXXXXX----------------XXXX----XXXXXXXX------------------------XXXX--------------------------------XXXX--------XXXX--------------------
XXXXXX----XXXXXXXXXXXXXXXXXXXX------------XXXX----XXXXXXXX----XXXX----------------XXXX----XXXXXXXX----XXXX--------XXXXXXXX--------XXXX--------XXXXXXXXXXXX
XXXXXX----XXXXXXXXXXXXXXXXXXXX----XXXX----XXXX----XXXXXXXXXXXXXXXX----XXXXXXXX----XXXXXXXXXXXXXXXXXXXXXXXX--------XXXXXXXXXXXXXXXXXXXXXXXXXXXXXXXXXXXXXXXX
