----------------------------------------------------------------------------------------------------------------------------------------------------------
----------------------------------------------------------------------------------------------------------------------------------------------------------
----------------------------------------------------------------------------------------------------------------------------------------------------------
----------------------------------------------------------------------------------------------------------------------------------------------------------
------o--ooo----------o---------------------------o---------------------o-----o----------------o----------------------------------------------------------
--------o---o----------o-ooo--o---------------------o---o----o--------o---------o--o----------------------o------o------o---------------------------------
-------o----------oo----o---oo-------------------o----------o------------------o-o---o----------------------o-o--------o---------oo-------o---------------
------?XX?SSX-o-----o---?-----X-?------oo---------?XS------o------o-o--SSX--------?X-X----oo--XSX-o-o------o-o-o------X------------o-------o--------------
-----------------o---o----SS??-------------X-?--------SS------o------o-----o-o---------o--X??S------------S?--X?-?----------------------------------------
----------------------------------------------XX-X-----------------o--------------------oo---------o-oo--o-----------o--------X??XX?SX--------------------
-----------------------------------S----------------------------?-?XXS----------------S--S--------------?---------?X??-----------------?------------------
XXXXXXXXXXXXXX--------XXXX----XXXX----------------XXXX----------------XXXX----XXXXXXXX--------XXXX--------------------XXXX--------------------------------
XXXXXXXXXXXXXX--------XXXXXXXXXXXX--------XXXX----XXXXXXXXXXXX--------XXXX----XXXXXXXX----XXXXXXXX--------XXXXXXXX----XXXXXXXX------------XXXXXXXXXXXXXXXX
XXXXXXXXXXXXXXXXXXXXXXXXXXXXXXXXXX----XXXXXXXXXXXXXXXXXXXXXXXX--------XXXXXXXXXXXXXXXX----XXXXXXXX--------XXXXXXXX----XXXXXXXXXXXXXXXX----XXXXXXXXXXXXXXXX
