----------------------------------------------------------------------------------------------------------------------------------------------------------
----------------------------------------------------------------------------------------------------------------------------------------------------------
----------------------------------------------------------------------------------------------------------------------------------------------------------
----------------------------------------------------------------------------------------------------------------------------------------------------------
-----------------------------------------------o-o---------------------ooo--------o--------------------------------------------------------o--------------
----------o-----------------oo---------o-------------------------------------o----------------o---oo-----o----------------------o-------------------------
--------oo-----------o---------------oo-o-----o---o----------------o-oo--------oo-------------------o-o-o------o-------oo-----o--o------------------------
---------------o----o-------------o-o------o--?XSS?X?-------------???-?S??-S------S?X---o-oo---------o--------X?-X----------o-?-?-------------------------
----------SXSX-----o-------X-Xoo----------o--------------?-o-----------------------------o------S--------X------------o--o---S----o-----------------------
------S?X?----X?--X-------------oo--------------------------o-------------------------?X?S----------------o-oo--------------------------------------------
------------------------------SX??---------X?------------------X-S------------------------?S??------------?X-X--------------------???X--------------------
----------------------------------------------XXXXXXXX------------XXXXXXXXXXXXXXXXXXXX------------------------XXXX------------XXXX----XXXXXXXX------------
----------XXXX------------XXXX--------XXXX----XXXXXXXXXXXX--------XXXXXXXXXXXXXXXXXXXX--------XXXXXXXXXXXX----XXXX--------XXXXXXXX----XXXXXXXXXXXXXXXXXXXX
XXXXXXXXXXXXXXXXXXXXXXXXXXXXXX----XXXXXXXX----XXXXXXXXXXXX--------XXXXXXXXXXXXXXXXXXXXXXXX----XXXXXXXXXXXX----XXXX----XXXXXXXXXXXX----XXXXXXXXXXXXXXXXXXXX
