----------------------------------------------------------------------------------------------------------------------------------------------------------
----------------------------------------------------------------------------------------------------------------------------------------------------------
----------------------------------------------------------------------------------------------------------------------------------------------------------
----------------------------------------------------------------------------------------------------------------------------------------------------------
-------------------o--o---------------o-------------------------------o----o---------------------------------------------------o--------------------------
----------o------------------o------------o-----------------------------oo---oo-oo-----o-o-----------------o-o--------ooo--------o------------------------
-------o------------oo-----oo-o--------oo--o-------o----------------oo---------o--------o---------------------------o-----o-------------------------------
----------------------?-?Xo----o---------X-----o-oo---------oo---------?S?-X-----?-o-o------o-------o-o---???--oo--o-o--------??S----------o--------------
---------o?X?-------------???X-S----------?X-S-X--?-X?----o-----?-?-?X----------------XX?X-o--?---o--o--------------------?-??----------------------------
------?-?X--------------------------o----------------------o------------------------------o--------o----------o--o----------------o-----------------------
----------------------------------------------------------------------------------????----SS-?------X---?X----X--------------------XX--?------------------
------------------XXXXXXXX------------XXXX------------XXXX------------XXXXXXXXXXXX------------------------XXXX----------------XXXX------------------------
----------XXXXXXXXXXXXXXXXXXXXXXXX----XXXXXXXXXXXXXXXXXXXX----XXXXXXXXXXXXXXXXXXXX----XXXX----XXXX--------XXXX--------XXXXXXXXXXXX------------XXXXXXXXXXXX
XXXXXXXXXXXXXXXXXXXXXXXXXXXXXXXXXX----XXXXXXXXXXXXXXXXXXXX----XXXXXXXXXXXXXXXXXXXX----XXXX----XXXX--------XXXX----XXXXXXXXXXXXXXXX------------XXXXXXXXXXXX
