----------------------------------------------------------------------------------------------------------------------------------------------------------
----------------------------------------------------------------------------------------------------------------------------------------------------------
----------------------------------------------------------------------------------------------------------------------------------------------------------
----------------------------------------------------------------------------------------------------------------------------------------------------------
------------------oo--------------------------------------o-------------o------oo------------------o---------------------------------------o--------------
-----------------o--oo---------oo---------------------------------------------o--o--------o-----o-------o------o-------o----------o-----------------------
--------o---------------------o--o--------------------------o---------oo-------------------o--o-----oo------o-o---------o--o-----o------------------------
---------oo-----------------------o-----o---------------o--------------S-X-----X-------oo--------------------o--------o----------------o------------------
------------o------------o---o???----ooo---------ooo---o---------S--------o--------XS?----------------?--?-----S??X------S---oX??-X-X---------------------
--------??-o--------------------------------S?--X-XSS----o-----------o-------------------o-----------------?S?-------------?-?--------XS------------------
----------?X?----------?-?-?SS------S------------------?----------S??S----SXX---------?S??----------------------------------------------------------------
------------------XXXX------------------------------------XXXX--------XXXX----XXXX--------XXXXXXXXXXXX------------------------------------XXXX------------
--------------XXXXXXXX--------XXXX------------------------XXXXXXXX----XXXX----XXXXXXXX----XXXXXXXXXXXXXXXX----XXXXXXXXXXXX----XXXXXXXX----XXXX------------
XXXXXXXXXX----XXXXXXXX--------XXXX----XXXXXXXXXXXXXXXX----XXXXXXXX----XXXX----XXXXXXXX----XXXXXXXXXXXXXXXXXXXXXXXXXXXXXXXXXXXXXXXXXXXXXXXXXXXXXXXXXXXXXXXX
