----------------------------------------------------------------------------------------------------------------------------------------------------------
----------------------------------------------------------------------------------------------------------------------------------------------------------
----------------------------------------------------------------------------------------------------------------------------------------------------------
----------------------------------------------------------------------------------------------------------------------------------------------------------
----------------------o-------ooo--------o-------------------------------------------------o--------------------------------------------------------------
---------o-----o----------------------o-o-------------o--o---------o--o-------------------o-------o-----------------oo--o---------------------------------
-----------o------o-o--o-o---o---------o------------------------o---oo--------o---o-----------------o-----o-oo--------------------o--------o--------------
-------??So-o-X--?-o-o-?-?--o-?-XS----------o--oooooo---o--o------XX??----------oo?-X-----?X?S-----o---??--------------o--------------SS------------------
-----------------------------------o-----------------o----o-----------??S---S-----------o-----------------S?SXo-o---------oo-----o------------------------
----------X-??-------------X?S--------------XXX?X-----------oo--?X-----------------------o---------------------o----------------o-S-??--------------------
----------------------------------------------------S---------------------------------?X-S---------------------X??----------?--S-X------------------------
XXXXXXXXXX----XXXX----XXXX----XXXX----XXXX------------------------XXXX------------XXXX----XXXX--------XXXX----------------------------XXXXXXXX------------
XXXXXXXXXX----XXXX----XXXX----XXXX----XXXX------------XXXX--------XXXXXXXXXXXXXXXXXXXX----XXXX----XXXXXXXXXXXX----XXXXXXXX------------XXXXXXXX------------
XXXXXXXXXXXXXXXXXXXXXXXXXXXXXXXXXXXXXXXXXXXXXXXXXX----XXXX----XXXXXXXXXXXXXXXXXXXXXXXX----XXXX----XXXXXXXXXXXX----XXXXXXXX--------XXXXXXXXXXXXXXXXXXXXXXXX
