----------------------------------------------------------------------------------------------------------------------------------------------------------
----------------------------------------------------------------------------------------------------------------------------------------------------------
----------------------------------------------------------------------------------------------------------------------------------------------------------
----------------------------------------------------------------------------------------------------------------------------------------------------------
------------------o-----------o---------------------------------------------------------------------------------------------------------------------------
---------o-o-o---o--o--------o-o----oo-----------o-----o-----------o----------------------------------------o-o-o--------o--------------------------------
----------o--------o--------o---o-----o---------o------------o------oo----o-----o------------------------------o-----o-o----------------------------------
-------SX??-SS--------o---?SX????--------o--o-SSX---o-X----o--o---------oo-------oo-o--o-o---o--o-ooo----------?-S------o----o----o--------o--------------
--------------X-S-----------------S?---oo---------oo------o-o---SX??SSoo------oo-------?XXoo--------------??SX------X----------o------?-------------------
---------------------------------------------S----SS?S-----------------------------??X-----?-X---o------------------------------oo------------------------
----------------------?S??--------------------------------------------S???---------------------------S?S??---------------------S??SXX---------------------
XXXXXXXXXXXXXX----XXXX----XXXXXXXX------------XXXX----XXXX----------------XXXX--------------------------------XXXX----------------------------XXXXXXXXXXXX
XXXXXXXXXXXXXXXXXXXXXX----XXXXXXXXXXXX--------XXXX----XXXX----XXXXXXXX----XXXX--------XXXX----------------XXXXXXXXXXXXXXXX------------XXXX----XXXXXXXXXXXX
XXXXXXXXXXXXXXXXXXXXXX----XXXXXXXXXXXXXXXXXXXXXXXXXXXXXXXXXXXXXXXXXXXX----XXXXXXXXXXXXXXXXXXXX------------XXXXXXXXXXXXXXXXXXXX--------XXXX----XXXXXXXXXXXX
