----------------------------------------------------------------------------------------------------------------------------------------------------------
----------------------------------------------------------------------------------------------------------------------------------------------------------
----------------------------------------------------------------------------------------------------------------------------------------------------------
----------------------------------------------------------------------------------------------------------------------------------------------------------
------------------------------o-o--------------------------------o------------------------o-------------------------------------oo------------------------
--------oo---------o-----------o---------------oo-------------o-o--o-o---------------------o------------------------------o--o----------------------------
------oo------------------o-o----------------o---o---------o-----------------------o---------------------------------o-o-o----o------------o--------------
--------------------oo-------o-???----o----oo-----o---?X----o----S-------------ooo---oo-oo?SXS----------o--ooo-o----o---o--?S-?S--------------------------
------?-X-o-------------o--o---------o-ooo----?XS-??X--------o-----??So--------------------------o-o-o---X----o-------------------------------------------
----------?-?---------oo--SS--------o---------------------------------?S-??-?-------?-?--X------o-o-o------------oS---------------o-----------------------
---------------?-?----------------------------------------------------------------------------??-S---------??-X---------------------X?--------------------
------------------------------XXXX--------------------XXXX----XXXX------------------------XXXX----------------------------XXXXXXXX------------------------
XXXXXXXXXX--------XXXX--------XXXX--------XXXXXXXXXXXXXXXX----XXXXXXXX--------XXXX--------XXXX--------XXXX------------XXXXXXXXXXXX------------------------
XXXXXXXXXXXXXX----XXXX----XXXXXXXX--------XXXXXXXXXXXXXXXXXXXXXXXXXXXXXXXXXXXXXXXXXXXXXXXXXXXX--------XXXX--------XXXXXXXXXXXXXXXX--------XXXXXXXXXXXXXXXX
