----------------------------------------------------------------------------------------------------------------------------------------------------------
----------------------------------------------------------------------------------------------------------------------------------------------------------
----------------------------------------------------------------------------------------------------------------------------------------------------------
----------------------------------------------------------------------------------------------------------------------------------------------------------
---------o-----------------------------------------------------o------------------------------------------------------------------------------------------
-------------------------------------o---------------------------------o------ooo-------o-------o----------------------o----------------------------------
-------o---------o--o-----------------------------------oo-----------o-----------oo-o----o-------------------------------oo----o-o------------------------
-------S-X--------oo-o------o-o--------o------------------------?SS??So----S-----------o--o-o------ooo------oo-------oo-o---------o-----------------------
-------------------------------o-o----o-o--------ooo--?S-?-oo---------XS-X------------?--?-----?---------------o-------X----??-----o-----o----------------
----------oo-----------o-----o----------------------o-----o------------------------??S-------------------?----o---???---------SX?X---------o--------------
----------XS?--------------?-??XS----------?S?S?-???X?------------------------------------S----------------X?SS-S-----------------?X?---------------------
XXXXXXXXXX----------------------------------------------------XXXXXXXX----XXXX----------------------------------------------------------------------------
XXXXXXXXXX----XXXXXXXX------------XXXX----------------XXXX----XXXXXXXXXXXXXXXXXXXX----XXXX----XXXX--------------------XXXXXXXX----------------------------
XXXXXXXXXX----XXXXXXXX------------XXXXXXXX------------XXXX----XXXXXXXXXXXXXXXXXXXXXXXXXXXX----XXXX----XXXX--------XXXXXXXXXXXXXXXX------------XXXXXXXXXXXX
