----------------------------------------------------------------------------------------------------------------------------------------------------------
----------------------------------------------------------------------------------------------------------------------------------------------------------
----------------------------------------------------------------------------------------------------------------------------------------------------------
----------------------------------------------------------------------------------------------------------------------------------------------------------
--------------------------------------------------------------------------------------------------------------------o-----------oo------------------------
----------o--------o-------------------------------------------------o--------o-------------o------oo--------------o-----------------------o--------------
--------oo----------o-----------------o------------o------o-o---------o--------ooo--------o----------o-----o-------------------o--ooo---------------------
----------XX-S-------o-o---o-oo----------------oo-----------------S?XS-o------?----o----o----o-o--o-----------o---S-X----------XX?--------o---------------
------?-S?--------S------------o-------ooo-------o??SS?X-?-----X------??-?--------o----o-o-S?----------XSX---o-o--------oo---------?XS---o----------------
-------------------------oXX--XS?S-??---------o---------------------------S-----------?S-?----------------??S?--o------o--o------------oo-----------------
--------------S-?------------------------------S??---------------------------------X?X------------------------?--?----------S-----------------------------
----------XXXX--------------------------------------------XXXX----XXXX--------XXXX--------------------------------XXXX--------XXXX------------------------
XXXXXXXXXXXXXX----XXXX--------------------XXXX----XXXXXXXXXXXXXXXXXXXXXXXX----XXXX--------XXXXXXXXXXXXXXXX--------XXXX--------XXXXXXXX----XXXX------------
XXXXXXXXXXXXXX----XXXX----XXXXXXXXXXXXXXXXXXXX----XXXXXXXXXXXXXXXXXXXXXXXXXXXXXXXX----XXXXXXXXXXXXXXXXXXXXXXXX----XXXX--------XXXXXXXX----XXXXXXXXXXXXXXXX
