----------------------------------------------------------------------------------------------------------------------------------------------------------
----------------------------------------------------------------------------------------------------------------------------------------------------------
----------------------------------------------------------------------------------------------------------------------------------------------------------
----------------------------------------------------------------------------------------------------------------------------------------------------------
-------------------------------------------------------------------------------ooo--------------------------------------------------o---------------------
------------------------------o--o---------------o-----------------o-o------------------------------------------------------------o-----------------------
---------o--------o-o-----------------------------o------------o----o--o------o-------------o----o-oo--------o------o-oo--o-------------------------------
----------oo-----------------o-?XS-------o--X????X--oo-----oo---?XS?SS-----------------o-o----------------XX-?o---------o----------X-?----o---------------
-------oo-S--------o-o--o----------o---o----------???S----o-----------o-------------------oo--------------------o--------o---o--oo-----?---o--------------
------??------------?------oo-------------------------o------o---------?-?--------?-X-S??X-?S--?--------X------o-------------?----------------------------
------------------------X-?SSS--------------------------X-----------------?-----------------------------------S?S----------------S------------------------
------------------------------XXXX--------XXXXXXXX------------XXXXXXXX--------XXXX----------------XXXX----XXXX--------------------XXXX--------------------
----------XXXXXXXX------------XXXX--------XXXXXXXXXXXX--------XXXXXXXX--------XXXX----------------XXXX----XXXX----XXXX------------XXXXXXXX----------------
XXXXXXXXXXXXXXXXXXXXXX--------XXXXXXXX----XXXXXXXXXXXX--------XXXXXXXXXXXX----XXXXXXXXXXXXXXXXXXXXXXXXXXXXXXXX----XXXXXXXXXXXX----XXXXXXXXXXXX----XXXXXXXX
