----------------------------------------------------------------------------------------------------------------------------------------------------------
----------------------------------------------------------------------------------------------------------------------------------------------------------
----------------------------------------------------------------------------------------------------------------------------------------------------------
----------------------------------------------------------------------------------------------------------------------------------------------------------
----------o---------------------------oo-o---------------------------------------o-------------------------------------oo---------------------------------
--------oo----------oo-------o----------o------------------o--------o-------------------o--------o----------------------------------o---------------------
-------------------o--------o-----o-----------------o-------oo-------oo-o------oo--------o--------oo--o--------------------o----o-oo----------------------
-----------?-----------oo-?-?X---o---o----------------o--oo-----------------------o---SXS-oo--?X-S----------o-o----------------o--S-S?---o-o--------------
------?SX?----S?---------o----oo----------------ooo---?-----S--XSXS-X-??-?---o-------o------o-------o----------------------------o------o-----------------
------------------------------XSX-------------?S?XS?S--------------------------------?----?S?---------X--X---o----------------X-?X----X-------------------
--------------------------------------------XX----------------------------X-X------------------------------??X??SS----------------------------------------
----------XXXX----XXXX----XXXX--------XXXX------------------------------------XXXX----XXXX----XXXX--------------------XXXX--------XXXX--------------------
XXXXXXXXXXXXXXXXXXXXXX----XXXX----XXXXXXXX------------XXXXXXXXXXXXXXXXXXXX----XXXX----XXXX----XXXX--------------------XXXXXXXX----XXXX--------XXXXXXXXXXXX
XXXXXXXXXXXXXXXXXXXXXX----XXXXXXXXXXXXXXXX----XXXXXXXXXXXXXXXXXXXXXXXXXXXX----XXXXXXXXXXXXXXXXXXXXXXXXXXXX--------XXXXXXXXXXXXXXXXXXXXXXXX----XXXXXXXXXXXX
