----------------------------------------------------------------------------------------------------------------------------------------------------------
----------------------------------------------------------------------------------------------------------------------------------------------------------
----------------------------------------------------------------------------------------------------------------------------------------------------------
----------------------------------------------------------------------------------------------------------------------------------------------------------
----------------o--------o------------------------oo-------o----------------------------o------------o----------------------------------------------------
----------------------o-o--------------o------------------o------------------------------o-------------------------------------o-o------------------------
---------------o-----------o--o---------o-------------------o-o--------------o--------------------ooo-----o-o-o-----------------o----------o--------------
--------o-------------------oo-----------o-------oX?-X----?----------o--o-S------o----?-?S-o------------o----o-----------oo-------------------------------
------------------oo------?S?S--------------o-----------------------o-o-------ooo-S?-?----o------------o---XS?X---------------XXS?oo------o---------------
-------X?Xo-o-------oo--------??-?--------S-?S--o------?------??-??--X??--------------------------------------------?-o-o--------------o------------------
----------SXS---------------------XS-----------XS?----------------------------------------?XXXS-----------------------------------?-?X--------------------
--------------XXXX----XXXX------------------------XXXX----XXXX------------XXXX--------XXXX--------XXXX----------------------------------------------------
--------------XXXX----XXXXXXXX--------XXXX--------XXXX----XXXX------------XXXX----XXXXXXXX--------XXXX----XXXXXXXX------------XXXX------------XXXXXXXXXXXX
XXXXXXXXXX----XXXX----XXXXXXXXXXXX----XXXXXXXX----XXXXXXXXXXXXXXXXXXXXXXXXXXXXXXXXXXXXXXXX--------XXXX----XXXXXXXXXXXX--------XXXX--------XXXXXXXXXXXXXXXX
