----------------------------------------------------------------------------------------------------------------------------------------------------------
----------------------------------------------------------------------------------------------------------------------------------------------------------
----------------------------------------------------------------------------------------------------------------------------------------------------------
----------------------------------------------------------------------------------------------------------------------------------------------------------
-------------------------------o------------------o--------oo---------------------------------------o-----o--o--------------------------------------------
--------------------o-----o---o-------o--o---------o------o---------------------o---------o----------o---o-------------o---o---------------o--------------
--------------o---o--------------o------------------o--------o----------------o------------o-----ooo--------o---------o-oo------oo------------------------
----------oo--??X--o---------o-X?----o-o---?------SS?-----------o-------o---o--o-----------------------o--SX??o--------------oo---------------------------
--------o-----------------???S-----o-------------o------o-----------oo-o-o----?------?---o?X-S-X---------?----------o-----X???----------------------------
---------o?-X-----------SS----------------------------------------?X??S----o-----------------------------------oo--------------?-So----??-----------------
--------?-------------------------------------?S??-----??-------XS--------?SX---------?XS---------------------?--S----------------X?X---------------------
--------------XXXX------------XXXX--------XXXX----XXXX----XXXX------------------------------------XXXX----XXXX----------------------------XXXXXXXXXXXXXXXX
--------------XXXXXXXX----XXXXXXXX----XXXXXXXX----XXXX----XXXX----------------XXXXXXXX----XXXXXXXXXXXXXXXXXXXX--------XXXXXXXX------------XXXXXXXXXXXXXXXX
XXXXXX----XXXXXXXXXXXXXXXXXXXXXXXX----XXXXXXXX----XXXX----XXXX----XXXXXXXX----XXXXXXXX----XXXXXXXXXXXXXXXXXXXX----XXXXXXXXXXXXXXXX----XXXXXXXXXXXXXXXXXXXX
