----------------------------------------------------------------------------------------------------------------------------------------------------------
----------------------------------------------------------------------------------------------------------------------------------------------------------
----------------------------------------------------------------------------------------------------------------------------------------------------------
----------------------------------------------------------------------------------------------------------------------------------------------------------
---------o----------------------------------------------------------------------------------------o-------------------------------------------------------
-------------------oo-------------------------o-o--o-----------------o----o----oo----o--oo----------------------------------------------------------------
-------------------------------------------------oo-o-----ooo-----o---o----------o-----------------ooo------ooo-o---------o----ooo--o---------------------
------??-So-------o------------o---o---o-------------------------oS--?-o-----oo----X??-o--o------o?-------?X-SSS?--?----o---------o-------oo--------------
-----------o-----------------oo----------oX-???X?--X-S------------------o-?------------?----o----------o--------------o---S?X?----------------------------
----------S??-------------S?S?---o----o-o---------------o-------------?X?S----------------------?-----o----------------o------?S??-?X?--------------------
-------------------------X-----X-S-------X------------?-?------?-S------------------------S?-?-----------X------------------------------------------------
XXXXXXXXXX------------------------------------------------XXXX----XXXX------------XXXX------------XXXX----XXXXXXXXXXXX----------------XXXX----------------
XXXXXXXXXX--------XXXX------------XXXX----XXXXXXXXXXXX----XXXX----XXXX----XXXXXXXXXXXXXXXX--------XXXX----XXXXXXXXXXXX----XXXX--------XXXXXXXX----XXXXXXXX
XXXXXXXXXXXXXX----XXXX----XXXX----XXXX----XXXXXXXXXXXX----XXXX----XXXXXXXXXXXXXXXXXXXXXXXX----XXXXXXXX----XXXXXXXXXXXX----XXXXXXXXXXXXXXXXXXXX----XXXXXXXX
