----------------------------------------------------------------------------------------------------------------------------------------------------------
----------------------------------------------------------------------------------------------------------------------------------------------------------
----------------------------------------------------------------------------------------------------------------------------------------------------------
----------------------------------------------------------------------------------------------------------------------------------------------------------
----------o---------------------------------------------------------------------------------------oo----------o-------o-o---------------------------------
-----------------------------o--------------------------------------o-----------oo------oo---------------------o-------o-----------------o----------------
--------------------oo-----o------------o-----------------------------------------o----o--o---------o------o----o-o-o----------------------o--------------
---------oSXS-------------XXXS--------o--------ooo----S-?S-o------SS??o------o-o------?-X?--o---------o-o-------?--o---------------o------o---------------
--------o----------o-----X----oo-------o-o--------o---------oo--oo-------o---------?-X-----------------------o-------------?X?---oo-----------------------
--------------o---?-----------------o-----o-ooSXSXXSS?---------?-?-------------------------X?------------S?S?S---------------------S-?--------------------
------?X-X----?-?-------------??SSS--------?-S-------------------------?X?--X-------------------------------------------------XX?S------------------------
XXXXXX----XXXX------------XXXX------------------------XXXX--------XXXX----------------XXXX--------XXXX--------XXXX----XXXX--------------------------------
XXXXXX----XXXX--------XXXXXXXX------------------------XXXX--------XXXX--------XXXXXXXXXXXX----XXXXXXXX--------XXXX----XXXXXXXX--------XXXX----------------
XXXXXX----XXXX----XXXXXXXXXXXX--------XXXX----XXXXXXXXXXXXXXXXXXXXXXXX--------XXXXXXXXXXXXXXXXXXXXXXXXXXXXXXXXXXXXXXXXXXXXXXXX----XXXXXXXXXXXXXXXXXXXXXXXX
