----------------------------------------------------------------------------------------------------------------------------------------------------------
----------------------------------------------------------------------------------------------------------------------------------------------------------
----------------------------------------------------------------------------------------------------------------------------------------------------------
----------------------------------------------------------------------------------------------------------------------------------------------------------
-------------------oo-----------------------------------------------------------oo----------------------------o--------o----------------------------------
------------------o------------------------------------------------------------o--o--o-----o---------------o-----o----o-o--------o------------------------
--------o---o--------o-----o-o--------oo------------------------------oo------o------------------------------------------o------o---------oo--------------
----------o------------XX?----ooo--------o-------o---------oo-SSSX---o-----o----------o--oo-------ooo----o--oo-XX?---------------------o------------------
---------o-o-----o---------?X?-----oo---S?-S-?----oo--o---o----------------------------o----X--------oo---?----------------X-?X??Xoo----------------------
--------???-SX----------------S???---o------------XSX?--o-------------SXX----o----------o-----S-?---------------------------------------------------------
--------------S?------------------------------SXS?----??-----X----?X??-----------------S?---------------------------?-------------?XS?--------------------
------------------XXXXXXXX------------------------------------XXXX------------XXXXXXXX------------------------XXXX----XXXX--------------------------------
------------------XXXXXXXXXXXX--------XXXXXXXX----------------XXXX------------XXXXXXXX----XXXX------------XXXXXXXX----XXXXXXXXXXXX--------XXXX----XXXXXXXX
XXXXXXXXXXXXXX----XXXXXXXXXXXXXXXX----XXXXXXXX----XXXX--------XXXX----XXXX----XXXXXXXX----XXXXXXXXXXXXXXXXXXXXXXXX----XXXXXXXXXXXX--------XXXX----XXXXXXXX
