----------------------------------------------------------------------------------------------------------------------------------------------------------
----------------------------------------------------------------------------------------------------------------------------------------------------------
----------------------------------------------------------------------------------------------------------------------------------------------------------
----------------------------------------------------------------------------------------------------------------------------------------------------------
---------------------------------------------------o---------------ooo----------o--o----------------------------------------------------------------------
-------o-------------o-------------------------oo-o----------------------------o-oo--o------------o----------o------------o-----oo------------------------
--------------------o-o----------------------o----------------oo--o--------------------------------o-o------o------------------o--------------------------
--------ooo---X--?-o--------o-oo------o----oo----o-S?-?---oo--?-?-SSX?o-------X----??S-oo-----------o---------o-------o-o----------o------oo--------------
--------X?---------------?---o--o-------o--X?S??-S----------oo--------???X----------------o--o------------???X-o---o-----o--??XSS?------------------------
----------??X-------------o---SXS?-----o-o-----------------------------------------------o----?X?----------------o-----o----------o-----------------------
---------------------------SX?----S-?-------------------------------------?XX---------??S-S--X-------------------------------------?----------------------
--------------XXXX--------------------------------XXXXXXXX----XXXXXXXX--------XXXXXXXX--------------------------------------------------------XXXXXXXXXXXX
XXXXXXXXXX----XXXXXXXXXXXX----------------XXXXXXXXXXXXXXXX----XXXXXXXXXXXX----XXXXXXXX------------XXXX----XXXX------------XXXXXXXX----XXXX----XXXXXXXXXXXX
XXXXXXXXXXXXXXXXXXXXXXXXXX----XXXX--------XXXXXXXXXXXXXXXX----XXXXXXXXXXXX----XXXXXXXX--------XXXXXXXXXXXXXXXX----XXXX----XXXXXXXX----XXXXXXXXXXXXXXXXXXXX
