----------------------------------------------------------------------------------------------------------------------------------------------------------
----------------------------------------------------------------------------------------------------------------------------------------------------------
----------------------------------------------------------------------------------------------------------------------------------------------------------
----------------------------------------------------------------------------------------------------------------------------------------------------------
--------------------------------o-----oooo------------------------------------------------------------------------------------------------o---------------
-----------------------------------------------------------oo-o-------o-----------oo--o-oo-----------------------------------o----------------------------
------------------------------oo------------------o-----o------------o-----------o-------------------------------------oo------------------o--------------
----------o---o--oo-o-----o---X-SS---o-S--------o----------------?--o---------o------o-o--o---------oo------ooo---?--------------oo------o----------------
--------------?-S-----?------------------------o-o?-??S?--?-------o---SSS?------o--?-?-??S--o--?X--o--o---XXSS------------XSSXS?-?-o----------------------
--------oo-o-------o-o-------o-------?-----o------------------------?-----?-?--------------??X----o---------------------------------oo--------------------
--------SX--?---------------------------------------------------------------------------------------------------?-----------------?-?---------------------
------------------------------XXXX----XXXX--------------------XXXX------------------------------------------------XXXX--------------------XXXX------------
XXXXXX--------XXXX----XXXX----XXXX----XXXX--------XXXXXXXXXXXXXXXX----XXXX--------XXXXXXXX----XXXX--------XXXX----XXXX----XXXXXXXX--------XXXX------------
XXXXXX--------XXXX----XXXX----XXXXXXXXXXXX----XXXXXXXXXXXXXXXXXXXXXXXXXXXXXXXXXXXXXXXXXXXXXXXXXXXX----XXXXXXXX----XXXXXXXXXXXXXXXX--------XXXXXXXXXXXXXXXX
