----------------------------------------------------------------------------------------------------------------------------------------------------------
----------------------------------------------------------------------------------------------------------------------------------------------------------
----------------------------------------------------------------------------------------------------------------------------------------------------------
----------------------------------------------------------------------------------------------------------------------------------------------------------
-------------------------------------------------o------------o-----------------------------------------------oo----------o-----o-------------------------
------------------------------------------------o----------ooo---------------------------------o---oo------------------ooo--------------------------------
-------------------o------------------ooo--o---o----o-----o--------------------oo-------------o-o-o-------------o----o-----o-o-o--ooo----o----------------
------------------------------oo--o------o---oX?SX-----o-o----?-X--o-----------------?---o-ooo-------o---o-ooo---X----o----S???-XS?--?----oo--------------
--------o----o---o--o--------o--o-----------?-----oo----------------ooo----------------SX?o---?S-------o------------o---??--------------------------------
----------o-o--------------------o---o------------?X?X------------?SSX?-???S-?----------------------------SSS-----?---------------------------------------
--------X-?-XXS-?--------?--S?XX???-?-----------------------------------------------------?-X?--------SX-?------------------------------------------------
----------------------------------------------XXXX--------XXXXXXXX------------XXXXXXXX------------------------XXXX--------XXXXXXXXXXXXXXXX----------------
------------------------------------------XXXXXXXX----XXXXXXXXXXXX------------XXXXXXXXXXXX----XXXXXXXX--------XXXX----XXXXXXXXXXXXXXXXXXXX----XXXXXXXXXXXX
XXXXXX------------XXXX----------------XXXXXXXXXXXXXXXXXXXXXXXXXXXXXXXXXXXXXXXXXXXXXXXXXXXX----XXXXXXXX----XXXXXXXXXXXXXXXXXXXXXXXXXXXXXXXXXXXXXXXXXXXXXXXX
