----------------------------------------------------------------------------------------------------------------------------------------------------------
----------------------------------------------------------------------------------------------------------------------------------------------------------
----------------------------------------------------------------------------------------------------------------------------------------------------------
----------------------------------------------------------------------------------------------------------------------------------------------------------
----------oo---------------------------o--------------------------------------oo-o-----------------o---------------------o--------------------------------
-------------------o----------o-------o-o-o-----------------oo-o----oo----------o----------------------------o---------oo-oo------------------------------
---------o----------o----------o---------o---------------o---------o-----o-o--------o---------------oo---o--o--------------------o------------------------
--------o-??-S----o--o------oo?SX?----------o-----o--------o----??----o-o------------?o-oo----X?--S-------SXX?--------------?S--o--------o-o--------------
------?SS?-----------------X-?-----o------?-----o--o--------------??-X??------------------------------------------------------o-----o---------------------
----------------------------------S-----------o--o-----X--------------------------------X?o-------------??-----o--------------XXSXo-----------------------
----------------------------------------------?-?-XS-S------------------------------------S-X?----------------X?SS-----------------S?X?X?-----------------
----------XXXXXXXX----XXXX----XXXX----XXXX--------------------XXXX------------XXXXXXXX--------XXXXXXXX----XXXX--------XXXXXXXX----------------------------
XXXXXXXXXXXXXXXXXXXXXXXXXXXXXXXXXX----XXXXXXXX------------XXXXXXXXXXXXXXXX----XXXXXXXX--------XXXXXXXX----XXXX----XXXXXXXXXXXX----------------XXXXXXXXXXXX
XXXXXXXXXXXXXXXXXXXXXXXXXXXXXXXXXXXXXXXXXXXXXX--------XXXXXXXXXXXXXXXXXXXXXXXXXXXXXXXXXXXX----XXXXXXXXXXXXXXXX----XXXXXXXXXXXXXXXX------------XXXXXXXXXXXX
