----------------------------------------------------------------------------------------------------------------------------------------------------------
----------------------------------------------------------------------------------------------------------------------------------------------------------
----------------------------------------------------------------------------------------------------------------------------------------------------------
----------------------------------------------------------------------------------------------------------------------------------------------------------
---------------------------------------------------------------------------------------------------------------------o------------------------------------
---------o---------oo------------------ooo-----ooo------------------------------o-----------------o--------------------oo----------o-o--------------------
------o---o----------o------oo-o------------------o----------o-------o---------o-------------------o-o----------------o-----------o--------o--------------
-------o-------------------o--o-----o---------o-----------ooo------------o--o-o---------ooo-o-------o-----------o--SX?--------------o-o---o---------------
------SSS??SX?--------o-----???X?X--------o-o-?SX?-o----------------o-o-----------o---?S-S-o-o-------?------ooo--------------X---oX?----------------------
--------------------------------------------X-----X?-?----------???S?S-oo----o----??-?--------o--o----??XX-S?S-o-----------------------ooo----------------
-------------------------S--------???X----------------?X-----------------?-----------------?SX----------------???S------------???X------------------------
--------------------------------------XXXX------------------------------------------------------------------------XXXXXXXX--------------------------------
XXXXXXXXXXXXXXXXXXXXXX----XXXXXXXX----XXXX----XXXX--------XXXX----------------XXXX----XXXX--------XXXX------------XXXXXXXXXXXX----XXXX--------------------
XXXXXXXXXXXXXXXXXXXXXX----XXXXXXXX----XXXXXXXXXXXXXXXX----XXXXXXXXXXXX--------XXXXXXXXXXXX--------XXXXXXXXXXXX----XXXXXXXXXXXX----XXXX----XXXXXXXXXXXXXXXX
