----------------------------------------------------------------------------------------------------------------------------------------------------------
----------------------------------------------------------------------------------------------------------------------------------------------------------
----------------------------------------------------------------------------------------------------------------------------------------------------------
----------------------------------------------------------------------------------------------------------------------------------------------------------
---------------------------------------------------------------------------------------------------------------o------------------------------------------
------------------------------------------------oo--------------------o--------------------o------------------o-------------------------------------------
-------oo------o-o----------o-o-------------------------------o-o-------o----------------oo----------------------------------------o----------------------
---------o-o-------oo-?-SX-?S?-o-------o-----?----o---------oo------------o-----------??S---o-----oo-------o-oXX-X----o---------o-o-----------------------
------???---------------------S-X-o-ooo--o----X--?--------oo---o---oo-?X-----ooo----------?XS?------o-o--------------o-oo---?-o--o---------o--------------
----------o---S--?o---------------------o----------o---?--------SS---o----------o-?SX?--------X------------?S?----X------o--------?X----------------------
----------S--?-----S------------------------------S?-?--------------?-----?------?---------------------S?---------------------?X??------------------------
----------------------XXXXXXXX------------XXXX----------------------------------------XXXX--------------------XXXX----------------------------------------
XXXXXXXXXX------------XXXXXXXXXXXX--------XXXXXXXX--------------------XXXX------------XXXXXXXX----------------XXXX--------XXXX----------------XXXXXXXXXXXX
XXXXXXXXXX----XXXX----XXXXXXXXXXXXXXXX----XXXXXXXX----XXXXXXXXXXXX----XXXX--------XXXXXXXXXXXXXXXX--------XXXXXXXXXXXX----XXXX----XXXXXXXX----XXXXXXXXXXXX
