----------------------------------------------------------------------------------------------------------------------------------------------------------
----------------------------------------------------------------------------------------------------------------------------------------------------------
----------------------------------------------------------------------------------------------------------------------------------------------------------
----------------------------------------------------------------------------------------------------------------------------------------------------------
----------o---------------------------o-o------------------o--------------------oo-----------------------------------o---o------o-------------------------
-------o-------------------------------o----------o---------o----------------------o--------------------------oo-----------------o------------------------
-------------------oo--------------o------o-------------o----o----------------oo------------oo---------------o----o---ooo-----o---------------------------
------o--o?-XS--------------ooo-o----------------o--o--------------o-o-------o--------o---o---------oo-?-?-o----o-S--------------S------------------------
------?-S-------------o-------------------------o-?XS?--------??SX----------------------o--o----o-------------X?----------o-------o--------o--------------
---------------------------?---o--SXS-----------------------------?-SSoo-----------------o-X?X---ooo-------?X?--------------?X-----------X----------------
--------------?X-?------------X?S?------------S???--------------------XS-?XS?----------XS-----------------------------------------?X?---------------------
----------XXXX------------------------XXXXXXXX--------XXXXXXXX----------------XXXX--------------------XXXX--------XXXXXXXX----XXXX------------------------
XXXXXXXXXXXXXX----XXXX----------------XXXXXXXX----XXXXXXXXXXXXXXXX------------XXXXXXXX----------------XXXX----XXXXXXXXXXXX----XXXX------------XXXXXXXXXXXX
XXXXXXXXXXXXXX----XXXXXXXXXXXX----XXXXXXXXXXXX----XXXXXXXXXXXXXXXXXXXX--------XXXXXXXX----XXXX--------XXXXXXXXXXXXXXXXXXXXXXXXXXXX----XXXX----XXXXXXXXXXXX
