----------------------------------------------------------------------------------------------------------------------------------------------------------
----------------------------------------------------------------------------------------------------------------------------------------------------------
----------------------------------------------------------------------------------------------------------------------------------------------------------
----------------------------------------------------------------------------------------------------------------------------------------------------------
----------------------------------------------------o-----------------------------------------------------------------------------------------------------
-----------------------o------------o--o---------------------------------------------------------------------o--------------------------------------------
---------------o------------o-----------o-------oooo-----------------ooo--------------o-o----------------o-o----------------------------------------------
---------o------------?--S---o-----------------XX-S-?X--o-oo---o--?XSS----o-o--o------------------o--o--------o---------------------o---o--o--------------
--------o-oo-o------o-----?S?-oo----------------------X-----o-------------------oo-----o-o--o-S----o--------X?-S?------o-o--------o-----------------------
----------X-?SS?--oo------------------------o-----------------?-X------X?SX-??o--------?-Xo---------o--X-------------------?-S---o--------o---------------
-------SX?--------------------??S?-----------X--------------------------------X-----------??-S--------------------?--------------????S--?-----------------
----------------------XXXX--------XXXX--------XXXXXXXX------------XXXX------------------------------------------------------------------------XXXXXXXXXXXX
----------------------XXXXXXXX----XXXXXXXX----XXXXXXXXXXXX--------XXXX------------------------XXXX--------XXXXXXXX----------------------------XXXXXXXXXXXX
XXXXXX----XXXXXXXX----XXXXXXXX----XXXXXXXX----XXXXXXXXXXXXXXXXXXXXXXXXXXXXXXXX--------XXXX----XXXX----XXXXXXXXXXXX----XXXXXXXX----------------XXXXXXXXXXXX
