----------------------------------------------------------------------------------------------------------------------------------------------------------
----------------------------------------------------------------------------------------------------------------------------------------------------------
----------------------------------------------------------------------------------------------------------------------------------------------------------
----------------------------------------------------------------------------------------------------------------------------------------------------------
----------------------------o-----------------------------------------------o-----------------------------------------------------------------------------
--------o---o----------------o----------o----------------o-----------o----o----------------------------------o--o-----o--o----------------o---------------
---------oo-----------o------------------------o-o----------o------o-----o------------------o-------o---------o----------------------------o--------------
----------????XS?--o------??XX-----o---o-oXSSS------o-o---oo--------o---o--X-X------------o-----S-oo--------------------o---o---oo-o----------------------
------?-?X----------o---------oo--------------?XSXoo---------o---o-?S-o--------oo--------o-----------X?-?SXSSS-XXS----X-----X-----o-----------------------
------------------o--o-----------o---o------------X??-----?-----------S?-X----o-----------S?X---------------------?-?---------?S?-?S-X--------------------
------------------------------XS------------------------------------------------------XSXS----------------------------------------------------------------
----------XXXXXXXX--------XXXX------------XXXX----------------------------XXXX----------------XXXX--------------------------------------------------------
XXXXXXXXXXXXXXXXXX----XXXXXXXX--------XXXXXXXXXXXX----XXXX--------XXXX----XXXX----XXXX--------XXXXXXXXXXXXXXXXXXXX----XXXXXXXX------------XXXXXXXXXXXXXXXX
XXXXXXXXXXXXXXXXXX----XXXXXXXX--------XXXXXXXXXXXXXXXXXXXXXXXX----XXXXXXXXXXXX----XXXX----XXXXXXXXXXXXXXXXXXXXXXXXXXXXXXXXXXXXXXXXXXXXXXXXXXXXXXXXXXXXXXXX
