----------------------------------------------------------------------------------------------------------------------------------------------------------
----------------------------------------------------------------------------------------------------------------------------------------------------------
----------------------------------------------------------------------------------------------------------------------------------------------------------
----------------------------------------------------------------------------------------------------------------------------------------------------------
--------------------------o---------------------o--------------------o------------------------------------------------------------------------------------
-----------------------------o-------------------o----------o-----------------------------o----------------------------o----------oo----------------------
----------------o-o--o-o----o-oo-----o---------------------o------------------o----------------o-o--------------------o-o-----------------oo--------------
------o-oooo-------oo-----???S-----------oo--oX??------------------S?X---------o---------o--o------oo-------oooo-----------------o?--X--------------------
-----------------------?--------o-----ooo---o-----o---X--S----?XS?----ooo-------oo--o-o-o-?----------o----o----???------------X--?-----o------------------
------?--?----?X--X-----------X?-??------------------o---------------------------------o-------------?------------o---------XS----------------------------
-------------?------------------------------X-----????----------------?-?S---------S??X?-?-------------S?-SX?S------------------------?-?-----------------
--------------------------XXXX----------------XXXX----------------XXXX------------------------XXXX--------------------XXXX--------XXXX----XXXX------------
----------------------XXXXXXXX----------------XXXX----XXXXXXXXXXXXXXXX--------------------XXXXXXXX------------XXXX----XXXX----XXXXXXXX----XXXXXXXXXXXXXXXX
XXXXXXXXXX----XXXXXXXXXXXXXXXXXXXXXXXXXXXX----XXXX----XXXXXXXXXXXXXXXX--------XXXX--------XXXXXXXXXXXX--------XXXX----XXXXXXXXXXXXXXXX----XXXXXXXXXXXXXXXX
