----------------------------------------------------------------------------------------------------------------------------------------------------------
----------------------------------------------------------------------------------------------------------------------------------------------------------
----------------------------------------------------------------------------------------------------------------------------------------------------------
----------------------------------------------------------------------------------------------------------------------------------------------------------
-------oo----------------------------------------------------o------------------------------------------o----oo---------------------------o---------------
------o--oo----------------------o--------------oo----------o-----o--------------o----------o--------------------------------------o-o-----o--------------
-----------------------------ooo---o----------o------------o----o--o-o----------o-------o-oo--oo-o----o-----o--oo-----o-oo----o-oo------------------------
-------X------S-----o------?SX?S?S-----o----------oo----------o---X?XX---------o--o-------??XX----o-o-------??S??S-----o---o--???So-----------------------
----------S?-X----------X?------------o--o----S-??-----o--------------o------------------o---------o--------------o-o---------------?S--------------------
-------------------o--------------?X----o------------o??-?-------------XX--------------??-----?--?---o----------------------?-----------------------------
---------------------------------------?-----------X?S--------------------?-X?-------X--------------------------------------------------------------------
XXXXXXXXXX----XXXX--------XXXXXXXX--------XXXX------------XXXX----XXXX--------------------XXXX--------XXXXXXXXXXXX------------XXXX----XXXXXXXX----XXXXXXXX
XXXXXXXXXXXXXXXXXX----XXXXXXXXXXXX--------XXXXXXXX--------XXXX----XXXX--------XXXX--------XXXX--------XXXXXXXXXXXX------------XXXXXXXXXXXXXXXX----XXXXXXXX
XXXXXXXXXXXXXXXXXX----XXXXXXXXXXXXXXXX----XXXXXXXX----XXXXXXXXXXXXXXXXXXXX----XXXX----XXXXXXXXXXXX----XXXXXXXXXXXX----XXXXXXXXXXXXXXXXXXXXXXXX----XXXXXXXX
