----------------------------------------------------------------------------------------------------------------------------------------------------------
----------------------------------------------------------------------------------------------------------------------------------------------------------
----------------------------------------------------------------------------------------------------------------------------------------------------------
----------------------------------------------------------------------------------------------------------------------------------------------------------
--------------------o---------------------------------------oo-o---------------------------o--------------------------------------------------------------
---------------------o------------------------------------o--------------------oo-----------o-------------------------------------------------------------
---------o---------o---o----oo------------------o----------o--------oo-o--o---------------o--o---o----------------o--o-----o----ooo--------o--------------
-------o---------------?SX------------o----------o-o-----o-S----------o----o-------?XX---o??-Xo------o-------oo--------o------XSS?-o----o-----------------
--------------S---------------oo-o-------o--------o----------------S--?S?S--X-------------------o-----?-XX-o-------------o--?-----------------------------
-------XS-o-----------------??-------o-oo-o---X-XX----??------------------------------??S?----S---ooo------?X-??-?-X----o---------XX-?X-------------------
----------???S----------------S--------------?----X--?----------------------------------------------------------------------------------------------------
------------------XXXXXXXX--------------------------------XXXXXXXX------------XXXXXXXX----XXXX--------------------------------XXXX--------XXXX------------
--------------XXXXXXXXXXXX--------------------------------XXXXXXXXXXXXXXXXXXXXXXXXXXXX----XXXX--------XXXX----------------XXXXXXXX--------XXXX------------
XXXXXXXXXX----XXXXXXXXXXXXXXXX----------------XXXX----XXXXXXXXXXXXXXXXXXXXXXXXXXXXXXXXXXXXXXXXXXXX----XXXXXXXXXXXXXXXX----XXXXXXXXXXXXXXXXXXXXXXXXXXXXXXXX
