----------------------------------------------------------------------------------------------------------------------------------------------------------
----------------------------------------------------------------------------------------------------------------------------------------------------------
----------------------------------------------------------------------------------------------------------------------------------------------------------
----------------------------------------------------------------------------------------------------------------------------------------------------------
----------------------o-----o----------------------------o-------------------------------------------o----------------------------------------------------
-------------------------o------o--------o----o-oo---------o-------------------------o-------------oo-----------------------------------------------------
-------o-o----------o--o-----o-o-----oo-o---------------------------o-------------o-----oo-----------------o-----------o--o----o--o-o------o--------------
-----------o-------------X?SSXo--------o------S-S-----?X-?o-oo----oo--o--------------S------o----o---S--------oo------------X-----------------------------
------?-?----------o----------???S--------o-------o------------------o----??---------------------------X-X---o-------o--o--------o--------o---------------
----------?-XX----X?--------------S----------?-----oo--------------SX----------ooo-----?SXoo--------------??X?-?X-------------XS?-?-?---------------------
--------------?SX---------------------------------?-?S----------S-----???-----------------SX?S---?----------------?-S-------------------------------------
----------------------XXXXXXXX----------------XXXX----XXXX------------------------XXXX------------XXXX--------------------XXXX--------XXXX----XXXXXXXXXXXX
XXXXXXXXXX------------XXXXXXXXXXXX----XXXX----XXXX----XXXXXXXX------------XXXX----XXXX------------XXXXXXXX----------------XXXX--------XXXX----XXXXXXXXXXXX
XXXXXXXXXXXXXX----XXXXXXXXXXXXXXXXXXXXXXXXXXXXXXXX----XXXXXXXX----XXXX----XXXX----XXXXXXXX--------XXXXXXXXXXXXXXXX----XXXXXXXXXXXXXXXXXXXXXXXXXXXXXXXXXXXX
