----------------------------------------------------------------------------------------------------------------------------------------------------------
----------------------------------------------------------------------------------------------------------------------------------------------------------
----------------------------------------------------------------------------------------------------------------------------------------------------------
----------------------------------------------------------------------------------------------------------------------------------------------------------
--------------------ooo-----------------------------------o-------------------------------o---------------o-----------------------------------------------
-------------------o---------------o-o-------------o-o--oo-o---------------o----------o--------------------oo----------o-o-o-o--------o-------------------
------o-ooo-----o------o----------o-------------------------ooo-----oo--------o----------o-------------------o----------o-----------------o---------------
------------SX-----------?-------o----------??---oo------------?-Xo---o-o---?--------X----X?SX-----------oX--S--------------------o-----------------------
----------------------------o---o-X?--o-----------??S-?-----------X--?---o-----ooo----??S------------o-o--------------------??-o---o--X----o--------------
------??S?----?X-------------ooo-------oo------XS?--------------------------------------------S----oo---------o------?--------o-oo------------------------
---------------------------?S?--?X------------------------------------?S-?------------------------------SS----S-X?------------X??-?-----------------------
----------XXXX----XXXXXXXX----------------XXXX------------XXXXXXXX--------XXXX----XXXX----XXXX------------XXXX--------------------------------------------
----------XXXX----XXXXXXXX--------XXXX----XXXX----XXXXXXXXXXXXXXXXXXXX----XXXX----XXXXXXXXXXXX------------XXXX--------XXXXXXXX--------XXXX----------------
XXXXXXXXXXXXXXXXXXXXXXXXXX--------XXXX----XXXXXXXXXXXXXXXXXXXXXXXXXXXX----XXXXXXXXXXXXXXXXXXXXXXXX--------XXXX----XXXXXXXXXXXX--------XXXXXXXXXXXXXXXXXXXX
