----------------------------------------------------------------------------------------------------------------------------------------------------------
----------------------------------------------------------------------------------------------------------------------------------------------------------
----------------------------------------------------------------------------------------------------------------------------------------------------------
----------------------------------------------------------------------------------------------------------------------------------------------------------
----------oo---------------o----------------------------------------------------------------------------------------o-------------o-----------------------
--------------o---oo--------o----------------o-----------------------------------------------------------------------o------------------------------------
--------------------o---o-o--o----------oo-o---o----------o-oo----o--o---------------------o-------o----------------------------o----------o--------------
----------SS?S--------o------?---------o---?-?o----o-------o----X--o--o---o---o-----------o-o----oo-ooo-o-o---o------------------o-??---------------------
------o-oo----?------?--------o------------------o---o--------------SX-o-----o-o---------oS?SX----?--?---------o-o----------------------------------------
------------------------?---------------------S?S-o-o-X?--------------?SSX-X----o---------------------------oo?S?------oo-o----???------------------------
---------?--------------------X?XS----------------SSXX-------------------------------??XS?------------X?--S???----------S--??-----------------------------
XXXXXX----XXXX------------XXXX------------XXXX----------------XXXX------------------------------------------------XXXX------------XXXX----XXXX------------
XXXXXX----XXXXXXXXXXXX----XXXX----XXXX----XXXX----------------XXXXXXXX--------------------XXXX----XXXX------------XXXX------------XXXX----XXXX------------
XXXXXX----XXXXXXXXXXXXXXXXXXXX----XXXXXXXXXXXXXXXX----XXXXXXXXXXXXXXXXXXXXXXXX------------XXXX----XXXX--------XXXXXXXX--------XXXXXXXXXXXXXXXXXXXXXXXXXXXX
