----------------------------------------------------------------------------------------------------------------------------------------------------------
----------------------------------------------------------------------------------------------------------------------------------------------------------
----------------------------------------------------------------------------------------------------------------------------------------------------------
----------------------------------------------------------------------------------------------------------------------------------------------------------
--------------------o----------o-o----o-----------------o--------------------------o---------------o---------------o-o------------------o-----------------
-----------o------o-------o-o---o------oo--------ooo-----o--------------------------------o----------oo---------------------------------------------------
--------oo---------o---o------o----------------------o----o-o---------o-------o-o-------o-----------------o--o--o----------------oo-o---------------------
---------------------?o------o??---------S----------o--S-----oo-o---oo-oo------o-----X----------------X-?-----o------------X??X?S-----X?--o---------------
-------S?S??X?------------?XX?-------------S--?X??X-SS-------------------o-------o-------o-SSX------------S???----------o---------------------------------
------------------------?----------------------------------------?-XXX?XS----o---------XS?--------------------X-?-----oo----------???------o--------------
---------------X----------------------------------------------------------SX------------------X-X---------------------------------------------------------
------------------XXXX--------XXXX----XXXX------------XXXX------------------------XXXX------------XXXXXXXX--------XXXX----XXXXXXXX----XXXX----XXXXXXXXXXXX
XXXXXXXXXXXXXX----XXXX----XXXXXXXXXXXXXXXXXXXXXXXXXXXXXXXXXXXX--------------------XXXX----XXXX----XXXXXXXXXXXX----XXXX----XXXXXXXX----XXXX----XXXXXXXXXXXX
XXXXXXXXXXXXXX----XXXXXXXXXXXXXXXXXXXXXXXXXXXXXXXXXXXXXXXXXXXXXXXXXXXXXXXX----XXXXXXXXXXXXXXXX----XXXXXXXXXXXXXXXXXXXX----XXXXXXXXXXXXXXXX----XXXXXXXXXXXX
