----------------------------------------------------------------------------------------------------------------------------------------------------------
----------------------------------------------------------------------------------------------------------------------------------------------------------
----------------------------------------------------------------------------------------------------------------------------------------------------------
----------------------------------------------------------------------------------------------------------------------------------------------------------
----------------------------------------oo----------------------------------------------------o-----------------------------------------------------------
---------------------------------------o----------o------------------------------------o-o--o-----o-------o-----------------o---oo------------------------
--------oo-o-------ooo-o------oo--o---o----o----o--oo-------------------------------o---------------oo--o----o----------------o---------------------------
-------o--?S????S-----------oo-------------S---o-o?X??-------oo---oo--o---------o-----S-??o---??---o----------oo-----oooo-o-------------------------------
----------------------o---------?-------------S-----------ooo--------o-----------------------------------S-??-------X------?X???X-o-----------------------
------?X-X------------SS-?-o------?-----------------------S---------o--????----o----??--------------------------------------------XSS??----o--------------
----------------------------??------------------------?S-----------S------------------------------------------X??S----------------------------------------
----------XXXXXXXXXXXX----------------XXXXXXXX----XXXX--------------------------------XXXX----XXXX--------------------------------------------XXXXXXXXXXXX
----------XXXXXXXXXXXX--------XXXX----XXXXXXXXXXXXXXXX--------------------------------XXXXXXXXXXXXXXXXXXXXXXXX----XXXX----XXXXXXXX------------XXXXXXXXXXXX
XXXXXXXXXXXXXXXXXXXXXXXXXX----XXXXXXXXXXXXXXXXXXXXXXXX----XXXX--------XXXXXXXX----XXXXXXXXXXXXXXXXXXXXXXXXXXXX----XXXXXXXXXXXXXXXXXXXXXXXX----XXXXXXXXXXXX
