----------------------------------------------------------------------------------------------------------------------------------------------------------
----------------------------------------------------------------------------------------------------------------------------------------------------------
----------------------------------------------------------------------------------------------------------------------------------------------------------
----------------------------------------------------------------------------------------------------------------------------------------------------------
-----------o-----------o---------------------------o----------o-------------------------------------------------------------------------------------------
------------------------------------------------o-o--------ooo--o------------------------------------o--------o---------oo--------oo----------------------
---------oo-o----o----------oo---------------oo--o----o----------------o----o---o--o-----o----------o------------------o------------oo----oo--------------
-----------XX------oo-------------------o-o-o---S-S?X?---o---??-X---o-o--------o-----?----o--------o--o-------?X??-----------------?----------------------
--------o------?X-o--o--------oo--o---oo-o----------------------------?--X--X--------------------------------o-------------S??---------o------------------
-------???-----------------???-SS-?---X------------------------------o----------------?S?XS-??SS-------o-o--o------------------o-o------oo----------------
------------------------------------------------------------------S-XX-------------------------------------X?-----X?SS--------X?-S------------------------
----------XXXX--------XXXX--------------------XXXXXXXX----XXXXXXXX----------------XXXX------------------------XXXX----XXXX--------XXXX--------------------
----------XXXXXXXX----XXXX----------------XXXXXXXXXXXX----XXXXXXXX----XXXXXXXXXXXXXXXX------------XXXX--------XXXX----XXXXXXXX----XXXX----XXXX----XXXXXXXX
XXXXXXXXXXXXXXXXXX----XXXXXXXXXXXXXXXXXXXXXXXXXXXXXXXXXXXXXXXXXXXX----XXXXXXXXXXXXXXXXXXXXXXXXXXXXXXXX--------XXXX----XXXXXXXX----XXXX----XXXX----XXXXXXXX
