----------------------------------------------------------------------------------------------------------------------------------------------------------
----------------------------------------------------------------------------------------------------------------------------------------------------------
----------------------------------------------------------------------------------------------------------------------------------------------------------
----------------------------------------------------------------------------------------------------------------------------------------------------------
----------o-------------------------------------------------------------------oo--------------------------------------------------------------------------
-------------------------------o---------------o---------o----------------------o-o--------o---------o---------------o-o---------o------------------------
---------------------o-------o-------------------o---------------------------o------------o---------o-o-----------------o---------o----o------------------
----------SXX--------------oo-o----------o---S--XXoo--X---------o----oo-------------------SX-S----oo------o--o-----------o-----o---o------oo--------------
--------o----------oo-----------?-----oo----------SS?X--------------o--o-o----------?X-------------------?--o-o----------S-----S-??-??--------------------
---------o----o---------XS--??----?-??--o------------------oo--S-------SX----------------o---------------------o-----------S-X---------S?-----------------
-------XX---------------------------------------------------------??-S----------------SSS?-----S?----------SS?X-S-----------------------------------------
XXXXXX----XXXX----------------------------XXXXXXXX----XXXX--------------------XXXX--------XXXX------------------------------------------------------------
XXXXXX----XXXX----------------XXXX--------XXXXXXXXXXXXXXXX----------------XXXXXXXXXXXX----XXXX----XXXXXXXX--------XXXXXXXX----XXXXXXXX--------------------
XXXXXX----XXXX----XXXXXXXXXXXXXXXXXXXX----XXXXXXXXXXXXXXXX----XXXX----XXXXXXXXXXXXXXXX----XXXX----XXXXXXXX--------XXXXXXXXXXXXXXXXXXXXXXXXXXXXXXXXXXXXXXXX
