----------------------------------------------------------------------------------------------------------------------------------------------------------
----------------------------------------------------------------------------------------------------------------------------------------------------------
----------------------------------------------------------------------------------------------------------------------------------------------------------
----------------------------------------------------------------------------------------------------------------------------------------------------------
----------o---------------------------o--o------o-----------------------------------------o-o----------------o---------------------o----------------------
----------------------------------------o--------o----------------------o----------------o-----------------------o----------------o-o---------------------
-------------------o--o----------------o-------o--o-o-----------------oo------------------------o--o----------o----------------------o-o--o---------------
------o-ooS?--------oo-------oo-----o--------o?SS--o-------oo-o-----------SS?---o-o-------X-SX-o--o-------S-XS-o--oo-o-----------oX-X?o----o--------------
---------------------?-o----------o--------o--------------------?----o?X-?--------X-??X-??----------o----?----?-?X----o-o-----?S??-------o----------------
------SX-S-------------X-?-oo--o----X--------------?SS----X-------o-o---------oo---------------------------------------o---------------SS-----------------
--------------------------?--?X-??---------------------------------??X---------------------------------------------S--------------------------------------
----------XXXX------------------------XXXX----XXXX----XXXX----------------XXXX------------XXXX------------XXXX------------XXXX----XXXX--------XXXXXXXXXXXX
----------XXXXXXXXXXXX----------------XXXX----XXXX----XXXX----XXXX----XXXXXXXX----XXXXXXXXXXXX--------XXXXXXXXXXXX--------XXXXXXXXXXXX----XXXXXXXXXXXXXXXX
XXXXXXXXXXXXXXXXXXXXXXXXXX--------XXXXXXXXXXXXXXXXXXXXXXXXXXXXXXXX----XXXXXXXX----XXXXXXXXXXXXXXXXXXXXXXXXXXXXXXXX--------XXXXXXXXXXXXXXXXXXXXXXXXXXXXXXXX
