----------------------------------------------------------------------------------------------------------------------------------------------------------
----------------------------------------------------------------------------------------------------------------------------------------------------------
----------------------------------------------------------------------------------------------------------------------------------------------------------
----------------------------------------------------------------------------------------------------------------------------------------------------------
--------------------------------------o-o-------------------o--------------------------oo-------------------------------------------------o---------------
----------o------o-----------o---------o-o----------------oo-----------------------------o----o------------o---------o------------------------------------
-----------o-o----------------o--o---------------------------o-----------------------------------o-----------o-o--o-------------ooo------o-o--------------
--------------?X?-o-o-------o-------------------o---------------------o---------------SSS-o---S----ooo----S?S-o---?X?--o-o----o-----o---------------------
---------o-?X--------o-----SXX-o----S------------o-o-------------------oo----oo-------------------o------S----??S?----o-o----?-----o----------------------
-------------------o-----------???----------------o---o-------------ooS?SX-----ooo---------o------X------------------------------XS-SX--------------------
--------?----------------------------------------S?X?SS?-X------------------S?---S?X-X-----?S-------------------------------------------------------------
--------------XXXX--------------------XXXX----------------XXXXXXXX--------------------XXXX----XXXX--------XXXX----XXXX----------------XXXXXXXX----XXXXXXXX
XXXXXX----XXXXXXXX--------XXXX----XXXXXXXXXXXX------------XXXXXXXX--------------------XXXX----XXXX----XXXXXXXXXXXXXXXX----XXXX--------XXXXXXXX----XXXXXXXX
XXXXXX----XXXXXXXX--------XXXXXXXXXXXXXXXXXXXX------------XXXXXXXX----XXXX------------XXXX----XXXXXXXXXXXXXXXXXXXXXXXX----XXXXXXXXXXXXXXXXXXXX----XXXXXXXX
