----------------------------------------------------------------------------------------------------------------------------------------------------------
----------------------------------------------------------------------------------------------------------------------------------------------------------
----------------------------------------------------------------------------------------------------------------------------------------------------------
----------------------------------------------------------------------------------------------------------------------------------------------------------
---------------------------------------------------o------------o--oo------------------------------oo-----------------------------------------------------
----------o--o------o-----------o-----------------o----o-------------o-----o------------------------------------------------------o-----------------------
----------------------------------------------------o---------o---------o-o----------o----o--------------o----o-----------------o---o---------------------
-----------o-----o-o-----?---ooo-----oo-o-------o-S??S------o---??-S-S-o----o-----o----o-o-------------X??---o-o-------o---------o------------------------
--------oo???-------?-----????XS?--o-----o----o--o---------o----------o-----?-oo----??--o---------------------?-??o---o-ooS--?-------------o--------------
---------------------------------------o--o---------------o--o---------?S?------oo----SSS-?XSX??----------??XX----S?S---------?-??------------------------
------?--?------------------------?S-------?SXXX?X----------------------------?---------------------------------------------------------------------------
----------------------XXXX------------------------XXXX--------XXXXXXXX----------------------------XXXXXXXX------------------------XXXXXXXX----XXXXXXXXXXXX
XXXXXX----XXXX----XXXXXXXXXXXXXXXX----------------XXXXXXXX----XXXXXXXX----XXXX----XXXX------------XXXXXXXX----XXXX--------XXXX----XXXXXXXX----XXXXXXXXXXXX
XXXXXX----XXXX----XXXXXXXXXXXXXXXX----------------XXXXXXXX----XXXXXXXXXXXXXXXX----XXXXXXXXXXXXXXXXXXXXXXXXXXXXXXXXXXXXXXXXXXXXXXXXXXXXXXXXXXXXXXXXXXXXXXXX
