----------------------------------------------------------------------------------------------------------------------------------------------------------
----------------------------------------------------------------------------------------------------------------------------------------------------------
----------------------------------------------------------------------------------------------------------------------------------------------------------
----------------------------------------------------------------------------------------------------------------------------------------------------------
----------oo--o----------------------------------------------------------------------------------------------o---o----------------------------------------
---------o---o------------------------------------------------------------------oo--------o----------------oo--o--------------------------oo--------------
--------o--------o--------------------o---------ooo-----------oo------o--o-----o---o--------------------------o-----------------oo------------------------
------X??????X??------o----o-o-----X-------------------?-----o------o--o------o----------o-----------o-X-X?-XX?---?-----o------o--oo----------------------
------------------ooo-?--?-----o-------oo--o----?S-X?X-----oo--X-?o-----o-----------------?-S------oo------------------o---o----------SX------------------
---------------------o--------o-------S----------------------------o--SX-?--o-----------o-----------------------------o------?-SXS------------------------
--------------------------S?XS?--?---------?-?---------------------?S?----S-----------SS?-------------------------------?----------?-?--------------------
XXXXXXXXXXXXXXXXXX----------------XXXX----------------XXXX------------------------XXXX----------------XXXXXXXXXXXXXXXX------------------------------------
XXXXXXXXXXXXXXXXXX----XXXX--------XXXX--------XXXXXXXXXXXX----XXXX------------XXXXXXXX----XXXX--------XXXXXXXXXXXXXXXX----------------XXXXXXXX------------
XXXXXXXXXXXXXXXXXX----XXXX--------XXXXXXXX----XXXXXXXXXXXX----XXXX----XXXX----XXXXXXXX----XXXXXXXXXXXXXXXXXXXXXXXXXXXX----XXXXXXXX----XXXXXXXXXXXXXXXXXXXX
