----------------------------------------------------------------------------------------------------------------------------------------------------------
----------------------------------------------------------------------------------------------------------------------------------------------------------
----------------------------------------------------------------------------------------------------------------------------------------------------------
----------------------------------------------------------------------------------------------------------------------------------------------------------
-------o-----------------------------------------o---------oo-----------------------------oo--------------------------------------------------------------
---------o--oo-----------------------------o--o-o---------o---------oo--------o-o------------o-------------------------oo---------------------------------
----------o------o------------o--------o--o-o--------------------------------o-o-o---------------o-----------oo----------o-----------o----oo--------------
--------?---?SS?S------SX?---oXXSX---------?---X-X--o---o-?---o---------o-o--------o-----oS-SS------o-------o-------?----------o--------------------------
-------------------o------SS?S-----------o--------o---o-----------S-X--o-------------?-oo----------o-oo---S?XX------------------oooo----------------------
--------------------o------------------------------------------X------o---------------------------o-----o-----?X-?-----------------SX?--------------------
-----------------------------------?S-------------?XSX?S--------------?SS--------------X?S--------------?S---------------------X-S----S??-----------------
XXXXXXXXXXXXXXXXXX----XXXX----XXXX--------XXXXXXXX--------XXXX----------------XXXX--------XXXX--------------------XXXX------------------------------------
XXXXXXXXXXXXXXXXXX----XXXXXXXXXXXX--------XXXXXXXX--------XXXX----XXXX----XXXXXXXXXXXX----XXXX------------XXXX----XXXXXXXX----------------XXXX----XXXXXXXX
XXXXXXXXXXXXXXXXXX----XXXXXXXXXXXX----XXXXXXXXXXXX--------XXXXXXXXXXXX----XXXXXXXXXXXX----XXXXXXXX--------XXXXXXXXXXXXXXXX--------XXXX----XXXX----XXXXXXXX
