----------------------------------------------------------------------------------------------------------------------------------------------------------
----------------------------------------------------------------------------------------------------------------------------------------------------------
----------------------------------------------------------------------------------------------------------------------------------------------------------
----------------------------------------------------------------------------------------------------------------------------------------------------------
-------------------oo-------------------------------------------------o----------------o-o-----o------------------------oo-------o------------------------
-----------------o---------------o--o--o-o--------o--o-----------------------------o--------------o-o------------------o-------o--------------------------
--------o---------------------o------oo-o----------------------------------------------------------o-o-------oo-----------o---o---------------------------
----------o-o-S-?-------------SX??----------o----o--o-?S-----o------o-?-?S-----o-o---o?XXS---o----------o--o-------------------X??o--o----o---------------
---------o??X?---------------o------X?--------?-X?X??-----oo---S??-----------------?X-----o---------------????----??-?-------------oo----o-o--------------
-------?X?-----------------S??------------------------------o-----XSS?----------o-----------o----------o------SS?X-----------?-----?--S-------------------
------------------------?X-------------------S----------------------------?-?-------------??-?------------------------------------------------------------
--------------XXXXXXXX--------XXXX----XXXX------------XXXX------------XXXX------------XXXX----XXXX--------------------XXXX----XXXX------------------------
----------XXXXXXXXXXXX--------XXXXXXXXXXXX----XXXXXXXXXXXX----XXXX----XXXX--------XXXXXXXX----XXXXXXXX----XXXX----XXXXXXXX----XXXX------------------------
XXXXXXXXXXXXXXXXXXXXXX----XXXXXXXXXXXXXXXX----XXXXXXXXXXXX----XXXXXXXXXXXX--------XXXXXXXX----XXXXXXXX----XXXXXXXXXXXXXXXXXXXXXXXXXXXXXXXXXXXX----XXXXXXXX
