----------------------------------------------------------------------------------------------------------------------------------------------------------
----------------------------------------------------------------------------------------------------------------------------------------------------------
----------------------------------------------------------------------------------------------------------------------------------------------------------
----------------------------------------------------------------------------------------------------------------------------------------------------------
----------------------------oo----o-----o---------------------------------o---------------oo------o-------------------------------------------------------
-------------o----------------------------------------------------o--o----------o-------------------o--------------------------oooo-----------------------
----------o--------------o-----------o-o----------------------------o---o---o-oo---------o---o-----o---------o-------oooo-o--------o----------------------
--------o----------o-o----?--?o---XS----------------------------o-X?-S----S??XX---o-----o-?-SX-------------X??--o-------------??XX----S-------------------
---------oSSS?XSX-o------------o-----------------ooo--o---ooo-o--o----o-----------X------------o---------------------------oo------???----oo--------------
--------------------o----------??-----------XS-S-?--------------------?X??-------------XSS----XS-?------------o---X?--------------------------------------
------XX?-----------------------------------------?-XXSSS-----------------------------------------------X?----?XS?----------------------------------------
--------------------------XXXX----XXXXXXXX------------------------XXXX----XXXXXXXX--------XXXX----XXXX----XXXX----------------XXXX----XXXX----XXXXXXXXXXXX
XXXXXX----XXXXXXXX----XXXXXXXX----XXXXXXXX------------------------XXXX----XXXXXXXXXXXX----XXXX----XXXX----XXXX--------XXXX----XXXXXXXXXXXX----XXXXXXXXXXXX
XXXXXX----XXXXXXXX----XXXXXXXXXXXXXXXXXXXXXXXXXXXX--------XXXX----XXXXXXXXXXXXXXXXXXXXXXXXXXXXXXXXXXXX----XXXX----XXXXXXXXXXXXXXXXXXXXXXXX----XXXXXXXXXXXX
