----------------------------------------------------------------------------------------------------------------------------------------------------------
----------------------------------------------------------------------------------------------------------------------------------------------------------
----------------------------------------------------------------------------------------------------------------------------------------------------------
----------------------------------------------------------------------------------------------------------------------------------------------------------
--------------------o--o-o--o-------------------o--------------------ooo-----------------o------------------------o--------------o------------------------
------------------o---o-----------o-------o----------o------o-o-----o-----------o--------------o-oo-oo-----ooo---------oo---------------------------------
-------------------o-o----oo-o-o---o--ooo--------oo-----o------o---o----o----ooo----------o--o----------------oo-----o-----------------o------------------
----------oo---o-----??--???-------------o----XXX?-o------oo-o-----S?SX-SX------------?-??-oo------o------o-------?-?---------?-??---------o--------------
---------oXX???---------------o-o----------X-?----?S---?X--?------------------------------XX-SS-------o---???X???X----------------o-------o---------------
------------------------------??XX----------------------------------------S?S--------------------------o----------------------------o---------------------
------SSX-----------------------------------------------------------------------------------------------X--------------------------?----------------------
------------------XXXXXXXXXXXX----XXXX--------XXXX----------------XXXXXXXX------------XXXX------------------------XXXXXXXX----XXXX------------XXXXXXXXXXXX
XXXXXX----XXXXXXXXXXXXXXXXXXXX----XXXX----XXXXXXXXXXXXXXXXXXXXXXXXXXXXXXXX----XXXX----XXXXXXXXXXXXXXXX----XXXXXXXXXXXXXXXXXXXXXXXX------------XXXXXXXXXXXX
XXXXXX----XXXXXXXXXXXXXXXXXXXXXXXXXXXXXXXXXXXXXXXXXXXXXXXXXXXXXXXXXXXXXXXXXXXXXXXX----XXXXXXXXXXXXXXXX----XXXXXXXXXXXXXXXXXXXXXXXX----XXXXXXXXXXXXXXXXXXXX
