----------------------------------------------------------------------------------------------------------------------------------------------------------
----------------------------------------------------------------------------------------------------------------------------------------------------------
----------------------------------------------------------------------------------------------------------------------------------------------------------
----------------------------------------------------------------------------------------------------------------------------------------------------------
-------------------------------o-o--------------------------o----------------------------o------------------------------------o--ooo----------------------
--------------------oo-------o----------------oo-o-----------oo------o------------------o--------o--------------------------------------------------------
----------oo-------o--------o-o-----o----------------------o-------------------o------o----o--------o-------o------o---------------------o----------------
--------o------------------o---?X?---------o------o----------------oo-o----------------X-?o--------o-o-------oo--------o----o-?XXS-X----------------------
----------??S----o----oo--?-??---------o------X?S??S?X-------------???--o--o--o-oo--------?X?S?S------S?-?-X---------------?SX--------?-------------------
------XXX-------------------------?X?-o-o-o------------?--------------X?-???------------------------X----------o------o-oo-----------------o--------------
-------------------------?----------------??XS----------------------------------------------------------------S??--------?--------------------------------
------------------XXXX--------XXXX------------------------XXXX--------------------XXXXXXXX------------------------------------XXXXXXXX--------------------
----------XXXX----XXXX----XXXXXXXX------------XXXXXXXX----XXXXXXXXXXXX------------XXXXXXXXXXXXXXXX----XXXXXXXX------------XXXXXXXXXXXXXXXX--------XXXXXXXX
XXXXXXXXXXXXXX----XXXX----XXXXXXXXXXXX--------XXXXXXXXXXXXXXXXXXXXXXXXXXXXXXXXXXXXXXXXXXXXXXXXXXXXXXXXXXXXXXXX----XXXX----XXXXXXXXXXXXXXXX--------XXXXXXXX
