----------------------------------------------------------------------------------------------------------------------------------------------------------
----------------------------------------------------------------------------------------------------------------------------------------------------------
----------------------------------------------------------------------------------------------------------------------------------------------------------
----------------------------------------------------------------------------------------------------------------------------------------------------------
------------------------------------------------------------o---------------------------------------o------------------------------o----------------------
----------o-o-----------------oo---------------------------o-----------o--------------------o-----o------------------------------oo-----------------------
--------oo-o----o--------------------o-----------------o--o---------ooo-o-----------------o--------o-o----------------o--o----o---------------------------
-----------?SXX---oo----?----o-----------o---o------o---X-----o---???X-------o-oo--------o-o--?--------------o----------o----?-----?S------o--------------
---------------------------o--??-S--------------oooo-----------o------?-X-----o---S?-X?S?X????-------------o--o---?X---o------XS?---------o---------------
------??XX----------oo------------?XS--oo-X?-S-?-X--------------S---------?---------------------------?S?S-----o-o----------------------------------------
---------------------------S----------------------?X?-----------------------------------------------------X?XS?-------------------------------------------
----------XXXXXXXX----XXXX----------------------------XXXXXXXX----XXXX------------------------XXXXXXXX--------------------XXXX----XXXX--------------------
----------XXXXXXXX----XXXX----XXXX--------------------XXXXXXXX----XXXXXXXX--------XXXXXXXXXXXXXXXXXXXX------------XXXX----XXXXXXXXXXXX--------------------
XXXXXXXXXXXXXXXXXX----XXXX----XXXXXXXX----XXXXXXXX----XXXXXXXXXXXXXXXXXXXXXXXXXXXXXXXXXXXXXXXXXXXXXXXXXXXX--------XXXXXXXXXXXXXXXXXXXX----XXXX----XXXXXXXX
