--------------------------------------------------------------------------------------------------------------------------------------------
--------------------------------------------------------------------------------------------------------------------------------------------
--------------------------------------------------------------------------------------------------------------------------------------------
--------------------------------------------------------------------------------------------------------------------------------------------
---------------------------------------------------EE-EE----X-------XXXXX-------------------------------------------------------------------
-------------------------------?-XSX-----SXSX----XXXSXXX------------------------------------S-----SSSSSS--------SSS-----------------S-------
--------------------------------------------------------------------------------------------------------------------------------------------
-------------------------------------------------------------------------------------X--------------------------------------------------XXX-
---------------------------------------XX---------------------------------------------------------------------------------SXSX--------------
----------E-----------------XXXX---------------------------SX--------------------XXXX--------------QSS----------XQQQQQQ---------------------
---------<>---------------------------------------------------------------------XXXX----------------SS--------------------------------------
---------[]---------<>---------------------------------------------------------XXXXX------SS--------------------------------------------XXXX
---EE-E--[]---------XEE------------------------------SS--EE-E------E-E-------EXXXXXX-----SS-----E------------------------------E------------
XXXXXXXXXXXXXXXXXXXXXXXXXXXXXXX---XX--------------------XXXXXXXXXXXXXXXXXXXXXXXXXXXXXXXXXXXXXXXXXXXXXXXXXXXXXXXXXXXXXXXXX-XX-XX-------------