--------------------------------------------------------------------------------------------------------------------------------------------
--------------------------------------------------------------------------------------------------------------------------------------------
--------------------------------------------------------------------------------------------------------------------------------------------
-----------------------------------------------------------------------------------------------------------------XXX-XXX--------------------
---------------------------------------------------------------------------------------------------------------------X----------------------
--------------------S------------------------SSS-------S---------------------------------------------SSS---------E--------------------------
----XXX---------------------------------------------------------------------------------------------------------XXXXXXX---------------------
-----------------------------------------------------------------------X--------------------------------------------------------------------
----------------------------------------------------------------------XX--------------------------------------------------------------------
-----------XXXXX--------XXXX---------SX-------QQ-SSS--E----X------------------------X-----<>--------EQQQQQS---<>-----------XXXXX--------XXXX
-----------------------XX----------------------------<>-----------X-X---------------X-X---[]-----------------?[]---------E-------------XXXXX
-----------------------X-----------------------------[]---XX-----XXXXX--------------XS----[]------------------[]--------XX-----------XXXX---
----------------------XX----EE--------------E-E------[]---SX-----X----------EE-----EXSX---[]-----------------o[]---------------------XXXXXXX
X---X-----------------------XXXXXXXXXXXXXXXXXXXXXXXXXXXX--------XX------------XXXXXXXXXXXXXXXXXX-XXXXXXXXXXXXXXXX--XXXXXX--------XXXXXXXXXXX