--------------------------------------------------------------------------------------------------------------------------------------------
--------------------------------------------------------------------------------------------------------------------------------------------
--------------------------------------------------------SS---SSSSSSSSSSSSSSSSSSSSSSS--------------------------------------------------------
--------------------------------------------------------------------------------------------------------------------------------------------
---------------------------------------------------------------------S-S-------------------------------X------------------------------------
---SSSS------SQS----------------------------SS------------------------SSS--------------------SSSSSS-----------------------------------------
------------------------------------------------------------------------------SX------------------------------------------------------------
---------------------------------------------------------XXXX-------------------------------------------------------------------------------
---------------------------------------------------------------------SX---------------------------------------S-----------------------------
---------------------------E---------SX---------------E----------SS-S------------------QQ----S?S-SSSSSQ-------------------------Q-QQQQQ-----
<>-------------E---E------<>-------------------------<>------------S--------E-X-X--X--------------------------------------------------------
------------------<>------[]-------------------------[]--------------------XX-XXXX-X------------------------XXX-----------------------------
------------------[]------[]EE--------------E-E------[]----------ES-<>-----XX-X-XXXXXE------------EE-E--E--XX---E-EE--<>--E-----------------
XXXXXXXXX------XXXXXXXXXXXXXXX-XXXX--X---XXXXXXXXXXXXXXXXXXXXXXXXXXXXXXXXXXXXXXXXXXXXX-XXX----XXXXXXXXXXXXXXXXXXXXXXXXXXXXXXXXXXXXXXXXXXXXXX