--------------------------------------------------------------------------------------------------------------------------------------------
--------------------------------------------------------------------------------------------------------------------------------------------
-------------------------------------------------------------------------------------------------------------------------SSSSSSSSSSSSS-SSSSS
--------------------------------------------------------------------------------------------------------------------------SSSSSSSSSSS-------
------------------------------------------------------------------------------------------------------------------------SSSSSSSSSSSS--------
---------------------------S-----------------?SS--------------------------------------------S---------------------------SSSSSSSSSSSS--------
------------------------------------------------------------------------------------------------------------------SS------------------------
-------------------------------------------------------------------------------------XXXXX--------------------------------------------------
-------------------------------------------------------------------------------------------------SX-X-----------?---------?----------?-E-XXX
-E---------------------S----------<>---S----QQQQQSS----------------------------XX--X----------------------------------<>--??SS-SSSS------XX-
<>-----------------E--------------[]------------------E----------<>---------XXXXXXXX------------------------E------EE-[]----S-S-SS-------XX-
------------------<>--------------[]-----------------------------[]--------XXXXXXXX--------------------<>-------------[]---SSSS----------XXX
EE--------------E-EE------E-E-E---[]-----------------<>-----E----[]-------XXXXXXXXXX------------E------------X-XX--E--[]------S-----E-E--XX-
XXXXXXXXXXXXXXXXXXXXXXXXXXXXXXXXXX----XXXXXXXXXXXXXXXXXXXXXXXXXXXXXXXXXXXXXXXXXX----XXXXXXXXXX--XXXXXXXXXXXXXXXX---XXX-XXXXXXXXXXXXXXXXXXXXX