--------------------------------------------------------------------------------------------------------------------------------------------
--------------------------------------------------------------------------------------------------------------------------------------------
--------------------------------------------------------------------------------------------------------------------------------------------
--------------------------------------------------------------------------------------------------------------------------------------------
--------E------------------E----------------------------------------------------------------------------------------------------------------
-SSSSSS----------X------S-S-S--S---X------------------X-------------------------------------------------------------------------------------
ESSS-------E--XXXX--------------------------------------------------------------------------------------------------------------------------
--S------------X-X--------------------------------------------------------------------------------------------------------------------------
X-S-----------XXXXX---------X-X-------SSSXSX------------------------------------------------------------------------------------------------
--XX-X-----------------------XXX-----------------XXXX--------QQ-------------------------------E------------------------------------SS-------
---------XXXXX----------------------------------------------------------------------------E--XX-------------E-----------------------------E-
-XSX------X--------------------------------------------X-------------------------S-----------XX---------------------------------------------
-XSX-----X---------------E-S---------------------------X---------------E--E-----E------------XX---------EE-----X----------------------------
---------------------------X---------------------------XXXXXXXXX-XXXXXXXXXX-XXXXXXXXXXXX-XXXXX-----XXXXXXXXXXXXXXXX--XXXXX------XXXXXXXXXXXX