--------------------------------------------------------------------------------------------------------------------------------------------
---------------------------E----------------------------------------------------------------------------------------------------------------
----XSXSXS----SSSS--------<>--SXSX--------------------------XSXSXS----SSSS---------E--------------------------------------------------------
---------S---SSSSS--------[]------------------------------------------------------<>--------------------------------------------------------
S--------S---SSS----------[]----------SXSXSXSXSX---------------------S------------[]--------------------------------------------------------
------------SSSS-----XXXXXXX-------S----SX------------------------------------EXXX-X--------------------------------------------------------
-------------------------------------------S------------------------------------------------------------------------------------------------
------------------------------------------XS----------------------------------------------------------------------XXXX----------------------
SSS------SSSSSSSSS--------------E-------E----------XXX--SSS------SSSSSSSXS----------------------------------------------------X-------------
----------SSS---SS--------SS---<>------------------X------------------------------SS------------------------------XX-----X------------------
-----------------------------E-[]--------E--------XX-----------------------------------------E------------------------E--X-XX-------E-------
-------------------------------[]------SS---------XXXX--------------------------------------<>-------------------XXX-----XXXXX------E-------
-------------------------------[]---SE-------E-EX-XXX----------------------------------EE---[]-------E----E------XXX-----XX-X-------oE------
XXXXXX-XXXXXXXXXXXXX--------XXXXXXXXXXXXXXXXXXXXXXXXXXXXXXXXXX--XXXXXXXXXXXX--------XXXXXXXXXXXXXX-XXXXXXXXXXXXXXXXXXXXXXXXXXXXXXXXXXXXXXXXX