--------------------------------------------------------------------------------------------------------------------------------------------
---------------------------------------------------------------------------------------------------------------E----------------------------
------------------------------------------------------------------------------------SSSSSSSSSSSSSSSSSSSSS-----<>----------------------------
---------------------------------------------------------------------------------------------SSS-SSS---S---XXX[]-XXXXXXX--------------------
--------------------------------------------------------------------------------------------SSSS-SSSSSSS------------------------------------
--------SSSSSSSSSSSS------------------------------SXX--------------------------------------------S-----E--SXX--X----------------------------
---------------------------------------------------------------------------------------------------S----XXSX----XXXX------------------------
----------------------------------------------------X--------------------------------------------SS---------XX------------------------------
--------------------------E------------------------XX----------------------------------------S-X-SSSS------XXX------------------------------
X--------SXS-SSSSSS------<>--SSSSS-----XXXX-----------XX---------------------------X-QQQ------SS-SXS------XXXXS-----------------------------
-------------------------[]-----------------------XX-----------------------------XXX-----------E----------XX-------------Eb-----------------
X------------------------[]------------------------X-----------------------------XXX--------------------X-XXX--X--------<>----------XX------
E--------------EE-E------[]------------------E----XX-------------------E--------XXXX-----------S-----XXXX-XXX------EE-E-[]----------XXX-----
X---XX-------XXXXXXXXXXXXXXXXXXXXXXXXXXXX---X-----------XXXXXXXXXXXXXXXXXXXXXXXXXXXXXXXXXXXXXXXXXXXXXXXX-X------XXXXXXXXXXXXXXXXXXXXXXXX----