--------------------------------------------------------------------------------------------------------------------------------------------
--------------------------------------------------------------------------------------------------------------------------------------------
----------------------------SSSSSSSSSSSSSSSSSSSSSSSSSSSS------------------------------------------------------------------------------------
----------------------------------SSSSSSSSSSSSSS--------------------------------------------------------------------------------------------
-----------------------------------SSSSSSSSSSSSS--------------------------------------------------------------------------------------------
-------------------------------S-----SSSSSSSSS-----X----------------------Q-----------------------?------------S------------------------SXS-
-----------------------------------------------------------------------------------------------------------SXS------------------------------
-----------------------------------------------------------------------------------X--------------------------------------------------------
---------------------------------------------------XXXSX----------------------------------------------S-------------------------------------
-------------------------------------SS-SSSSSS--X-X--SSS----E-<>---E----QQQQQQQ------E-------XX------------S--------------------------------
---------------------------------------SSSS----XX-X-----E--<>-[]-----------------<>-<>------------XX---E------------------------------------
----------------------------------------SSS----XX-XX-------[]-[]-----------------[]-------------------<>------------------------------------
--------------------------E----E--E--ESSSSS-XXXXX-X-----E-<>--[]-----------------[]--E----------------[]------E-----------------------------
XXXXXXXX----------X-X---XXXX--XXXXXXXXXXXXXXXXXX-XXXXXXXXXXXXXXXXXXXXXXXXXXXXXXXXXXXXXXXXXXXXXXXXXXXXXXXXXXXXXXXXXX-----XXXXX---------------