--------------------------------------------------------------------------------------------------------------------------------------------
--------------------------------------------------------------------------------------------------------------------------------------------
-----------------------------------------------------------------------------S--------------------------------------------------------------
--------------------------------------------------------------------------------------------------------------------------------------------
--------------------------------------------------------------------------------------------------------------------------------------------
-------------------------------S--------------------------------?S----SSS--------------------------------------S-----------------X----------
----------------------------S------------------------------S-----------------------------------------------SX-------------------------------
---------------------------------------------------------XXXXX----------------------------------------------S-------------------------------
----------------------------XSX---------XXXXX------------------------SX-X-----------------------------------------------------XX------------
---------------------------X---------------------XXXX---------------S---------------XQ-------S---------SSSS---EQ----------------------------
--------------------------<>---------------------------X--------------------E---E--XX------------------------<>-----------------------------
--------------------------[]---------------------------X-------------------<>------X<>-----------------------[]E----------------------------
------------------------E-XX------------------------EXXX---S--------E------[]---XXXX[]--------------E-EE-----[]-----------------------------
------XX------------XXXXXXXXXXXXX---------XXXXXXXX--XXXX-----XXXXXXXXXXXXXXXXXX-XXXXXXXXXXXXXXXXXXXXXXXXXXXXXXXXXXXX-----------XXXXXX-XXXXXX