--------------------------------------------------------------------------------------------------------------------------------------------
--------------------------------------------------------------------------------------------------------------------------------------------
------------------------------------------------------------------------------------------------SSSSSSSSSSSSSSSS----------------------------
-----------------------------XXXXX------------------------XXX---------------------------------SSSSSSSSSSS-----------------------------------
----------------------------------------------------------------------------------------------SSSSSSSSSS------------------------------------
--------------------------------------------------------------------------------------------SSSSSSSSSSSS-------XSSS--------SX-------SXXXXXX-
----------------------------XX--------------------------------------------------------------------------------------------------------------
--------------------------------------------------------------------------------------------------------------------------------------------
-SS------S-SSSSSS------------------------------------------------------------E------?---------?----------?----SX------------SX--------------
--------X-------------------------------------------------------------------X--X----------<>--??S--SSSS---Q--SSSXQQ-----------------------XX
-------------------------------------E---------------------<>-----E--------XXXXXXXXX---EE-[]----S-S-SS--------------------------------------
------------------------------------<>---------------------[]----<>---------XXXXXXX-------[]---SSSS----------SS-----------------------------
------------------------------------[]-----------XX--------[]----[]---------XXX--XX-X-----[]---------E--E-E---------------------------------
XXXXXX---XXXXXXXXXXX----XXXXXXXXXXXXXXXXXX--XXXXXXXXXXXXXXXXXXXXXXXXXXXXXXXXXXX--------XXX-XXXXXXXXXXXXXXXXXXXXXX---------------------------