--------------------------------------------------------------------------------------------------------------------------------------------
--------------------------------------------------------------------------------------------------------------------------------------------
----------------------------------------------------------SXS-------------------------------------------------------------------------------
--------------------------------------------------------------------------------------------------------------------------------------------
------------------------------------------------------------------SXSXSXSXSX------------------------------------------------SXSXSXSX--------
--------------------------------------------------------SQS----SSSS---------------------------------------------XQQ----S-SSSSX----Q---------
--------------------------------------------------------------------------------------------------------------------------------------------
----------------------------------------------------------------------SS---------X------XX--------------------------------------------------
---------------------E----------------------SX---------------------------------------------------XXX----------------E---------------------XX
------<>--------Q---<>----------------------------------SSSSXS------------------------XX------E----------X------?--<>-----------QQQ------XX-
--------------------[]----------------XXX---------------------------------------X---------E--<>---------X-------S--[]--------------------XX-
--<>--<>------------[]----------------XX--------------------------------------XXXXX---XX-----[]---------XX------S--[]------SS----------XXXX-
--XX--[]-EE-E-------[]---------------------------------------------E--EE-E-E--XXX-----X------[]---------XX-----XXE-[]---------EE-E--EEXXXXX-
XXXXXXXXXXXXXXXXXXXXXXXX----XXXXXXXXXXXXXX--XXX---XXXXXXXXXXXXXXXXXXXXXXXXXXXXXXX-----XX-XXXXXX--XXXXXXXXXXXXXXXXX-XXXXXXXXXX-XXXXXXXXXXXXX-