--------------------------------------------------------------------------------------------------------------------------------------------
--------------------------------------------------------------------------------------------------------------------------------------------
--------------------------------------------------------------------------------------------------------------------------------------------
---------------------------------------------------------X----------------------------------------------------------------------------------
-------------------------------------------------------------------------------------------------------------E------------------------------
-----------------------------S----------------EX------------------------------------SSS?-------SXSX---------S-S-----------------------------
---------------------------------------------XXXXX---------------------------------------------------XX-------------------------------------
-----------------------------------------------------------------------------------------------------X--------------------------------------
------------------------------------------------------------E-------E------------------------------------------S----------------------------
-------------------SSS----<>-----------XXXX--------XXXX----<>------------------X-XX---------------------------------------------------------
-------------------------o[]---------------------X--X------[]------------------XXXX---------------------------------------------------------
--------------------------[]-------------------------------[]----<>-----------XXXXX---------------------------------------------------------
E-EE------E---------------[]-------------------------------[]---<>----------XXXXXXX---------------------------SS----------------------------
XXXXXXXXXXX--XXXXXXXXXXXXXXX----------------------------XXXXXXXXXXXXXXXXXXXXXXXX-----------------------------XXXX-----XXX---------------XXXX