--------------------------------------------------------------------------------------------------------------------------------------------
--------------------------------------------------------------------------------------------------------------------------------------------
--------------------------------------------------------------------------------------------------------------------------------------------
--------------------------------------------------------------------------------------------------------------------------------------------
XXXXXXX-----XXXSX-----------------------------------------------------XXXXXX----------------------------------------------------------------
----------------------------------------SSSSS-----------SSS----------------XXXSX------------------SSSSSS------------------------------------
-------XX-----------------------------------------------------------------------------------------------------------------------------------
----------------------------------------------------------------E--------------------E------------------------------------------------------
----------------------------SS-------SSSSS--------------------------------------------------------------------------------------------------
--------------------------E-X-----XXXX---SS-------------SSSSSSSS--------------------X--------------SSSS---Q---------------------------------
---------------------------------------------------------S----------------------------------------------------------------------------------
--------X--------------------------------------------XXX-o---------------------XXSX-------SS------------------------------------------------
------------------------E------------------E-----------------------E-E-E-E-----XX---X-----S-------------------------------------------------
XXXXXXXXX----XXXXXXXXXXXXXXXXXXXXXXXXXXXXXXXXXXXX---XXX-XXXXXXXXXXXXXXXXXX-X--------XXX-XXXXXXXX---XXXXXXXXXXXXX--------------------XXXXXXXX