--------------------------------------------------------------------------------------------------------------------------------------------
--------------------------------------------------------------------------------------------------------------------------------------------
----------------------------------------------------------------------------------------------------------------SSSSSSSSSSSSSSSSSSSS-----SSS
--------------------------------------------------------------------------------------------------------------S---------SSSSSSSS-----------X
-----------------SX------------------------------------------------------------------------------------------E-E--------SSSS-SSSS-----------
SSS-----------------X--------------------------------------------------SX-----------SSS?--------XSX---------SSSS---------S---SSS-----------X
-----------------------------------------------------------------------------------------------------X--------------------------------SX----
-----------------------------------------------------------------------------------------------------X-----------XX---------------------XXX-
-------------------------------------S-SSSSSS------------------------------------------------------------------S-------------SXSS------XXXX-
SSS-S?SS-----------------------------------------------------------------------------------------------------XX----------SSSS--------XXXXX-X
------------------------------------------------------XX-----------------------------------------XX?-----------------------S--------X-XXXXXX
------------------------XSX--------------------------XXX---------------------------------------------------------------------------XXXXXXXXX
-------------E-E-------XX---------------------------XXXX------------------E----------------------------------------------ESS------XXX-XXXXXX
XXXXXXXX---XXXXXXXXXXXXXX---------XXXXXX--XXXXXXXX-XXXXXXXXXXXXX----XXXX-XXXXXXXXXXX----------------------------XXXXXXXXXXXXXXXXXXXXXXXXXXXX