--------------------------------------------------------------------------------------------------------------------------------------------
--------------------------------------------------------------------------------------------------------------------------------------------
--------------------------------------------------------------------------------------------SSSSSSSSSSSSSSSSSSSS----------------------------
----X-XX-------------------------------------------------------------------------------------SSSSSSSSSSS------------------------------------
---------------------------------------------------E----------------------------------------SSSSSSSSSSSS------------------------------------
-------------------------------S-XS-----------------SSS------SSSSS--------------------------SSSSSSSSSSSS-----------------------------------S
---X----------------SXS----------------------------------------------------------------------------------------------------------------SXSXX
----------------------------------------------------------XXSX-----------------------E--------------------------------------------------S--X
X-X-------------------------------------X------------------------------SXSX--------------------------------E--SX------------------SX--------
----------E--X------XXXXXX---X---------------------------------------------------------------SSSSSSSSSS------SSS-E-------XX---------SSSS----
---------<>---------XXX-XX-X----------------------------XX-------------------------------------SS-S-SS----------<>-------------E----------E-
---------[]----X---XXXX---------------------------------XX--------------------------------SS----SSS-------------[]--------------------------
------------------XXXXXXXX-X-------------------------SS-XX--------------------------------S-----SSS-------------[]--------E-------EE-----<>-
-------------------XX-----XXXXXXXXXX-------X-XX---------------XXXX-----XXXXXXXXXXXXXX-XXXX--XXXXXXXXXXXXXXXXXXXXXXXXXXXXXXXXXXXXXXXXXXXXXXXX