--------------------------------------------------------------------------------------------------------------------------------------------
--------------------------------------------------------------------------------------------------------------------------S--S-------------E
----------------------------------------------------------------------------------------------------------------SSSSSSSSSSSSSSSSSSS-------<>
----------------------------------------------------------------------------------------------------------------X-------SSSSSSSS-------XXXXX
------------XXXXXXX-----------------------------------------------------------------------------------------------------SSSSSSSSSSSS--------
--------S-----------SXSX-----------------------------------------------------------------------------------------------SSS--ES----SE------XX
------------------------------------------------SX-----------------------------------------------------------------------------S----XX-X----
-----------------------------------------------------------------------------------------------------------------------------SSSS-------XXX-
------------------------------X----------XSX----------------------E----------E---------------------------------------------X--SSS------XXXX-
S-SSSS----------------------------------XXX------XXXXXX---X------<>--<>E----<>---E-------------------------------SQSQ--------SXS------XXXX--
-----------------------E----------------------------------<>-----[]------X--[]---XXX--------------------------XX-----------E---------XXXXX--
----------------------<>----------------------------------[]-----[]---------[]--------------------------------XX-------------------XXXXXXX-X
-------------E--EE----[]----------------------------------X---EE-[]-E-------[]-------------------------------XXX-----------S------XXX-XXXX--
XXXXXXXXXXXXXX-XXXXXXXXX----XXXXX----XXXXXXXXXXXXX-----XXXXXXXXXXXXXXXXXXX-XXXXXXXXX-----XXXXX----------XX--XXXXXXXXXXXXXXXXXXXXXXXXX---X---