--------------------------------------------------------------------------------------------------------------------------------------------
--------------------------------------------------------------------------------------------------------------------------------------------
--------------------------------------------------------SSSSSSSSSSSSSSSSSSSSSSSSSSSS--------------------------------------------------------
--------------------------------------------------------------SSSSSSSSSSSSS-----------------------------------------------------------------
---------------------------E-----------------------------------SSSSSSSSSSSSS----------------------------------------------------------------
SSS?S--------SQ--X------SSSS-------------------------------------SSSSSSSSSS--------X--------------------------------------------------------
-----------E--X---------------------------------------------------------------------------------------------------------------------SXE-----
---------------X-X---------------------------------------XX---------------------------------------------------------------------------------
---------------------------S----E----------------------------------------------XXXSX-------------XXX------------XXX----------XXX------------
-------------------------------<>--------------SS-----E----------SSSSSSSSS----XXX--X-------------------------------------------------XXXXX--
----------XXXXXX------------o--[]--------------------<>------------SSSS-----X-XXXX-X--------------------------------------------------------
-------------------------------[]--------------------[]-------------SSS----XX-XXXXXX--------------------------------------------------------
-------------------------SSS---[]---------E-EE----E--[]----------ESSSSS---XXX-XXXX-X-------------------------------------------------X-----X
------------------------XXXXXXXXXXXXXXXXXXXXXXXXXXXXXXXX--XXXXXXXXXXXXXXXXXXXXXXXXXX---X----XXX--------X------XX---------------------------X