-------------------------------------------------------------------------------------------E------------------------------------------------
--------------------------------------------------------------------------------------------------------------------------------------------
-----------------------------------------------------------------------------------------SSSSSSSSSSSSSSSSSSSSSSS-------------------SSSS----S
-----------------------------------------------------------------------------------------SSSSSSSSSSSSSSSS-----------------------------------
-XXXXX-------------------------------------------------------------------------------------SSSSSSSSSSSSS------------------------------------
-E------------------------------------------------------SS---------X-------XS----------S----SSSSSSSSSSSS------------------------------------
XXXXXXX------------------------------------------------------------------------------SSSX---------------------------------------------------
-------------------------------------------------------------------------------------<>---------------------------XXXX----------------------
------------------------------------------------------------------------------------?---------E----------?----SX-------------SX-X-----------
-----------XXXXX----------XX--------XX-------------------Q--------------------------------<X--SSSSSSSSS------ESS-------------------------SQS
-----------------------E------------------------------------------------------------------[]---SSSS-SS------------------------------E-------
----------------------XX------------------------------------------------------------------[]---SSSS---------XXXX----S--------------<>-------
----------------------XX-------------------E------------------------------------X---X-X---[]---SSSS----<>-E---X----SS-------E------[]-------
--------X-------------XX-X--XXXXXXX--XXXXXXXXXXXXXXXXXXX--------------------X---------XXXXXXXXXXXXXXXXXXXXXXXXXXXXXXXXXXXXXXXXXXXXXXXXXXXXXX