--------------------------------------------------------------------------------------------------------------------------------------------
--------------------------------------------------------------------------------------------------------------------------------------------
-----------------------------------------------------------------------------------------------------------------S-S-S----------------------
--------------------------------------------------------------------------------------------------------------------------------------------
--------------------------------------------------------------------------------------------------------------------------------------------
-----------------------------------------------------------SSSSS-----SQS-------------SS?S------------X----------S--------------------XXXXXXX
-----------------------------------------------------------------------------------------------E--X--X--------------------------------------
--SSSX---------------------------------------------------------------------------------------------X-X--------------------------------------
-------------XXXXXX-------------------------------------------------------------------------------------------------------SXSXSX------------
---X---------------------------QQ--------------------XXX-------XXX---------------------X-------------------------QQQ-------------------XXXXX
------------X----------------------------------------XXX--------------------------------------XXXXX?----------------------------------------
---X----SXX------------------------------------------XXX------------------------------------------------------------------------------------
--SX-----X-------------------E-----------EEE-----E-XXXXX--------------------------E--------------------------EEE----------------------------
XXXXXXXXXX---XXXXXXXXXX-XXXXXXXXXXXX---X-XXXXXXXXXXXXXXXXXXXXXXX-------X--X-X-XXXXXX------------------------XXXX---------XXX----------------