--------------------------------------------------------------------------------------------------------------------------------------------
----------------------------------------------------------------------S---------------------------------------------------------------------
--------------------------------------------------------SSSSSSSSSSSSSSS----------------XSXS-------------------------------------------------
------------------------------------------------------------------------------------XXXXXXX-------------------------------------------------
--------------------------------------------------------------------SX----------------------------------------------------------------------
----------------------------------------------Q---------X-----------EX------------------------------------------SS--------------------------
--------------------------------------------------------------------------------------------------------------------------------------------
--------------------------------------------------------------------------------------------------------------------------------------------
--------------------------------E-------E------------------<>-------E--------E-------------------------------X------------------------------
-------------------SSS----E----<>--------------QQQ----E----[]-----------SX--S--X---------------------------XXXXX-QQ-------------------------
-------------------------<>-E--[]--------------------<>-?--[]-----E-SE-----XX-XX-------------E----------XXXXXXXX--------------------------X-
-------------------------[]----[]--------------------[]----[]------SSS------XXXXXX----------<>---------XXXXXXXXX------------------------XXXX
E-EE------E--------------[]-E--[]----EE--------------[]----[]----E-------X-XXXXX-------EE---[]--------XXXXXXXXXX------------------------X-XX
XXXXXXXXXXXXXXXXXXXXXXXXXXXXXXXXXXXXXXXXXXXXXXXXXXXX-X---XXXXXXXXXXXXXXXXXXX-XX-XXX-XXXXXXXXXXXX--XXXXXXXXXXXXXXXXX-X-X-------X-----XX-XXXXX