---------------------------------------------------------------------E----------------------------------------------------------------------
---------------------------------------------------------------------S----------------------------------------------------------------------
-------------------------------------------------------------SSSSSSSSSSSSSSS-----SSS----------------------------SSSSSSSSSSSSSSSSSSSSSSSSSSSS
---------------------------------------------------------------SSSSSSSSSSSSSS---------------------------------------------------------------
---------------------------------------------------------------SSSSSSSSSSSSS--------------------------------E-E-----------------------------
-----------------------------------------------------------S----SSSSSSSSSSSS-------XS-S?S-SX----XSX---------SXXS----------------------------
--------------------------------------------------------------------------------------------------------------------------------------------
--------------------------------------------------------------------------------------------------------------------------------------------
----------SSSX----------------------------------------------------??-----------E-XXX-----------XX--------------------------------------XX---
-XX---------------------------------------------------XX----------?SSSSSSSS-----XXXXXXXX----------------------------------------------X---SS
------------------------------------------------------XX---<>------SSSS-S-------XXXX--------------------------------------E-----------X-----
------------------------------------------------------XX----S------SSSS-------XXXXXX-------------------------------------<>--------XX-XX----
----------------------------------------------------E-XX---E-------S-SS----<>-X-XXXX-----E-------------------------EE----[]-----XXXXX-XX----
XXXXXXXXXXXXXXXXXXX---------XXXXXXXXXX---XX----XXXXXXXXX---XXX-XXXXXXXXXXXXXXXXXXXXXXXX-----------------X-------XXXXXXXXXXXXXXXXXXXXXXXXXXXX