--------------------------------------------------------------------------------------------------------------------------------------------
--------------------------------------------------------------------------------------------------------------------------------------------
SSSSSSSSSSSSSSSS------------SSSSSSSSSSSSSSSSSSSSSSSSSSSSSSSSS--SS---------------------------------------------------------------------------
--------------------------------------------------------------------------------------------------------------------------------------------
--------------------------------------------------------------------------------------------------------------------------------------------
------------EX--------------------------------------------------------------------X-------------------------------------------------------S-
------------------------------------------------SXSX------------------------------X---------------------------------------------------------
------------------------------XXX------------------------------------------------SX--------------------------------------------X-X----------
----E------------------XXXX--------------SX---------------------------SX---------XX--------------------------------------------------------S
---<>------------X--X--XXX------------E----------XX------QQQ-----------------X--XX-X-------------------SSS----<>------------------------XXX-
---[]-----E--E-----XXXXX-------------<>---------XX---------------------------XX-X-XX--------------------------[]----------------------------
---[]----<>--------XXXXXXXX----------[]--------XXX---------------------------XXXXXXX-------------------------b[]------------X---------------
---[]----[]-----XXXXXXXXXXX----------[]-----X-XXX---X-----------------------XXXXXXXX--------------------------[]----------------------------
XXXXXXXXXXXXXXXXXXXXXXXXXXXX-XXXXXXXXXXXXXXXX-XX----XXXXXXXXXXXXXXXX--XXXXXXXXXXXXXXXXXXXXXXXXXXXXXXXXXXXXXXXXXX--------------------------XX