--------------------------------------------------------------------------------------------------------------------------------------------
----------------------------------------------------------X------------------------E--------------------------------------------------------
--------------------------------------------------------SSXSXSSSSSSSSSSSSSSSS-----<>SSSSSSSSSSSSSSSSSSSSSSSSSSSS----------------------------
------XX-------------------------------------------------------SSSSSSSSSSSSS---XXX[]--------------------------------------------------------
---------------------------------------------------------S------SSSSSSSSSSSS----------------------------------------------------------------
-E---------------------------------------------------------------S--SSSSS-SS--SXX--X---S--------EQ--SS------------------SSSSSSSSS-----------
XXXXXEX---------------------------------------------------------------------X--X------------------------------------------------------------
---------------------------------------------------------S-----------S----------X--------------------------------X--------------------------
---------------------------------------------------------XS------S-XSSSSSS-----XXX-----------------------E----------------------------------
---------------X----------XX-------------------------------------SSSS--SS-----XXX-SS-------------SSSSX--X-----QS------------S--SS-----------
---------E---------------------------------------------------------S-------------------E------E-SSS--X-XXXX-----------------------------X--X
------------XXXX----------------------X-X---------------------------------------------<>-----<>--SS-----XXX------------------------------XXX
--------------------EE----------------X-X----------------------------------X----------[]--<>-[]--SS-XX-XXXX------------------------------XXX
---------X---------X--XX-XX-XXXXXXXXXXXXXXXXXXXXXXXXXXXXXXXXXXXXXXXXXXXXXXXX-------X-XXXXXXXXXXXXXXXXXXXXXXXXXXX--X--X--XXX--XXXXXXXXXXXXXXX