--------------------------------------------------------------------------------------------------------------------------------------------
--------------------------------------------------------------------------------------------------------------------------------------------
--------------------------------------------------------------------------------------------------------------------------------------------
--------------------------------------------------------------------------------------------------------------------------------------------
------------------------------------------------------------------------------------------------------------E-------------------------------
------------------------------------------------S---------------------------------S----------------------XXXXXX-----------------------------
--------------------------------XXX---------------------XXXXXXX-----------------------------------------------------------------------------
--------------------------------------------------------------------------------------------------------------------------------------------
--------------------------E--------------------------------------------------------S--------------------------------------------------------
X---?---S----------SSS---<>------------XXXX----------XXX--------------------------X--------------------------XXX--XX-----<>----E-----E------
-------------------------[]------------------------E------------------------------------------------------------------E--[]---------<>------
X------------------------[]-----------------------<>----------------XXX-------------------------------------------XX-----[]--XX-----[]------
XEEEE--------EE-E--E-----[]-----------------------[]--------------------------------------------------------------XX-----[]---------[]------
XXXXXXXXXXXXXXXXXXXXXXXXXXXXXXXXX--------------XXXXXXX-X-----------------XXXXXXXXXXX---------XXXX---------------XXXXXXXXXXXXXXXXXXXXXXXXXXXX