--------------------------------------------------------------------------------------------------------------------------------------------
--------------------------------------------------------------------------------------------------------------------Q-----------------------
--------------------------------------------------------SSSSSSSSS-S--SSS---SSSSSS-----------------------------------------------------------
------------------------------------------------------------------------------------------------------------------------------------------<>
-----------------------------------------------------------------------------------------------------SX---------S----------------------EE-[]
---------------------------S--------------------------------------------------------------------------------------SSSSSS--------------EXXXXX
----------------------------------------------------------------------------------------------------------------E-S-------------------------
--------------------------------------------------------------------------------------------E-----------------------------------------------
----------------S-SX----------------------------------E---------------------------------------------------------SES--------SX--SSSX---------
-E-------------------SSS--------E--------------Q-----<>-----E-----------SX--X-----------S?SSS-------------------XX---XXXX-------------------
<>-----------------------------<>--------------------[]----<>--------E----------------------------------------X-----------------------------
[]-----------------------------[]--------------------[]----[]--------S---------------------------------------SX-----------------------------
[]--------------------------EE-[]--------EE-E--------[]----[]----E-------X--E-E------------------E-E--E----XXXX------E----------------------
XXXXXXXXXXX----XXXXXXXXXXXXXXXXXXXXXXXXXXXXXXXXXXXXXXXXXXXXXXXXXXXXXXXXXXX-X--XXXXXXXXXXXXXX---XXXXXXXXXXXXXXXXXXXXXXXXXXXXXXXXXXXX---------