--------------------------------------------------------------------------------------------------------------------------------------------
--------------------------------------------------------------------------------------------------------------------------------------------
----------------------------SSS---SSSSS-SSSS------------------------------------------SSSSSSSSSSSSSS----------------------------------------
----------------------------------------SS--------------------------------------------------------------------------------------------------
--------------------------------------------------------------------------------------------------------------------------------------------
-S------------------------------------SSSS--------------------------------------------------------------------------------------------------
--SS------------------------------------------------------------------------------------------------------------------------------------SSSS
--SSSX-------------------------------------------------------------------------------------------------------------------------X------------
XXS----------XXXXXX--------------------------------XXXXX----------------------------------------------------XX------------------------------
---X----------------------------E-------SS-SSX--S--XXXXX----------E----------X--------------------------X-XXXX-X--XX-----XX-----------------
------------X------------------<>-------SSS-------XXXXX----------<>---------------------------E---------XXXXXX-X---------XXXXX--------------
--SX----SXX--------------------[]------SSSS-----XXXXXXXX-------------------------------------<>--------XXXXXXX---XXX-----XXXXXX-------------
--SX-----X----------E----X-X---[]---------S---XXX-XXXXXX--------------------EX---------EE----[]-------XXXXXXXXX--X-------XXXXX-------E------
XXXX-XXXX------XXXXXXX--XXXX--XXXXXXXXXXXXXXXXXXXXXXXXXX---XXX-----------XXXX-----XX-XXXXXXXXXXXXXXXXXXXXXXXXXXX------XXXXXXX---XXXXXXXXXXXX