--------------------------------------------------------------------------------------------------------------------------------------------
--------------------------------------------------------------------------------------------------------------------------------------------
------------------------------------------------------------------------------------SSSSSSSSSSSSSSSSSSSSSSSSSSSSSSSSSSSSSSSSSSSSSSSSSSSSSSS-
----------------------------------------------------------------------------------------X-----------------------------------SS--------------
-----------------------------------------------------------------------------------------------------------------------------S--------------
----------------------------------------------Q--------------------SSQ--S?SS------------------------------------------------SS---------XX---
------------------------XX------------------------------------------------------------------------------SXSX--------------------------------
--------------------------------------------------------------------------------------------------------------------------------------------
----------------------------------------------------------------------------------E---------------E------------------------------------XXX--
-------------------SSS----<>----E-------------QQQQ---<>------------S----QQQQ-----<>-----------E---------XXXXX-------E--------SSSSXS---X---SS
---------------E----------[]E--<>--------------------[]--------------------------[]----------<>---------XXX----X------------SS--------XX----
--------------------------[]---[]--------------------[]-------<>-----------------[]----------[]--------XXXX----X------------SS--------XX----
--------------------------[]E--[]-E---E--------------[]-E-E---[]-----------------[]----------[]-----X-XXXXXXXX-X---Eb------------XXXE-XX----
XXXXXXXXXXX-XXXXXXXXXXXXXXXXXXXXXXXXX-XXXXXXXXXXXXXXXXXXXX--XXXXX------XXXXXXXXXXXXX-XXX-XXXXXXX-XXX--XXXX--XXXXXXXXXXXXXXXXXXXXXXXX-XXXXXXX