--------------------------------------------------------------------------------------------------------------------------------------------
--------------------------------------------------------------------------------------------------------------------------------------------
--------------------------------------------------------------------------------------------------------------------------------------------
------------------------------------------------------------------------------------------XX------------------------------------------------
--------------------------------------------------------XXXXXX--------XSX-------------------------------------------------------------------
-------------SQS---------SSS--SSSSSSS------------------S-----------------------------E-----------------------------------------------------S
---------------------------------------------------------------XX-------------------XXXXXXX-------------------------------------------------
----------------------------------------------------------------E---------------------------------------------------------------------------
--------------------------------------------SXSX--------------------------------------------------------------------------------SXSX--------
---------X-------------S----<>---XXXXX-------------S----------S-S-----------S-----<>-------------XXX----------X--E-----XXXX------------S----
--------------XX---E--------[]----------------------------------------------------[]---------E------------------<>-------------E------------
------------------<>--------[]----------------------------------XS----------------[]-------------XX-------------[]--------------------------
------------------[]--------[]--------------------------------------------EE----E-[]--------------------XXXX----[]----------------E---------
XXXXXXXXXXXXXXXXXXXXXXXXXX-XXXXXXXXXXXXXX--XXXXXXXXXXXXXXXXX-XXXX----XXXXXXXXXXXXXXX-----------------XXXX-------XXXXXXXXXXXXXXXXXXXXXXXXXXXX