--------------------------------------------------------------------------------------------------------------------------------------------
--------------------------------------------------------------------------------------------------------------------------------------------
--------------------------------------------------------------------------------------------------------------------------------------------
--------------------------------------------------------------------------------------------------------------------------------------------
----------------------------------------XXXXXXXX--------------------------------------------------------------------------------------------
SSS----X---SX-----EX---------------------------------------SSSSX-----SQS--------SSSS-----------------X--------------------------------------
-----------------XXXXX----------------------------------------------------------------------------------------------------------------------
--------------------------------------------------------------------------------------------------------------------------------------------
------------SX--------------------------------------------------------------------------------------SXSX-----------------------E------------
-QQ--------XXX---------XXX--S--SX---------------------E----------------------------------XXX------------------------------E-----------------
------------------------X--------S-------------------<>-------------XXXX---E-------------------XX---------------------E--<>-----------------
-----------------------------------------------------[]-------------------<>---------------------------------------------XX-XXXX------------
-----------------------------EE-E--------EE-EE-E-E-<>[]-------------------[]-----SE-------------------------------------------------EE------
----------------------------XXXXXXXXXXXXXXXXXXXXXXXXXXXXXXXXXXXXX---------XXX-XXXXXXXXXXXXX---XXXXXXXXXXXXXXXXXX-XXXXX-----------XXXXXXXXXXX