--------------------------------------------------------------------------------------------------------------------------------------------
--------------------------------------------------------------------------------------------------------------------------------------------
--------------------------------------------------------------------------------------------------------------------------------------------
----------------------------------------------------------------------------------<>--------------------------------------------------------
--------------------------------------------------------------------------------------------------------------------------------------------
---S----------------------------------------------------S----------------------XXXXX------------------------------SS--------------------SXX-
---SX-------------------------------------------------------------------------------------------------------SSSS----------------------------
---------------------------X-----------------------------------------------------------------------X----------------------------------------
X---------E----------E-------------------------------------------SSSSSSXS-----------------------------------------X---------X--X-X----------
--X---<>-<>--SSE----<>---E-Q-----------------------------XXX------------------XXX-----XX-----XX-------------------XX-------------------XX---
X-X---[]-[]------X--[]--------------------------------------------------------------XXX------XXXXX------------------------------------------
XXX--S[]-[]--<>-----[]--------------------------------------------------------------XXX------XXXXXX-----------------------------------------
XXX--S[]-[]-<>------[]---------------------------------------------------------------X-------XXXXX-------------E-----E----------------------
XXXXXXXXXXXXXXXXXXXXXXXXXXXXX-XXXX-----------X--------XXXXXXXX---XXXXXXXXXXX-------XXXXXXXXXXXXXXXXXXXXXXXXXXXXX--X------------------------X