--------------------------------------------------------------------------------------------------------------------------------------------
--------------------------------------------------------------------------------------------------------------------------------------------
--------------------------------------------------------------------------------------------------------------------------------------------
--------------------------------------------------------------------------------------------------------------------------------------------
----X-------XXXXXXXX---------------------------------------------------------------------------------------------------------------------E--
-------------------------------SSSSSS--------S---------S---------S--SSSSS-----------------------S?--------------SSS-------XSX--SX---XXXXXXXX
------------------------------------------XXXX--------SS------------------------------------------------------------------------------------
------------------------------------------E--------------S----------------------------------------------------------------------------------
--------------------------------------------XXXX-------------------SS--SS--------X------E----------------------------------XX---------------
----X---------------------E-XXXX-XXX--------------?S--------------S--------------------<>---------------------X-XXX-------------------------
-------------------------<>-XXX--------XE------------------------------------------X---[]--------------------XX-----------------------------
-------------------------[]-XX------S-SXXX---------------------------------------XXX---[]--------------------XX-----------------------------
--E----------EE-E--E----E[]-XX-X----S--XXX-----------E-E--------------------------XXEE-[]---------EE------E--XX-----------------------------
XXXXXXXXXXXXXXXXXXXXXXXXXXXXXXXXXXXXXXXXXXXXXXXXXXXXXXXXXXXXXXXXXXX---XXXXXXXX--XXXXXXXXXXXXXXXXXXXXXXXX-----X------------------------------