--------------------------------------------------------------------------------------------------------------------------------------------
--------------------------------------------------------------------------------------------------------------------------------------------
--------------------------------------------------------------------------------------------------------------------------------------------
--------------------------------------------------------------------------------------------------------------------------------------------
----------------------------------------------------------------------------------------------------------------S-------E------------------E
-------------------------------------------------------SSSS--------XX------XS---------SSSSSS----------------------SSSSSS---------X----------
----------------------------------------------------------------------------------------------------------------E-S--------E--XXXX---------S
--X-X-------------------------------------------------------------------------------------------------------------S-----------E-------------
--------------------------------------------SXSX-------------------XSX--------------S---------------SXS---------SE---------S---XXXXX--------
--X------------Q-------------E------XXX-----------?S----SQQQQ-Q--------------------------XXX--------------------X--X-XXX--------------------
XXX---------------E-E-------<>-------------E-----------------------------------------------------------------------------XXXX---------------
XX------------------X-------[]--------------------------------------------------X-XXX---------------------------XX-X----SXSXX---------------
XXX---E-----E-------X-------[]-------------------------------------------------------------------------------EEE-X-XSE-SSX---------------E--
XXXXXXXXXXXXXXXXXXXXXXXXXXXXXXXXXXXXXXXXXXXXXXXXXXXXXXXXXXXXXXXX---X----------------XX--XXXXXXXX---XXXX---XXXXXXXXXXXXXXXXXXX--XXXX-XXXXXXXX