--------------------------------------------------------------------------------------------------------------------------------------------
-------------------------------------------------------E------------------------------------------------------------------------------------
----------------------------SSS-SSSSSSSSSSSSSSSSS----S<>--------------------------------------------------------------------------SSSSSSSSSS
----------------------------------SSSSSSSSSSSSSSS-----[]------------------------------------------------------------------------------------
-------------------------EE--S-----SSSSSSSSSSSSS--------------------------------------------------------------------------------------------
SSS?SXSX--XSXSXSX-------SXX---------SSSSSSSSSSSS---X---X-------------------------------SSS-----------X--------------------------------------
-------------------------------------------------------------------------------------------------------------------SX-----------------------
-----------------------------SX---------------------X-------------------------------------------------------------X-------------------------
-----------XX--------------------------??S?SE------XXXSX--------------------------------------------SX--------------------E-----------------
XXXX---------------------------------SSSSSSSSS------X-SS-----------------------------------------------------------------S---SSES-----------
---------------------------------------S----------X-X-------------XXXXXX------------------------XX----------------------------------E---E--X
-----------------------------------------SS--------XXXXX--------------XX-----------------------------------------------------SX-----XX-----X
-------------------------SSS-----------SSS-----<>-----------------------------------------------------------------X---E--ES-<>-----<>-----XX
----------------------------X-XXXXXXXXXXXXXXXXXXXXXXXXXXX--------X--XX----XXXXXXXXXX-------XXX------------X------XXXXXXXXXXXXXXXXX-XXXXXXXXX