--------------------------------------------------------------------------------------------------------------------------------------------
--------------------------------------------------------------------------------------------------------------------------------------------
----------------------------------------------------------------------S-SSSSSSSSSSSS--------------------------------------------------------
--------------------------------------------------------------------------------------------------------------------------------------------
--------------------------------------------------------------------------------------------------------------------------------------------
-----------------------------------------------------------S------------SS-------------SSS-------------------------------SSSSSSSSSS---------
-----------------------------------------------------------SX-------------------------S-----------------------------------------------------
--XXXX---------------------------------------------------E----------------------------SSSX--------------------------------------------------
-------------SX-----------------------------------------?---------E----------E-----------------SXSXSXSX-----------------------------------XX
--XX-----------Q---------------------<>---------XX------------<>----SSSSSS--<>---E-Q--------------------------------------SSS--SSS-------XXX
-----------XE-----E-<>--E------------[]---------XX--------X---[]---SSSS-SXX-[]-----E----------------------------------------------------XXXX
-X--S----XS--------o[]---------------[]---------XX--------X---[]----SSS-----[]----------------------------------------SS----------------XXXX
-XXX-----X--X------E[]---E-E---------[]-----X---XX------X-X--S[]--SSSSS----<>?----------------------------------------S-----------------XXXX
XXXXXXXXXXXXXXXXXXXXXXXXXXXX-XXXXXXXXXXXXXXXXXXXXXXXXXXXXXXXXXXXXXXXXXXXX--XXXXXXXXX------XXXX-----XXXX-----XXXXXXXXXX----X--XXXXXXXXXXXXXXX