--------------------------------------------------------------------------------------------------------------------------------------------
------------SSS-----------------------------------------------------------------------------------------------------------------------------
SSSSSSSSSSSSSSSSSS---SSSSS------------------------------------------------------------------------------------------------------------------
------------S-------------------------------------------------------------------------------------------------------------------------------
------------SXSS--SS------------------------------------------------------------------------------------------------------------------------
X-----------SX----Q---------SQQ----SSSSSSQ--------------------------------------------S?---------SX---------SSSS----------------------------
------------------------------------------------------X-------------------------X-----------------------------------------------------------
------------------------------------------------------X-------------------------S--X-----------------------------------------------------SX-
---<>----------------E-E-----------------------------XX--------------------------------------------------------S----------SSSS-----------X--
---[]-----------SXS-S--X----S--QQQ-------SS----------X---------------------QQS----E--------------------------------------------------------X
?--[]-------SSS--------X-----------------------------XX--------------------------<>-------------------------------------------------------XX
---[]------SSS--------XX---------------------------XXXXX-------------------------[]-----------------------------------------------------XXXX
---[]------------E--E-X------E-----------EEE----E--XXXXXESEE--E---E-E------------[]-----------------------------------------------------XXXX
-XXXXXXXXXXXXXXXXXXX-XXXXXXXX--XXXXXX-XXXXXXXXXXXXXXXXX-XXXXXXXXXXXXXXXXXXXXXXXXXXXX----------------------------XXXXXXXXXXXX-XXXXXXXXXXXXXXX