--------------------------------------------------------------------------------------------------------------------------------------------
--------------------------------------------------------------------------------------------------------------------------------------------
--------------------------------------------------------------------------------------------------------------------------------------------
--------------------------------------------------------------------------------------------------------------------------------------------
---------------------------------------------------------------------------------E-------------------------------------------------------E--
-S--------XSXSXSX-------SSSS----------X----S-----X--SSSS-S---------SX----------XSXX-SS-S-------SXSX---------SSS-SSS--------SXSXSX-XXSXXXXXXX
-------XX----------------------------------------------------------------X---------------------------XX--------------------------XX---------
--------------------------------------------------------------------------------------------------------------------------------------------
-----------------------------------------------------------------------------------S---------------------------S------------XX--------------
---------------------------------------------------------------------X----------XXXX-----------------------------XX---------------------XXXX
-------------------E------------------------------------------------------------------------------------------------------------------------
------------------SX------------------------------------------------------------------------------------------------------------------------
--------------------------E-----------------------------------------------------------------------------------------------------------------
-------------------XXXXXXXXX-------XXX--------XXXXXXXX-X-------------------------------------------------------X----------------------------