--------------------------------------------------------------------------------------------------------------------------------------------
--------------------------------------------------------------------------------------------------------------------------------------------
----------------------------------------------------------------SS--SSSSSSSS----------------------------------------------------------------
-XE--E------------------------------------------------------------SSSSSSSSSSS---------------------------------------------------------------
XXXXXX-------------------------XX-------------------------------SSSSSSSSSSSS--------XXXXXX--------XSX---------------------------------------
-E-------------------XS-----------------------------------------SSSSSSSSSSSS-------X--------------------------------------------------------
XXXX-X-------------------------------------------------------------------------------------XX-----------------------------------------------
---------------------------------------------------------S---------------------------------------------------------------------X------------
--------------------------------------------------------SX---------?--------------SX------------------------------------------XE-----------S
--------------------------------------------------------X------?-SSSSSSSSSS------SSS------S-S-----------------EX----------------------------
---------E-------------E---------------------------E-<>------------------------------------------------------<>-----------------------------
X-------<>------------<>------------<>-------------------------------------------XXX--------XS---------------[]---SX-----XXXXXX-------------
--------[]------------[]------EEE---[]----E-EE-E--Eo----X----------------------------------------E----------E[]---S-------------------------
XXXX-XXXXXX-XX--XX-XXXXXXXXXXXXXXXXXXXXXXXXXXXXXXXXXXXXXX--XXXXXXXXXXXXXXXXXXXXXXXXXXX----XXXX--XXXXXXXXXXXXXXXX--------------------------XX