--------------------------------------------------------------------------------------------------------------------------------------------
--------------------------------------------------------------------------------------------------------------------------------------------
--------------------------------------------------------------------------------------------------------------------------------------------
--------------------------------------------------------------------------------------------------------------------------------------------
-------------------------------------------------------------------------------------------------------------E-------------------------E-EE-
SSS-------XXX-XSX--XXXXXSSSSSSS?-------SXSX-----------S---------------S------XXXXX---S----------X-----E-----XXX-SSS?---X--XSXSXSX-------SXXS
---------------------------------------------XX------------------------------------------------------XXXXX----------------------------------
--------------------------------------------------------------------------------------------------------------------------------------------
----------------------------------------X----------------------------------------------------------------------------------XX---------------
------------------------------X------------------XXXX-------------------------------------------XX--------XXXXXXXXX-------------------------
--------------------------------------------------------------------------------------------------------------------------------------------
--------------------------------------------------------------------------------------------------------------------------------------------
-------------------------------------------------------X---------------E-E---------------------------------------------------------------SSS
-------------------------------------------------------XXXXXXXXXXXXXXXXXXXXX----------------------------------------------------------------