--------------------------------------------------------------------------------------------------------------------------------------------
--------------------------------------------------------------------------------------------------------------------------------------------
-----------------------------------------------------------XSX-------------------------XS-SSS-S-S-------------------------------------------
----------------------------X-XXXXXX--------------------XXXXXXX-------------------------X-XX------------------------------------------------
------------------------------------------------------------XXX---SXSXSXSX----------------------------------------------------XXXXX---------
-------------------------------------------------------------XXS-------------------------------------------------QS-----------------XXS-----
--------------------------------XXX------------------------------------------------------E--------------SX----------------------------------
--XXX-----------------------------------------------------------------XS--------------------------------------------------------------------
-------------SX-----------------------------------------------------------------------------------------------------------------------------
---------X-------------------------------XX--------XXXXX---SX------------------XXX--------------XXXX-----XXXXXXXSSSSSSSS--------------------
--------------------E---E------------E-----------XXXXX-----------E------------XXXX-----------E-----------XXX--------------------------------
---------XX---------o---------------<>----------XXXXX---X-------<>-----------XXXXX----------------------XXX----------------------------<>---
---------XX-E-------<>-----X--------[]--------XXXXXXXX---<>-E---[]-S-------E-XXXXX--------------------XXXXXXX----------------E-EEE-----[]---
XXXXXXXXXXXXXXXXXXXXXXXXXXXXXXXXXXXXXX-------XXXX-XXXXXXXXXXXXXXXXXX---XXXXXXXXXXXX-XXXXX----X-------XXXX------XXXXXXXXXXXXXXXXXXXXXX--X----