--------------------------------------------------------------------------------------------------------------------------------------------
--------------------------------------------------------------------------------------------------------------------------------------------
--------------------------------------------------------------------------------------------------------------------------------------------
--------------------------------------------------------------------------------------------------------------------------------------------
--------------------------------------------------------------------SX----------------------------------------------------------------------
--------------------------------------------------------X-----------EX----Q--------------E?S?S---------Q------------------------------------
---------------------------------------------------------------------------------------SX---------------------------------------------------
-------------------------------------------------------------------------------------XXXXX--------------------------------------------------
--------------------------------------------------------Q--<>-------E--------E----XX?-------------------------------------------------------
----------E------------------------------------------------[]-----------Q---S--XXXXXXXX----------SSQ---------QQQ----------------------------
---------<>-------------X--X----------------------------?--[]-----E--E---------XXXXXXXX--------S------E-E-----------------XXXXXX------------
---------XQ----------X-------------------------------------[]----<>SS---------XXXXXXXX--SS-------------<>-----------------------------------
---------<>---------EE-----X-------------------------------[]----[]---------XXX-XXXXXXXSSSXS----<>-----[]-----------------------------------
XXXXXXXXXXXXXXXXXXXXXXX---XXXXXXX----XXXXXXXXXXXX-X-XXXX-XXXXXXXXXXX--XXXXXXXXXXXXX-XXXXXXXXXXXXXXXXXXXXXXXXXXXXXXXXXX---XXXXX--XXXXXXXXXXXX