--------------------------------------------------------------------------------------------------------------------------------------------
--------------------------------------------------------------------------------------------------------------------------------------------
------------------------------SXSX-XSXS-----------------------------------------------------------------------------------------------------
--------------------------------------------------------------------------------------------------------------------------------------------
-------------------------------------------------------------------------------------XXXX----------------------------------------------E-EEE
---------------------------S-----------------------XX-----------------------------------------------------------S-S?SXSX--X--SXSX-------SSSS
-----------------------SXSX---------------------------------------------------------------XXX-----------------------------------------------
------------------------S---------------------------X---------------------------------------------------------------------------------------
---------------------------------------------------XX-----------------------------------------------------------------------X---------------
-----------------------S------SS--------XXX---------X-XX--X------------------E-----------------------------------XX-------------------------
--------------XE---E------------------------------XX----XXX-----------------<>--------------------------------------------------------------
------------------<>------------------------------XX-----X------------------[]--------------------------------------------------------------
-E----------------[]-------------------------E-E--XX----XXX---E---E-E-------[]-----------------------------<>----------------------------SS-
XXXX-XXXXXXXXXXXXXXXXXXXXXXXXXXXXX---XXXXXXXXXXXXXXXXX-XXXXXXXXXXXXXXXXXXXXXXXXXXXXXXXXXXXXXX----XX-----XXXXXXXX------------------X-XXX-----