--------------------------------------------------------------------------------------------------------------------------------------------
--------------------------------------------------------------------------------------------------------------------------------------------
----------------------------------------------------------------------------SXX----------------------------------------------------SXSSS----
--------------------------------------------------------------------------------------------------------------------------------------------
--------------------------------------------------------------------------------------------------------------------------------------------
-----E?S?SSS--SS?E?Q------------------X-------------SSSS------------------------------------------------------------------------------------
-S-S----------------------------------------------------------------------------------------------------------------------------------------
-XX---------------------------------------------------------------------------------------------------------------XXX-----------------------
SX--------------E-------------------------------------------------------------------------------------SX------------------E--XE-------------
XX----XXX----SSQSS-------SQS--------------------------------------E-----------X---XX----------X------------S------X------<>---SE-----E---Q--
X-----------------?-----------------------X----------------------<>-----------X-------------------XX------------------E--[]---------<>------
XX----SS--------------------------------------SX-----------------[]-----------------------------------------------X------[]--XB-----[]------
XX--SSS-----E-----------------------------------------------------------X---XXXX----------------------------------XS-----[]---------[]------
XXXXXXXXXX-XXXXXXXXXXXXXXXXX-------------------------------XX----XXXXX--------X--XXXXXXXXX--XXXXXXXXXXXXXXXXXXXXXXXXXXXXXXXXXXXXXXXXXXXXXXXX