--------------------------------------------------------------------------------------------------------------------------------------------
--------------------------------------------------------------------------------------------------------------------------------------------
--------------------------------------------------------SSSSSSSSSSSSSSSSSSSSSSSSSSSS--------------------------------------------------------
--------------------------------------------------------------------------------------------------------------------------------------------
-----------------------------------------------------E--------------------------------------E-----------------------------------------------
----------------------------------------------------SSS-------------------------------SSSSSX---------X----------------------SS--------------
-------------------X---------------------------------------------------------------------------E--XXXX--------------------------------------
---------------------------------------------X-----------------------------------------------------X-X-----------------------------------SX-
-------------------------------------------------------S--------------E-----------------------------SX-X-------------------X-SSSS--------XX-
-----------XXXX---------XXXX-------------------------XXX---------SS---SS-----------X---X-X--------------------------------SS------------X--X
------------------------X--------------------------------------------------XXXX----X---------XXXXXXX------------------------------------X-XX
----------------------------------------XXX--------------------------------XXXXXX--X---X------X----------------------------------------XXXXX
-----------------------------------------------------------------EE--------XX-X-XX-X---X---------------------EEE------------------------XXXX
------XXX----------------------------------------XXXXX--XXXXXXXXXXXXXXXXXXXXXXXXXXXXX---------------------XXXXXXXXXXXXXXXXXXXXXXXXXXXXXXXXXX