--------------------------------------------------------------------------------------------------------------------------------------------
--------------------------------------------------------------------------------------------------------------------------------------------
--------------------------------------------------------------------------------------------------------------------------------------------
--------------------------------------------------------------------------------------------------------------------------------------------
--------------------------------------------------------------------S-----------------------------------------------------------------------
------SSS--------SSS-------S----------------------------XQX-------SSSQ---?Q-----------------------------------------------------------------
--------------------------------------------------------------------------------------------------------------------------------------------
-----------------------------------------------------SX-------------------------------------------------------------------------------------
----------------S-S-------------------------------------X--<>-----?-E-------------EX--------------------------------------------------------
<>-------------S-----SSS-----SSSS-------------------XX-X?--[]------E----QQQQQ-Q--<>---------------------------------------------------------
[]-----------------------------------------------X--XXXXS--[]--------------------[]----------<>---------------------------------------------
[]----SS-----------------------------------------XXXXXXXb--[]------SS------------[]----------[]---------------------------------------------
[]----S-------------------E------------E---------XXXXXXXo--[]----------E-E--E-E--[]----------[]---------E-----------------------------------
XX--XXXXXXXX---XXXXXXXXXXXXXXXXXXXXXX-X---XXXXXXXXXXXXXXXX-XXXXXX-XXX-XXXXXXXXXX-XX-XXXXXXXXXXXXXXXXXX-XXXXXXXXXXXXX----------------XXXXXXXX