--------------------------------------------------------------------------------------------------------------------------------------------
----------------------------------------------------------------------------------------Q---------------------------------------------------
SSSSSSS--------------------------------------------------------------------------------------------------------E----------------------------
--------------------------------------------------------------------------------------------------------------<>----------------------------
------------S-----------------------------------------------------------------------S-----------------------E-[]--------------XXXXX---------
------------EX-------------------------------SSS-------S------------------------------SSSXSX--------------EXXXXX----------------------S-----
------------------------------------------------------------------------------------SSS-----------------------------------------------------
-----------------------------------------------------------------------X------------------------------------------------E-------------------
---<>-------E--------E----X-----------------------------XXX----------XXX------------SSS------SSSSSSSXSX-------------------------------------
---[]-----------SX--S--X-X-----------SX-----QQQ--SSS-------------------------XXXX---XXXX------------------XXX-------SSSS--------------------
?--[]-----E--E---------XXXX-----------------------------------------------------------------------------------------------------------------
---[]----<>S--------XXXXXXX-<>-----------------------------------XX-X---------------------------------------------------X--------------b----
---[]----[]------X--XXX--XX-[]--------------E-------------------------------EX-----X-----------------------------------------E--EE----<>----
-XXXXXXXXXXXXXXXXXXXXXX--XX-XX--XXXXXXXXXX-XXXXXXXXXXXXXXXXXXX------------XXXX----XX-------XXXX-----------------XXXXXXXXX---XXXXXXXXXXXXXXXX