--------------------------------------------------------------------------------------------------------------------------------------------
--------------------------------------------------------------------------------------------------------------------------------------------
----------------------------SSSSSSSSSSSSSSSSSSS-------S?------------------------------------------------------------------------------------
---------------------------------------------------XXXXX------------------------------------------------------------------------------------
---------------------------------------------------------------------------------E----------------------------------------------------------
-----------------------------------------------E-------X-S----------------------SXSS-----SS-----------S--------S--SSSSSS---------X--------SS
------------------------------------------------XXSX---------------------XX-----------------------------------------------------------------
----------------------------------------------------XXX-------------------------------------------------------------------------------------
SSS-------SSXS-SS-------------------------SXS------XXX-----------------------------S----------------SXSX------------------------SX-X--------
--------------------------------------E--SX------XXXXX--------------------------XXXX<>----XXXXX-----------?S---------X-X--------------------
------------------------------------------------XXXXXX------------------------------[]------------------------------------XXXXX-------------
---------------------------X-------------------XXXXXXX-X----------------------------[]------------------------------------------------------
-----E--------------------XX------------------XXXXXXXX------------------------------[]---------------------------------------------------EE-
XXXXXXXXXXXX--XXXXXXX----XXXXXXXXX--XXXX-XXXX-XXXX----------------------------------XXXXXXXXXXXXXXXXXXXXXXXXXXXXXXX---XXXX------XXXXXXXXXXXX