--------------------------------------------------------------------------------------------------------------------------------------------
--------------------------------------------------------------------------------------------------------------------------------------------
---------------------SSS-S-S------------------------------------SSSSSSSSSSSSSSSSSSSS--------------------------------------------------------
--------------------------------------------------------------------------------------------------------------------------------------------
--------------------------------------------------------------------------------------------------------------------------------------------
--------?-----SSS--Q---------------------------------------S------------SS------------------SSSSSSSSSSSS------------------------------------
---SX------------------------------------------------------SX-------------------------------------------------------------------------------
-XXXX---------------------------------------------------------------------------------------------------------------------------------------
?X--------------------------SE---------SX--SSS-----------------S--E----------E--------------------------------SX----------------------------
XX-------------QS--------QQQ------XXX-------------------------<>-<>--SSSSS--<>---QQQX--------SSSSSSSSSS------SQ-----------------------------
-----------?------E-E-------------------------------------<>--[]-[]-SSS--X--[]-------------------------------------------------E---E--------
X---S--------------<>-------------------------------------[]--[]-----SS-----[]-------------S-----------------SS-------------------<>--------
XX-SSSSS----EX-----[]------------E------------------------Xo--[]-<>-SSS-XS--[]------E-----S--------E------------------------------[]--------
XXXXXXXXXXXXXXXXXXXXXXXXXXXXXXXXXX---XXXXXXXXXXXXXXXXXXXXXXXXXXXXXXXXXXXX--XXXXXXXXXX---XX--XXXXXXXXXXXX--XXXXXXXXXX-XXXX---XXXX--XXXXXXXXXX