--------------------------------------------------------------------------------------------------------------------------------------------
--------------------------------------------------------------------------------------------------------------------------------------------
--------------------------------------------------------------------------------------------------------------------------------------------
--------------------------------------------------------------------------------------------------------------------------------------------
-------------------------E------------------------------------------------------------------------------------------------------------------
SSS?-------SXSX---------XXXX-----------XX-------------S-----------X--SXSX-------SSSSSSS--------SX--SX-XXS----XX-----------------------------
-----------------XXX-X--------XXXXXXX----------------------------------------------------------------XXX---------XXXXEX---------------------
--------------------------------------------------------------------------------------------------------------------------------------------
------------SX-----------------------------------------S-----------------------------------------------------------------------------------S
-XX-------------------XXXXXX--------------------------XX----------------------------------------------------XX----------------------------XX
--------------------------------------------------------------------------------------------------------------------------------------------
-----------------------------------------XX-------------------------------SX------------------------------------------------XXXX------------
--------------------------------------------------------------------------------------------------------------------------------------------
-----------------------------------------------XXXXXXXXX----------------------XXXXXX-------------------------------------------------XXXXXXX