-------------------------------------------------------------------------------------------------E------------------------------------------
----------------------------------------------------------------------------------------------SSS-------------------------------------------
------------------------------------------------------------------------------------SSSSSSSSSSSSSSSSSSSSSS---SSS----------------------------
------------------------------------------------------------------------------------------SSSSSSSSSSSSSSS-----------------------------------
-------------------------------------------------------------------------------------------SSSSSSSSSSSSS------------------------------------
-------------------------------------------------------------------------X------------------SSSSSSSSSSSS--XXX--X-----------------X----------
-----------------------------------------------------------------------XX-------SSSS-----------------------------------------------------SSS
--------------------------------------------------------------------------------------------------------------------------------------------
------------------------------------------------------------------------XX--------------------???---E------EXXSX----------------SX-X--------
-------------------SSQ---------SQ--------------------------X-X-------------------------------S?SSSSSSSS------SSS----------------------------
-------------------------EE--------------------------X--XX-------XXXXX------------------E------SSSS-------X-----XX--------XXXXXX------------
----------------------------------------------------XXX-XX-X-----XXXXX-------------------------SSSS-------XX----XX--------XXX---------------
--EE-----EE------------------------------EEE-------XXX---X-X-----XXXXX-----------------E---------SS--E----E------?--------XXXX--------------
XXXXXXXXXXXXXXXXXXXXXXXXXX---X-XXX-XXXXXXXXXXXXXXXXXX-X-XXXXXXXXXXXXXXXXXXXXXXXXXXXX---XXXXXXXXXXXXXXXXX--XXXXXXXXXX-XXXXXXXXX-XXXXXXXXXXXXX