--------------------------------------------------------------------------------------------------------------------------------------------
--------------------------------------------------------------------------------------------------------------------------------------------
--------------------------------------------------------------------------------------------------------------------------------------------
--------------------------------------------------------------------------------------------------------------------------------------------
--------------------------------------------------------------------------------------------------------------------------------------------
---------------------XQQQ---------------------------------------------XXXX------------------------------------------------------------------
---------------------X------------------------------------------------X<>-X-----------------------------------------------------------------
---------------------X------------------------------------------------X[]--X----------------------------------------------------------------
---------------------XEE-----X--------------ooo-----------------E----XX[]---X---------------------------------------------------------------
---------------------XSSSSSSSX--------------ooo---------------------XXS[]----X----------------XX--------------------------------------------
-------------oooo-------------------------------------------oo-----XX--[]-----X--------------XB-X----------------E-------------------------X
XX----------------------------------------------------------oo----XX---[]----S-X-----Q------XXb--X------------------------XXXXXX----------XX
E-XXXXXXXXXXXXXXXXXXXXXXXXXXXXXXXXXXXXXXXXXXXXXXXXXXXXXXXXXXXXXXXXX----[]------XXXXXXXXXXXXXX-BEE-XXXXXXXXXXXXXXXXXXXXXXXXXE-EE-XXXXXXXXXXXX
XXXXXXXXXXXXXXXXXXXXXXXXXXXXXXXXXEEXEXXXXXXXXXXXXEEXEXXXXXXXXXXXXXXXXXXXXXXXXXXXXXXXXXXXXXXXXXXXXXXXXXXXXXXXXXXXXXXXXXXXXXXXXXXXXXXXXXXXXXXX