------------------------------------------------------------------------------------XXXXX---------------------------------------------------
-------------------------------------------XXXXXXXXXXXXXXXXXXXXXXXXXXXXXXXXXXXXXXXXXX----XXXXXXXXXXXXXXXXXXXXX------------------------------
SSSSSSSSSSSSSSSSS?SSSSSSSSSSSSS----------XXXSS????SSSSSSSSSSSSSSSSSSSSSSSSSSSSSSSSSSS----SSSSSSSSSSSSSSSSSSSS-X---SSSSSSSSSSSSSSSS----------
--------------------------SSSSS-------XXXXSS---------------------------------------------SSSS------------------X--SSSS----------------------
--------------------------SSSSS-------XSSS-----------------------------------------------SSSS-------------------X-SSSS----------------------
--------------------------SSSSS-------X--------------------------------------------------SSSS----E---------------XSSSS-------------XX--XXXX-
-----------------XXXXX----SSSSS------XX---------------------------------------------------------<>----------------X---------------XX-XXX---X
-----------XXXXXXX----X---SSSSS-----XXS---------------------------------------------------------[]-----------------X-------------XX--XXX----
----------XXXXXXXX-----XX-SSSSS---XXX-------XXXXX------------------------------------------E----[]-----------------oXXX------XXXXX----------
--XXXX---XXXXXXXXX----<>-X---SS--XX<>------XXXXXX----------------------------XXX----------<>---?SSS--E------------S?SS-X----XX-XXX------S--?
-X----X-XXXXXXXXXX----[]--X--SS-XX-[]-----XXXXXXX--------------------XXX------------------[]--------<>------------SSS---X--XX-----------SSS-
XX-----XXXXXXXXXXX----[]---X-SSXX--[]----XXXXXXXX---XXX------XXX--------------------------[]--------[]-----<>-----SS-----XXX------------SSS-
XX-----XXXXXXXXXXX----[]----XXXX---[]---XXXXXXXXX-----------------------------------------[]--------[]-----[]-------E-EE--XX------------SSS-
XX-----XXXXXXXXXXX--XXXXXXXXXXXXXXXXXXXXXXXXXXXXXX-----------------------------------XXXXXXXXXX----XXX---XXXXXXXXXXX-XXXXXXX---------XXXSSS-