--------------------------------------------------------------------------------------------------------------------------------------------
--------------------------------------------------------------------------------------------------------------------------------------------
--------------------------------------------------------------------------------------------------------------------------------------------
--------------------------------------------------------------------------------------------------------------------------------------------
-----------------------------------------oooooooo--E--XXXXXXX---------E---------------------------------------------E---------------------XX
SS----QQQQQQ---------------------------SSSSSSSSSSSSSSXX-SSSSXSSSSSSSSSSSSS--------------------------------------QQQQQQQQQ----------------XXX
----------------------------------------------------XX-------X--------------------------------------------------------------------------XXXX
B--------------------------------------------------XX---------X------------------------------------------------------------------------XXXXX
b--------------------XXXX-?-----------XXXXXXXXXXXXXX-----------X------E------X--------------------------XXXX---------E----------------XXXXXX
X----QQQ?QQQ--------XX<>-X-----------XX--?SSSSSSSSSS--X?--------X-----QQ?QQQQX-------------------------XX<>-X--E?QQQQQQQQ---------XXXXXXXXXX
X------------------XX-[]--X---------XX---------------XX----------X------------------------------------XX-[]--X-------------------XXE--XXXXXX
X-----------------XX--[]---X-------XX---------------XXX-----------XX----------------XXX--------------XX--[]---X-----------------XX<>-XXXXXXX
XXXXXXXXXXXXXXXXXXX---[]----XXXXXXXX-----------E---XXXX-----------X-XXXXXXXXXXXXXXXXX-EXXXXXXXXXXXXXXX---[]----XXXXXXXXXXXXXXXXXX-[]-XXXXXXX
XXXXXXXXXXXXXXXXXXXXXXXXXXXXXXXXXXXX---XXXXXXXXXXXXXXXXXXXX-------XXXXXXXXXXXXXXXXXXX--XXXXXXXXXXXXXXXXXXXXXXXXXXXXXXXXXXXXXXXXXXXXXXXXXXXXX