--------------------------------------------------------------------------------------------------------------------------------------------
--------------------------------------------------------------------------------------------------------------------------------------------
---XX---------------------------------------------------------------------------------------------------------------------------------------
---[]---------------------------------------------------------------------------------------------------------------------------------------
---[]---------------------------------------------------------------------------------------------------------------------------------------
---[]-------------------SSSSSS-----------XXXXXXXXXXXXXXXX--------------X--------------------------------------------------------------------
---<>---XXXX---------------------------------[]-------[]-----------------------------------------------------------------------------------E
-------XX---X------XXX-------XXX-------------[]-------[]-------------X-----------------------------------------------------------------XXXXX
------XX-----X----XXB-XXXXXXXX--X------------[]-------[]-------XXX-----------------------------------------SS--------X---X-----------XXX----
-----XX-------X--XXXXXXESSSSSS---X-----------[]-------[]------XX<-X-------------------------Q----E------E-----E---XQ----------------XXXX----
XXXXXX---------XXXXXXXXX----------X----------<>-------<>-----XX-[]-X----------------------------<>-----<>----<>---X----------------XX-------
XXXXXX--------XXXXXXXXXX-----------X---------XXX------XXX---XX--[]--X----------XX---------------[]-----[]----[]---X----------XXXXXXX--------
X-------------XXXXXXXXXX----------B-XXXXXXXXXXE-XXXXXXXE-XXXX---[]---XXXXXXXXXXXXXXXXXXXXXXXXXXX[]-----[]----[]---X-------XXXX--XXXX--------
X-------------XXXXXXXXXXXXXXXXXEXXXXXXXXXXXXXXX-XXXXXXXX-XXXXX--XXXXXXXXXXXXXXXXXXXXXXXXXXXXXXXXXXXXXXXXXXXXXXXXXXX----XXXXXXX--------------