--------------------------------------------------------------------------------------------------------------------------------------------
--------------------------------------------------------------------------------------------------------------------------------------------
--------------------------------------------------------------------------------------------------------------------------------------------
--------------------------------------------------------------------------------------------------------------------------------------------
-------------------------------------XXX-----------------oo---------------------------------------------------------------------------------
------------------------XXXX--------XX--X----------------oo---------------------------------------------------------------------------------
-----------------------XX---X------XX----X--------------------------------S-------------------------oooo-----------oooo---------------------
----------------------XX-----X----XX------XXXXXX----XXX-------------------------------------------------------------------------------------
--------------------XXX-------XXXXX--------X----XXXXX--X---------------------------------ooo-------------------XXXX-------------------------
-XX----------------XXXX-------XXXXX--------X---XXXXXX---X---?-------------------------------------------------XX<>-X------------------------
XX-X--------------XX-X-----------------------------------X-----XXXX---XXXXXX---------------------------------XX-[]--X------------QQQQQ?-----
X---X------XXXXX-XX---------------------------------------X---XX---X-XX---X-X-------------------------------XX--[]---X---------------------X
X----XXXXXXX----XX-----------------------------------------X-XX-----XXX---X--XXXXXXXXXXXXXXXXXXXXXXXXXXXXXXXX---[]----XXXXXXXXXXXXXXXXXXXXXX
X---XXXXXXXX----XX----------------------------------XXX-----XX-----XXXXX--X--XXXXXXXXXXXXXXXXXXXXXXXXXXXXXXXXXXXXXXXXXXXXXXXXXXXXXXXXXXXXXXX