------------------------------------------------------------------------------------------------------------------------------XXXXXXX-------
---------------------------------------------------------------------------------------X-------------------XXXXXXXXXXXXXXXXXXXX-----XXXXXXXX
----------------------------------------------------------------------------------oo---------------------XXXSS????SSSSSSSSSSSSS-------SSSSSS
------------------------------------------------------------------------------------------------------XXXXSS--------------------------------
---------XXXXX--------------------------------XXXXX---------------------------------------------------XSSS----------------------------------
--------XXXX--X------------E---------------E-XXXXX-X------------------------------XXX-----------------X--------------------------------X----
-------XXXXX---X----------->----------------XXXXXX--X-------------------------------------XX---------XX----------------------------X--------
------XXXXXX----X----------]------XXXX-----XXXXXXX---X----------------------------------------------XXS-------------------------------------
-----XXXXXXX-----X---------]----XXX---X--XXXXXXXXX----X-----------------------------XXXXX---------XXX-------XXXXX---------------------------
--XXXXXXXXXX------X-------[]---XX<>----XXX<>XXXXXX-----X-------------------XXXX----XXXXX-X-------XX<>------XXXXXX---------------------------
XXX--XXXXXXX-------X----------XX-[]----EX-[]XXXXXX------X-------------------------XX------X-----XX-[]-----XXXXXXX-----------XXX-------------
X<>-XXXXXXXX--------X--------XX--[]---<>>-[]XXXXXX-------XXX---------XXX---XXX---XX--------X---XX--[]----XXXXXXXX---XXX---------------oooooo
-[]XXXXXXXXX--------XXXXXXXXXX---[]---[]]X[]XXXXXX-------XX-XXXXXXXXXX--XXXX--XXXX----------XXXX---[]---XXXXXXXXX---------------------oooooo
XXXXXXXXXXXXXXXXXXXXXXXXXXXXXXXXXXXXXXXXXXXXXXXXXXXXXXXXXXXXXXXXXXXXXX--XXXX--XXXX--------XXXXXXXXXXXXXXXXXXXXXXXX--------------X-----XXXXXX