--------------------------------------------------------------------------------------------------------------------------------------------
--------------------------------------------------------------------------------------------------------------------------------------------
SSSSSSSSSSSSSSSSSSSSSSSSSSSS----------------------------------------------------------------------------------------------------------------
--------------------------------------------------------------------------------------------------------------------------------------------
------------------------------XXX--------------------------------Eooo---------------------------------------XXX--------XXXX-----------------
------E--------------------------------------XXX-----------------XXXXX-------------------XX----------------XX--X------XXXX-X----------------
------>---------------------------------------------------------------------------------XX-X------XXXX----XX----X----XXXXXX-X---------------
------]---------------------------------------------------------------XXX--------------XX---X----XX---X--XX------X--XXXXXXX--X--------------
------]------------------XXXXX-----SSSSS??--------------------XXXXXXXXX--X---------XXXXX-----X--XX-----XXX--------XXXXXXXXX---X----------XXX
X-----]----XXXX---------XXXXX-XXXX---------------------------XXXXXXXXXX---X-------XX-XXX------XXX------XXX---------XXXXXXXX----X--------XXQQ
-X---->---XXSS-X-------XXEXXX-XXX-X-------------------------XX-------------X-----XX-----------XXX-----E------------XXXXXXXX-----X------XX---
--X------XX-SS--X-----XXXXXXX------X------XXX---------XXXXXXX-----------o---X---XX-------------------<>-----------XXXXXXXXX------X----XX----
E-EXXXXXXX--SS---XXXXXXXXXXXX-------XXXXXXX--XXXXXXXXXX--XXXX----------XXX---XXXX--------------------[]----------XXXXXXXXXX-------XXXXX--X--
XXXXXXXXXXXXXX--XXXXXXXXXXXX-------XXXXXXXX--XXXXXXXXXX----------------------XXXX--------------------[]----------XXXXXXXXXXXXXXXXXXXXXXXXXXX