--------------------------------------------------------------------------------------------------------------------------------------------
--------------------------------------------------------------------------------------------------------------------------------------------
--------------------------------------------------------------------------------------------------------------------------------------------
--------------------------------------------------------------------------------------------------------------------------------------------
--------------------------------------------------------------------------------------------------------------------------------------------
---------------------------------------XX----------------------------------------------------------------XX---------------------------ESS?--
--------------------------------------XX-X----------------------------------S---------------------------XX-X--------------------------------
-XX----------------------------------XX---X----oooooo--------------------------------------------------XX---X----oooooo---------------------
XX-X---------oooo----------------XXXXX-----X-----XX------------------------------------------------XXXXX-----X-----XX-----------------------
X---XXX----------------E--------XX--XX------X---XX-X------------------------------------E---------XX--XX------X---XX-X----------------------
----<>-X-------------------E---XX---XXX------X-XX---X------------E------XXXXXX---------------E---XX---XXX------X-XX---X-----------E---------
----[]--X---------------------XX----XXXX------XX-----XXX---------------XX---X-X-----------------XX----XXXX------XX-----XXX------------------
X---[]---XXXXXXXXXXXXXXXXXXXXXXX----XXXXX-----<>-----XX-XXXXXXXXXXXXXXXXX---X--XXXXXXXXXXXXXXXXXXX----XXXXX-----<>-----XX-XXXXXXXXXXXXXXXXXX
XX--[]XXXXXXXXXXXXXXXXXXXXXXXXXX----XXXXXX----[]------XXXXXXXXXXXXXXXXXXX---X--XXXXXXXXXXXXXXXXXXX----XXXXXX----[]------XXXXXXXXXXXXXXXXXXXX