----------------------------------------------------------------XXXXXX----------------------------------------------------------------------
------------------------------------------------------------XXXXX----XXXXXXXXXXXXXXXXXXXXXXXXX--------------------------------------o-------
SSSSSSSSSSSSSSSSSS?SSSSSSSSSSSSSSSSSSSSSSSSS-----SSSSSSSS--XX--X-------SSSSSSSSSSSSSSSSSSSSSSS-------------------------------------XXX------
SSSSSSSSSSSSS------SSSSSSSSSSSSSSSS-------[]--------------XX---X--------------------------[]------------------------------------------------
SSSSSSSSSSSSS------SSSSSSSSSSSSSSSS-------[]-------------XX-------------------------------[]------------------------------------------------
SSSSSSSSSSSSS------SSSSSSSSSSSSSSSS-------[]------XXXXXXXX--------------------------------[]------------------------------------------------
----------------XXXXX---------------------[]------XSSSSSSS-X--------X---------------------[]----------X--EX---------------------------------
XXXXX------XXXXXX----X--------------------[]------XSSSSSS---------------------------------<>----------X---X---------------------------------
X----XXXXXXXE--<>-----X------XXXXXXX------[]---XXXXSSSSSS---------------------------------------X---X-X---X--------X-EE----X----------------
?----SSSSSSSS--[]------X--XXXX-<><>-X-----[]--XX--?SSSSSS--------------------------<>-----------XSSSX-XSS?X--------XSSSSSSSX---------------<
---------------[]-------XXXXXX-[][]--X----<>-XX-------S--S-------------------------[]----S-S-S----------------------------------------------
--<>-----------[]-------EEXXXX-[][]---X-----XX-----------S-----X-------oooooooo----[]----S-S-S-----------------XXX--------------------------
--[]-----------[]------E-XXXXX-[][]----XXXXXX------------S-------------oooooooo----[]----S-S-SXXXXXXXXXXXXXXXXXX--XXXXXXXXXXXXXXXXXXXXXXXXXX
XXXXXXXXXXXXXXXXXXX-XXXEXXXXXX-XXXXXXEXXXXXXX----XXXXXXXX--------------XXXXXXXXE---[]----S-S-SXXXXXXXXXXXXXXXXXX--XXXXXXXXXXXXEEXEXXXXXXXXXX