--------------------------------------------------------------------------------------------------------------------------------------------
--------------------------------------------------------------------------------------------------------------------------------------------
SSSSSSSS-SSSSSSS-----------SSSSSSSSSSSSSSSSSSSSSSSSSSSSSSSSSSSSSSSSSSSSSSSSSSSSSSS?SSSSSSSSSSSSSSSSSSSSSSSSSSSSSSSSSSSSSSSSSSSSSSSSSSSSSSSSS
----------------------------------------------SS--SSSSSS--SSSS------SSSS---------------------SSS--------------------------------------------
---------------------------E------------------SS--SSSSSS--SSSS--E---SSSS---------------------SSS--------------------------------------------
--------------------------SQ-----oooo-------SS--------SS---S----SS----------ooooooo----------------------------------------oooo-------------
----------------XXXX------------------------SS--------SS---S----SS--------------------------------------------------------------------------
-----------XXXXXXXX-X------SS--S-SSSS-S-----SS--------SS---S----SS----------SSSSSSS-------------------XXX----------------S-SSSS-S-----------
----------XXXXXXXXX--X----SSS--SoS--SoS-----SS----ooooSS---So??-SS---E------SSSSSSS-----------------XXX--X---------------SoS--SoS-----------
--XXXX---XXXXXXXXXX---X---SSS--SSS--SSS-----SSSS--SSSSSS---SSS--SS--SSSS---------------------SSS---XX<>---X------XXXX----SSS--SSS----XXX----
EXX---X-XXXXXXXXXXX----X----------------------SS-------------------EE------------------------SS---XX-[]----XXX--XXSS-X---------------->-X--X
XX-----XXXXXXXXXXXX-----X---------------------SS-----------------------XXXXX-----------------SS--XX--[]----<>-XXX-SS--X---------------]--XXX
XX-----XXXXXXXXXXXX-----EXXXXXXXXXXXXXXXXXXXXXXXXXXXXXXXXXXXXXXXXXXXXXXX----XXXXXXXXXXXXXXXXXXXXXX---[]--E-[]--X--SS---XXXXXXXXXXXXXXX]---X-
XX-----XXXXXXXXXXX--XXXXXXXXXXXXXXXXXXXXXXXXXXXXXXXXXXXXXXXXXXXXXXXXXXXX---XXXXXXXXXXXXXXXXXXXXXXXXXXXXXXXXXXXXX--XX--XXXXXXXXXXXXXXXXXXXXX-