--------------------------------------------------------------------------------------------------------------------------------------------
--------------------------------------------------------------------------------------------------------------------------------------------
-----------------------E---------------------------------------------?--------------------------------------------------------oo------------
---------o-----------------------------------------------------------------------XXX-----------------------------------?-----XXXX-----------
o------------------------------------------------------------------------------XXX--X-------------------------------------------------------
X------XX-XXXX------------------------------?SS-----------------------------XXXX-----X------------------------------------------------------
-X----XX-X-------------------------------------------------------------SS--XX--E------X-------------------------oooX-----E--------XXXX--o---
--X--XX---X---------------------------------------------------------------XXX--XX------X-----------------------------XXXXXX----XXXX----XXX-X
---XXX-----X-------------------------------------------------------SS----XXXX--XX-------X-------------------------------------XX---X--------
---XXX------X-------------------------------------------QQQQ------------XXXXX--XX--------X-----------------------XXXX-----oooXX-----X-------
-------------X--------------------------E----B-----------------B-------XXXXXX--XX---------X--------XX-----------XXXXXXXXXXXXXX-------X------
--------------X-------XXXX--------B----------b-------B--E------b-----XXXXXXXX--XX----------X-----XX-------XXXXXXX---XXXXXXXXXX--------X-----
oo-------------XXXXX-XXXX-XXXXXXXXXXXXXXXXXXXXXXXXXXXXXXXXXXXXXXXXXXXX-XXXXXX--XX-----------XXXXXXX------XX--XXXX----------------------XXXXX
XX------------XXXXXXXXXXXXXXXXXXXXXXXXXXXXXXXXXXXXXXXXXXXXXXXXXXXXXXXX-XXXXXXXXXX-XXXXXXX---XXXXXX-XXXXXXX----------------------------XXXXXX