--------------------------------------------------------------------------------------------------------------------------------------------
--------------------------------------------------------------------------------------------------------------------------------------------
-------------------------------------------------------S--------------------------------?---------------------------------------------------
XX------------------------------------------------------------------------------------------------------------------------------------------
--X---------------------------SSS----SSSS---------------------E------------------------------------------XXXXX------------------------------
---X-----S-------XQQ?QQX--------------------------SSSSSS----QQQQQQQ----------------------------XXXXX----XXXX--X-----------------------------
----X----S-------X-----X------------------------------------------------------------------SS--XX----X--XXXXX---X----------------------------
-----X-----------X-----X------X--------------------------------------------------------------XXX-----XXXXXXX----X---------------------------
S-----X--SSS-----XE-E--X------XEE-------X----------------------E----------------------SS----XXXX------XXXXXX-----X-----------E--------------
-------X-SSS-----XQQ-QQX------XSSSSSSSSSX--------XXXX------QQQQQQQQ--------XXX-------------XXXXX------XXXXXX------X------------XXXX---------
--------XSSS------------------------------------XX---X--------------------XXX-X---B-------XXXXXX-----XXXXXXX-------X----------XX<>-X--------
----------SS-----------E----------------XXXXX--XX-----X------------------XX-X--X--b-----XXXXXXXX----XXXXXXXX--------XX-------XX-[]--X-------
--------X-SSXXXXXXXXXXXXXXXXXXXXXXXXXXXXX----XXX-------XXXXXXXXXXXXXXXXXXX--X---XXXXXXXXX-XXXXXX---XXXXXXXXX--------X-XXXXXXXX--[]---XXXXXXX
XXX-----XXXXXXXXXXXXXXXXXXXXXXXXXXXXXXXXX----XXX------XXXXXXXXXXXXXXXXXXXXXXXXXXXXXXXXXXX-XXXXXXXXXXXXXXXXXXXXXXXXXXXXXXXXXXXXXXXXXXXXXXXXXX