---------------------------------------------------------------------XXX--------XXX---------XXXX--------------------------------------------
--------------------------------------------------------------------XX--X------XX--X-------XX---X-------------------------------------------
-------------------------------------------------------------------XX----X----XX----X-----XX-----X------------------------------------------
------------------------------------------------------------------XX------X--XX------X---XX-------X-XXX-------------------------------------
----------------------------------------------------------------XXX--------XXX--------XXXX---------XX--X------------------------------------
---------------------------------------------------------------XXXX--------XXX--------XXXX---------XX---X------------------XXXX-------------
--------------------------------------------------------------XXXXX--------XXX--------XXXX---------XX----X----------------------------------
-------------------------------------------------------------XXXXXX--------XXX--------XXXX---------XX-----X---------------------------------
------------------------------------------------------------XXXXXXX--------XXX--------XXXX---------XX------X--------------------------------
---------XXX-----------------------------------------------XXXXXXXXS-------XXX--------XXXX---------XX-------X-------------------------------
---------XB-X-----------------E---------------------------XXXXXXXXX--------XXX--------XXXX---------XX--------X-----XXX----------------------
XX------XXb--X--------------------------XXXXXX-----------XXXXXXXXXX--------XXX--------XXXX---------XX---------X---XXB-X-----------XXX-XXX---
E-XXXXXXX-BEE-XXXXXXXXXXXXXXXXXXXXXXXXXXXE-EE-XXXXXXXXXXXXXXXXXXXXX--------XXX--------XXXX---------XX----------XXXX-b--XXXXXXXXXXXX--XX--XXX
XXXXXXXXXXXXXXXXXXXXXXXXXXXXXXXXXXXXXXXXXXXXXXXXXXXXXXXXXXXXXXXXXXXXX------XXX--------XXXX---------XXXXXXXXX---XXXXXXXXXXXXXXXXXXXX--XX--XXX