--------------------------------------------------------------------------------------------------------------------------------------------
---------------------------------------------------XXXXX-XXXXX------------------------------------XX----------------------------------------
-------SSSSSSSSSSSSSSSS-------------SSS--[]SSSSSSSSSSSSSSSS---X----------------------------------XX-X---------------------------------------
XXXXX--SSSS------------------------------[]SSSSSSSSSSSSSSSS----XX-------------------------------XX---X----XXXXX---XXXX----------------------
E----X-SSSS------------------------------[]SSSSSSSSSSSSSSSS------X-XXXX-----o-------------------------XXXXX----X-XX---X---------------------
>-----XSSSS--------X----XX--XXXXX--------[]SSSSSSSSSSSSSSSS-------XX---X-----------------------SS-----SSSSS-----XX-----X--------------S-----
]------X---------------XX-XXX----X-------[]SSSSSSSSSSSSSSSS-------XX----X---------------------------------------<>------X-------------------
]-------X-------------XX--XXX-----X------[]SSSSSSSSSSSSSSSS--------------X------------------XXXXXX--------------[]-------X------------------
]-------oXXX------XXXXX------------X------]SSSSSSSSSSSSSSSS---------------XXXXX-----------XXX---X------SS-------[]--------X---ooo-----------
]------S?SS-X----XX-XXX-------------XXXXX-]SSSSSSSSSSSSSSSS---------------XXXX-XSSS------XX<>---S---------ES----[]S--------XXX--------S-----
]------SSS---X--XX-----------SSS-S--SSSSSSSSSSSSSSSSSSSSSSS---------------------X-------XX-[]------------<>-----[]---------<>-X-------------
]------SS-----XXX------------SSS-S--SSSSSSSSSSSSSSSSSSSSSSS--<>------------------X-----XX--[]------<>----[]--<>-[]---------[]--X------------
]--------E-EE--XX------------SSS-S--SSSSSSSSSSSSSSSSSSSSSSS--[]---------o---------XXXXXX---[]------[]----[]--[]-[]---------[]---XXXXXXXXXXXX
XXXXXXXXX-XXXXXXX---------XXXSSS-S--XXXXXXXXXXXXXXXXXXXXXXX--[]---------X-------XXXXXXXXXXXXXXXXXXXXXXXXXXXXXXXXXXXXXXXXXXXXXXXXXXXXXXXXXXXX