------------------------------------------------------------------------------------------------------XXX-----------------------------------
-------------------------------------------------------------------------------------XX--------------XX--X----------------------------------
------------------------------------------------------------------------------------XX-X------------XX----X-----XX--------------------------
XXXXX------------------------------------------------------------------------XX----XX---X----XXXX-XXX------X---XX-X-------------------------
X----X-----------------------------------------------------------------XX---XX-XXXXX-----XXXXX---X----------X-XX---X-XXX--------------------
>-----X-----------------------------------------------------E---------XX-X-XX--SSSSS-----SSSSS-S-S-----------XX-----XX--X-------------------
]------X-------------------------------------------------------------XX---XX------------------------E--------XX-----XX---X------------------
]-------X-----------XXXXXX-----oooo---------------------XXX-XXXXXXXXXX----<>-----------------------<>---------------------X-----------------
]--------X--XXX---XXX--X--X----oooo-------------------XXX--XX---X---<>----[]-----------------------[]----------------------X----------------
]---------XXXS-X-XXXX--X---X------------E------------XXXX--<>---S---[]----XXX----------------ES----[]-----------------------X---------------
]----------X----XXXXX--X----XXXXXXXXXXX<>-------E---XXXXX--[]-------[]----------E------E----<>--E--[]------------------------X--------------
]----------SS-SSXXXXX--X----XXXXXXXXXXX[]----------XXXXXX--[]-------[]---------<>-----<>----[]-<>--[]-------------------------X-------------
]--------X-SS-SSXXXXX--X----X----------[]---------XXXXXXX--[]-------[]---------[]-----[]----[]-[]--[]-------------------------XXXXXXXXXXXXXX
XXXXXXXXXXXXXXX-XXXXX--X----X----------XXXXXXXXXXXXXXXXXX--XXXXXXXXXXXXXXXXXXXXXXXXXXXXXXXXXXXXXXXXXXXXX---------------------XXXXXXXXXXXXXXX