--------------------------------------------------------------------------------------------------------------------------------------------
-----XX------XXX----------------------------------------------XXXXXXXXXXXXXXXXXXXXXXXXXXXXXXX-----------------------------------------------
----XX-XXXXXXXX-X------------SSSSSSSSSSSSSSSSSSSSSSSS--------XXSSSSSSSSSSSSSSSSSSSSSSSSSSSSSSSSSSSSS--SSSSSS------SSSSSSSSSSSSSSSSSSSSSSSSSS
---XX--XXXXXXX---X-------------[]----[]---------------------XX------------------------------------------------------------------------------
--XX---XXXX-------X------------[]----[]-------E--------XXX-XX--------------------------------------------------------------XXXXXXXXXXX------
--XS---XXXX--------X-----------[]----[]---QQQQQQ------XXXX-XSSS-----------E-----------------------------------------------XX--QQQ?QQQ-X-----
XXX----XXXX---------X----------<>----[]--------------XX---XX-------------<>-----------------------------o----------------XX------------X----
-X-----XXXX----------X---------------[]--------XXX--XX-----XS------------[]-------------------------XXXXX---------SS----XX------E-------X---
<>-----XXXX-----------X--------------[]--XXXXXXX--XXX------S-S-----------[]-------S-------------XXXXX--S-X--------SS--XXX-----SSSSSSS----X--
[]-----XXXX------------X-------------[]-XXSSSSSS--QQQ---------S-----E--SS[]SS---E----E-------X-XXXXXX-----XX------SS-XX<>--------------E--X-
[]-----XXXX-------------X------------<>XX-SSSSSS-------------------<>----[]----<>---<>--------XX]XXXXXX--XX-XX------XX-[]-------X------X---X
[]-----XXXX--------------X----XXX-----XX--SSSSSS-------------------[]----[]----[]---[]---------X]XXXXXX--XXXX-X----XX--[]-------X------X----
[]-----XXXX-------------X-XXXXX--XXXXXX---SSSSSS-------------------[]-E--[]----[]---[]--------X-]XXXXXXE-XXXX--XXXXX---[]----E--X------X----
XXXXXXXXXXXXXXXXXXXXXXXXXXXXXXX--XXXXXXE--XXXXXXXXXXX------XXXXXXXXXXXXXXXXXXXXXXXXXXXXXXXXXXXXXXXXXXXXXXXXXXXXXXXXXXXXXXXXXXXXXXXXXXXXXXXXX