--------------------------------------------------------------------------------------------------------------------------------------------
--------------------------------------------------------------------------------------------------------------------------------------------
--------------[]SSSSSSSSSSSSSSSS------------------------------------------------------------------------------------------------------------
--------------[]SSSSSSSSSSSSSSSS------------------------------------------------------------------------------------------------------------
--------------[]SSSSSSSSSSSSSSSS------------------------------------------------------------------------------------------------------------
XXXX----------[]SSSSSSSSSSSSSSSS--------------------------------------------------------------SSSSSSSSSSSSSSS-------------------------------
]-------------[]SSSSSSSSSSSSSSSS--------------------------------XX--------------------------------------------------------------------------
]-------------[]SSSSSSSSSSSSSSSS-------------------------------XXX----------------------------------XXXXXXX-----<>------<>------------------
]--------XX----]SSSSSSSSSSSSSSSS------------------------------XXXX-----------------XXX----------XXXXXSSSSS-X----[]------[]------------------
]-------XX-XXX-]SSSSSSSSSSSSSSSS-------E--EE-----------------XXXXX----------------XX--X-------XXXSSSS-------X--QQQQQQ---QQQQQ-------------XX
>------XX---XSSSSSSSSSSSSSSSSSSS------<>--<>----------------XXXXXX------?--B-----XX----X-----XX<>------------X----------------------------XB
XX----XX---SSSSSSSSSSSSSSSSSSSSS--<>--[]--[]-------Q-------XXXXXXX---------b----XX------XXX-XX-[]-------------X-XXXXX---XXXXX---XXX------XXb
E-XXXXX----XSSSSSSSSSSSSSSSSSSSS--[]--[]--[]--------------XXXXXXXX--------XXXXXXX-------XX-XX--[]------E---EE--XX----XXXX----XXXXE-XXXXXXX-B
X-XXXXX---XXXXXXXXXXXXXXXXXXXXXX--[]--[]--[]-------------XXXXXXXXX-------XXXXXXXX-------XXXXXXXXXXXXXXXXXXXXXXXXX-X-XXXXX-X-XXXXXXXXXXXXXXXX