--------------------------------------------------------XXXXX-------------------------------------------------------------------------------
-------------------------------------------------------XX----X------------------------------------------------------------------------------
SSSSSSSSSSSSSS?SSSSSSSSSSSSSSSSSSSSSSSSSSSSSSSSSSSSSS-XX--------------------------XXXX------------------------------------------------------
SSSS-------------------------------------------------XX----------------------------[]---------XXXXX-----------------------------------------
SSSS------------------------------------------------XX-------X---------------------[]-------XXX----X-------------------------------------ooo
---------oooooo----------QQQ?QQQQQQQQ?QQQQ---------XXX--------X--------------------<>------XX<>-----X------------------------------------ooo
---------------------------------------[]---------XXXX------X--XX-------------------------XXX[]------X--------------------------------------
---------SSSSSS------------------------[]--------XXXXX------------------------------------XXX[]-------X-----------XXXXXX-----oooo--------XXX
-E-------SSSSSS------------------------[]-------XXXXXX----------------------------------XXXXX[]--------X--XXX---XXX--X--X----oooo-------XX--
SSSS-----------------------SSSSSSSSSSS-<>------XXXXXXX?------------XXXX-----------XXXX-XX<>XX[]---------XXXS-X-XXXX--X---X------------EXX---
E---------------------------------------------XXXXXXXX------------XX---XX--------XX---XXX[]XX[]----------X----XXXXX--X----XXXXXXXXXXXXXX----
---XXXXXX-----------------E---E--------XXX---XXXXXXXXX-----------XX---<>-X------XX---<>XX[]XX[]----------SS-SSXXXXX--X----XXXXXXXXXXXXXX----
XXXX-----XXXXXXXXXXXXXXXXXXXXXXXXXXXXXXXE-XXXXXXXXXXXX----------XX----[]--XXXXXXX----[]XX[]XX[]--------X-SS-SSXXXXX--X----X------------X----
XXXX----XXXXXXXXXXXXXXXXXXXXXXXXXXXXXXX<>-XXXXXXXXXXXXXX-------XX-----XXXXXXXXXXX----[]XXXXXXXXXXXXXXXXXXXXXX-XXXXX--X----X------------X----