--------------------------------------------------------------------XXXXXX------------------------------------------------------------------
------E-------------------------------XXXXXXXXXXXXXXXXXXXXXXXXXXXXXXX-XXX-XXXXXXXXXXXXXXXXXXXXXXXXXXXX--------------------------------------
SSSSSSSSSSSSSSSSSSSSSSSSSSSSS--------XXSSSSSSSSSSSSSSSSSSSSSSSSSSSSSS-----SSSSSSSSSSSSSSSSSSSSSSSSSSSS--------------------------------------
SSSSSSSSSSSSSSSSSSSS----------------XX------------------------------------SSSSSSSSSSSSSSSS--------------------------------------------------
SSSSSSSSSSSSSSSSSSSS-----------XXX-XX-------------------------------------SSSSSSSSSSSSSSSS--------------------------------------------XXXX--
SSSSSSSSSSSSSSSSSSSS--QQ------XXXX-XSSS------------E----------------------SSSSSSSSSSSSSSSS-----E-------------------------------------XXXX-X-
-----------------------------XX---XX--------------<>----------------------S-------------------<>----------------------------E-------XXXXX--X
XX-----------------XXX-XXX--XX-----XS-------------[]----------------------S-------------------[]-----------------------------------XXXXXX---
?-XXXXXXXXXXXXXXXXXX--XX--XXX------S-S------------[]------E----------------?oooooooooo--------[]----------------------------------XXXXXXX---
??SSSSSSSSSSSSSSSSSS--QQ--QQQ---------S------E--SS[]SS---<>----------------??SSSSSSSSS----XX--[]---------------------------------XXXXXXXX--S
--SSSSSSSSSSSSSSSSSS------------------------<>----[]-----[]---------XX-----]-------------XXX--[]----SS---------------E----------XXXXXXXXX---
--SSSSSSSSSSSSSSSSSS------------------------[]----[]----[[]--------XXXXXX--]------------XXXX--[]----SS-------------------------XXXXXXXXXX---
ooSSSSSSSSSSSSSSSSSS------------------------[]-E--[]X---[]]-------XXXX-----]------EE---XXXXX--[]----SSXXXXXXXXXXXXXXXXXXXXXXXXXXXXXXXXXXX---
XXXXXXXXXXXXXXXXXXXXXXXXXXXXX------XXXXXXXXXXXXXXXXXXXXXXXXXXXXXXXXXX-----XXXXXXXXXXXXXXXXXXXXXXX---XXXXXXXXXXXXXXXXXXXXXXXXXXXXXXXXXXXXXXXX