------------------------------------XXXXXX--------------------------------------------------------------------------------------------------
--------------------------------XXXXX----XXXXXXXXXXXXXXXXXXXXXXXXX--------------------------------------------------------------------------
SSSSSSSSSSSSS-----SSSSSS-SSSS--XX--X-------SSSSSSSSSSSSSSSSSSSSSSS--------------------------------------------------------------------------
-----------[]-----------------XX---X--------------------------[]----------------------------------------------------------------------------
-----------[]----------------XX-------------------------------[]---------------------------------------------------------XXXXX--------------
-----------[]------XXXXXXXXXXX--------------------------------[]--------------------------------------------------------XXXXX-X-------------
-----------[]------XSSSSSSSSSS-X--------X---------------------[]----------X--EX------------oo--------------oooo--------XX-XXX--X------------
-----------[]------XSSSSSSSSS---------------------------------<>----------X---X----------------------------------------X-XXXX---X-----------
-XXXX------[]---XXXXSSSSSSSS----------------------------------------X---X-X---X--------X-EE------------XXXX-----------XX-XXXX----X----------
XX<>-X-----[]--XX--?SSSSSS----------------------------<>------------XSSSX-XSS?X--------XSSSSSS--------XX<>-X---------XXXXXXXX-----X------SSS
X-[]--X----<>-XX--------------------------------------[]-----S-S-S-----------------------------------XX-[]--X-------XX-XXXXXX------X--------
--[]---X-----XX--------------------X-------oooooooo---[]-----S-S-S-----------------XXX--------------XX--[]---X-----XX--XXXXXX-------XX------
E-[]----XXXXXX-----------------------------oooooooo---[]-----S-S-SXXXXXXXXXXXXXXXXXX--XXXXXXXXXXXXXXX---[]----XXXXXX---XXXXXX-------X-XXXXXX
XXXXXXEXXXXXXX----XXXXXXXXXXX--------------XXXXXXXX---[]-----S-S-SXXXXXXXXXXXXXXXXXX--XXXXXXXXXXEXXXXXXXXXXXXXXXXXXXXXXXXXXXXXXXXXXXXXXXXXXX