--------------------------------------------------------------------------------------------------XXX--------XXX---------XXXX-------XXX-----
-------------------------------------------------------------------------------------------------XX--X------XX--X-------XX---X-----XX--X----
SSSSSSSS-----------------------------------------------------------------------------------------X----X----XX----X-----XX-----X---XX----X---
SSSSSSSS----------------------------------------------------------------------------------------XX-----X--XX------X---XX-------X-XX------X--
SSSSSSSS--------------------------------------------------------------------------------------XXX-------XXX--------XXXX---------XX--------XX
SSSSSSSS-------------------------------------------------------------------------------------XXXX-------XXX--------XXXX---------XX--------XX
--------------------------------------------------------------------------------------------XXXXX-------XXX--------XXXX---------------------
-------------------------------------------------------------------------------------------XXXXXX-------XXX--------XXXX---------------------
XXXXXXXXX---------X-X-------------------------------------------------XXXX----------------XXXXXXX-------XXX--------XXXX---------------------
??SSSSSS-X--------XX-X-----------------------------------------------XXX--X--------------XXXXXXXXS------XXX--------XXXX---------------------
----------X------XXB--X---------------XXXooo---XXXX-----------------XX-X---X------------XXXXXXXXX-------XXX--------XXXX---------------------
B----------X----XX-b---X-----------------------------XXX------XXXX-XX--X----X----------XXXXXXXXXX-------XXX--------XXXX---------------------
b-----------XXXXX--BEE--XXXXXXXXXXXXXXXXXXXXXXXXXXXXXX--XXXXXXX---XX--EX-----XXXXXXXXXXXXXXXXXXXX-------XXX--------XXXX---------------------
XXXXXXXXXXXXXXXXXXXXXXXXXXXXXXXXXXXXXXXXXXXXXXXXXXXXXX--XXXXXXX--XXXXXXX-----XXXXXXXXXXXXXXXXXXXXXX-----XXX--------XXXX---------------------