-------------------------------------------------------------------------------------------------XXXX--------XXX-----------------XXX--------
--------------------------------------------------------X--------------------------------------XXX---X-----XXX--X-------XXX-----XX--X------X
SSSS--[]SSSSSSSSSSSSSSS---------------------------------S--------------------XXX-----XXXX-----XX------X---XX-----X-----XX--X---XX----X----XX
------[]SSSSSSSSSSSSSSS-------------------XXXXXXXXXXXX--S-------------------XX--X---XX---X---XX--------X-XX-------X---XX----X-XX------X-SXX-
------[]SSSSSSSSSSSSSSS------------------XX-------------S------------XXX---XX----X-XX-----XXXX----------XX---------X-XX------XX--------XXX--
------[]SSSSSSSSSSSSSSS-----------------XXX-------------S-----------XX--X-XX------XX------XXXX----------XX----------XX-------XX--------XXX--
------[]SSSSSSSSSSSSSSS----------------XXXX-------------S----------XX-E--XX-------XX------XXXX----------XX----------XX-----------------XXX--
------[]SSSSSSSSSSSSSSS---------------XXXXX-------------S---------XX-----XX---------------XXXX----------XX-----------------------------XXX--
-------]SSSSSSSSSSSSSSS--------------XXXXXX-------------S-----XXXXX-----------------------XXXX----------XX-----------------------------XXX--
XXXXXX-]SSSSSSSSSSSSSSS--------E----XXXXXXX-------------S-S--XX-XXX-------o---------------XXXX----------XX-----------------------------XXX--
XSSSSSSSSSSSSSSSSSSSSSS---E---<>---XXXXXXXX-----<>------S-S-XX------------o--XX-----------XXXX----------XX-----------------------------XXX--
>SSSSSSSSSSSSSSSSSSSSSS--<>---[]--XXXXXXXXX-----[]------S-SXX-----------------------------XXXX----------XX-----------------------------XXX--
]SSSSSSSSSSSSSSSSSSSSSS--[]---[]-XXXXXXXXXX-----[]------S-XX------------------------------XXXX----------XX------------------o----------XXX--
XXXXXXXXXXXXXXXXXXXXXXX--XX---XXXXXXXXXXXXXXXXXXXXXXXXXXXXXX------------------------------XXXX----------XXXXXXXXX-----------X----------XXX--