--------------------------------------------------------------------------------------------------------------------------------------------
-----------------------------------------------------------------XXXXX----------------------------------------------------------------------
--------------------------------------oo------------------------XX----X------------------------ooo-----------------------SSSS---------------
---------------------------------------------------XXX-----XXX--XQ-----XXX---------------------XXXX-----------------------------------------
---XXXXX----------------------------------------XXXX-oXoooXX--XXX-----XXX-X-------------XXXX-----------------------------------XXXXXXXXX----
E-XXXXX-X-----------------------------XXX------XX-XX---X-XX----X-----------X-----XXoo--XXXX-X---------------------------------XX-XXXXXX-X---
-XXXXXX--X------------------------------------XX--------XX-----XX-----------X---------XX-----X-------------------------------XX----------X--
XXXXXXX---X----------------------------------XX---------XX-------------------X--XXXXXXX-------X-----------------------------XX------------X-
XXXXXXX----X----------------------------XXXXXX--------------------------------XXX----X---------X----XXXX------ooooXXXXXXXXXXX--------------X
>XXXXXX-----X------------------XXXX----XXXXXXX-----------------------------XXXXXX----XX-----XX--XXXXXX-----------XX--XXXXXXXX---------------
]XXXXXX------X------------------------XX-------------------------------------------------------XXXXXX-X---------XX-----------------------XX-
]XXXXXX-------XXX--------XXX---XXX---XX--------------------XXXXX---------------------------------------X-------XX---------------------------
]XXXXXX-------XX-XXXXXXXXX--XXXX--XXXX------------------------------------------------------------------XXXXXXXX----------------------------
XXXXXXXXXXXXXXXXXXXXXXXXXX--XXXX--XXXX---------XXXX--XXXX----------------------------------------------XXXXXXXXX-XXXX-----------------------