--------------------------------------------------------------------------------------------------------------------------------------------
------------------------------------------------------------------------------------XX------------------------------------------------------
-----------------------------------------------------------------------------------XX-XXX-------------------------------------------------?-
----------------------------------------------------------------------------------XX--XX-X--------------------------------------------------
-------XXXXXXXXXXX-----------------------------XX--XXX---------------------------XX---XX--X-------------------------------------------------
------XX---X---XX-X------------E--------------XX-XXX--X-------------------------SXS---XX---X--------------------Q---------------------------
-----XX-E--E---[]--X----------<>-------------XX---<>---X-------------------------X----XX----X-----------------------------------------------
---XXX---------[]---X---------[]----XXXXXXXXXXE---[]----X--------------------XXXXX----XX-----X----------------------------------------------
--XX-E---------[]----X--------[]--XXX----X---<>---[]-----X-----------------XXX---X----XX------X-----------------------------------------SS--
-XX------------[]-----XX---------XX<>---SS---[]---XX------X--------SSS----XX<>---SS---XX-------X--------------S?SQS------------XXX----------
XX-------------<>-----B-X-------XX-[]--------[]------------X-------------XX-[]--------XX--------X--------QQ----------XXXX-----XXX-X--B------
X---------------------b--X-----XX--[]--------[]-------------XX----------XX--[]--------XX---------X------------------XX<>-X---XX-X--X-b----XX
X---------------E-----B---XXXXXX---[]--------[]-------------X-XXXXXXXXXXX---[]--------XX--------X-XXXXXXXXXXXXXXXXXXX-[]--XXXX--X---XXXXXXX-
X-------------XXXXXXXXXXXXXXXXXXXXXXXXXXXXXXXXXXXXXXXXXX----XXXXXXXXXXXXXXXXXXXXXXXXXXXXXXXXXXXXXXXXXXXXXXXXXXXXXXXXXXXXXXXXXXXXXXXXXXXXXXX-