------------------XXXX----------------------------------------------------------------------------------------------------------------------
-------------------X-<XXXXXXXXXXXXXXXXXXXXXXXXXXXXX---XX------------------------------------------------------------------------------------
SS[]SSSSSS------------SSSSSSSSSSSSSSSSSSSSSSSSSSSSS-SSSSSSSSSSSSSSSSSSSSSSSSSSSSSSS?SSSSSSSSSSSSSSSSSSSSSSSSSSSSSSSSSSSSSSSSSSSSSSSSSSSSSSSS
S-[]SSSSSS------------SSS----------------------[]-------SS--SSSS------SSSS------------------------------------------------------------------
S-[]SSSSSS------------SSS----------------------[]-------SS--SSSS--E---SSSS------------------------------------------------------------------
S-[]SSSSSS------------SSS--------E-------------[]-------SS---S----SS----------oooooo--------------------------------------------------------
S-[]SSSSSS------------------<---<>-------------[]-------SS---S----SS------------------------------XX----------------------------------------
S-[]SSSSSS------------------[---[]-------------<>-------SS---S----SS----------SSSSSS-------------XX-X-XXX-----------------------------------
S--]SSSSSS-------------E----[---[]------------------ooooSS---So??-SS---E------SSSSSS------------XX---XX--X----------------------------------
XX-]SSSSSS------------->---?SES-[]S-----------------SSSSSS---SSS--SS--SSSS--------------------XXX----<>---X------XXXX---------XXXX---------X
SSSSSSSSSS---E---------]----->--[]----SSS-----S-S-S------------------EE----------------------XX<>----[]----XXX--XXSS-X-------XXSS-X-------XX
SSSSSSSSSS--<>---------]-----]--[]----SS------S-S-S----------------------XXXXX--------------XX-[]----[]----<>-XXX-SS--X-----XX-SS--X-----XXX
SSSS-SSSSS--[]---------]-----]--[]------------S-S-SXXXXXXXXXXXXXXXXXXXXXXX----XXXXXXXXXXXXXXX--[]----[]--E-[]--X--SS---XXXXXX--SS---XXXXXXXX
XXXXEXXXXX--XX---XXXXX-XXXXXXXXXXXXXXXXXX-----S-S-SXXXXXXXXXXXXXXXSXXXXXXX---XXXXXXXXXXXXXXXXXXXXXXXXXXXXXXXXXXX--XX--XXXXXXX--XX--XXXXXXXXX