--------------------------------------------------------------------------------------------------------------------------------------------
--------------------------------------------------------------------------------------------------------------------------------------------
[-------------------------------------------------------------------------------------------------------------------------------------------
-----------------------------------------------------------------------------------------------------------------------oo-------------------
----------------------------------XXXXX------------------------------------------------XXXXX------------------------------------------------
---------------------------------XXXX--X----------------------------------------------XXXXX-X------------------------SSS-------E------------
XXXXXXXXX-----------------------XXXXX---X--------------------------------------------XX-XXX--X--------------------------------<>------------
SSSSSSSS-X---------------------XXXXXX----X------------------------------------------XX--XXX---X-------------------XXXXXXXXX---[]-----------X
SSSSSSS---X----XX-------------XXXXXXX-----X---------------------XXXX---------------XXXX-XXX----X----------------XXX---X----XX-XXX--------XXX
SSSSSSS----X--XX-X---------XXXXXXXXXX------X-------------------XX<>-X-------------XXXXX-XXX--S--X-------SSS----XX<>---S---<>-X----------XX<>
SSSSSSS-----XXX---X------XXX--XXXXXXX-------X-----------------XX-[]--X-----------XXXXXX-XXX------X------------XX-[]-------[]--X-XXXX---XX-[]
SSSSSSS<>----X-----X----XX<>-XXXXXXXX--------XX--------------XX--[]---X-----XXXXXXXXXXX-XXX-------XXX--------XX--[]-------[]---XX<>-X-XX--[]
SSSSSSS[]---<>------XXXXX-[]XXXXXXXXX--------X-XXXXXXXXXXXXXXXE--[]----XXXXXX---XXXXXXX-XXX-------XX-XXXXXXXXX---[]----E--[]----X[]--XX---[]
XXXXXXX[]---[]---XXXXXXXXXXXXXXXXXXXXXXXXXXXXXXXXXXXXXXXXXXXXXXXXXXXXXXXXXXXX--XXXXXXX--XXXXXXXXXXXXXXXXXXXXXXXXXXXXXXXXXXXXXXXXXXXXXXXXXXXX