-------------------------------------------------------X------------------------------------------------------------------------------------
--------------------------------------------------------------------------------------------------------------------------------------------
--------------------------------------XXXX-----------------E------SSSSSSSSSSSSSSSS------------------------XXX-------------------------------
-------------------------------------XX---X--------------------------------------------------------------XX--X--------------------XXXXXXX---
----------E-------------------------XX-----X----XXXXX-------------------------------XXX-----------XXX---XX----X--------------XXXXXX---X--X--
---------SQS--SQS------------------XX-------X--XXXXX-X-----------------------------XX--X-XXX-----XX--X-XX------X------------XXXXXXX---?---X-
XXX------------------------------XXX---------XXXXXXX--X---------------------------XX-E--XXX-X---XX-E--XX--------X-----------X--------------X
XX-X-----------------------o-----XXX----------XEXXXX---X-------------------------XX-----XX---X-XX-----XX---------XX--------XX---------------
XX--X-----------------------E----XXX----------XXXXXX----X-------------------XXXXXX------------XX-----------------E-XXXXXXXXX----------------
XX---X---SQS--S?S--------SSSSS--XXXX---------XXXXXXX-----X------------------X-XXXX-------o--XXXX-------o-----XXXXXXXXXXXXXXXXX----XXXEX-----
XX----X---------------E--E-----XXXXX-------EXXXXXXXX------X----------------XX------------o-------------o--XX--------------------------------
XX-----X---------------------EXXXXXX-------XXXXXXXXX-------XXX--------XXX-XX----------------------------------------------------------------
XX-----EXXXXXXXXXXXXXXXXXXXXXXX-XXXX------XXXXXXXXXX-------XX-XXXXXXXXX--XX-----------------------------------------------------------------
X--XXXXXXXXXXXXXXXXXXXXXXXXXXXXXXXXX---XXXXXXXXXXXXXXXXXXXXXXXXXXXXXXXX--XX-----------------------------------------------------------------