--------------------------------------------------------------------------------------------------------------------------------------------
--------------------------------------------------------------------------------------------------------------------------------------------
SSSSSSSSSSSSS-S?SSSSSSSSSSSSSSSSSSSSSSSSSSSSSSSSSSSSSSSSSSSSSSSSSSSSSSSSSSSSS---------------------------------------------------------------
-------------------------------------SSSSSSSSSSSSSSSSSSSSSSS--SSS---------------------------------------------------------------------------
-------------------------------------SSSSSSSSSSSSSSSSSSSSSSS--SSS---------------------------------------------------------------------------
-------------------------------------SSSSSSSSSSSSSSSSSSSSSSS--S-----------------------------------------------------------------------------
---------------XXXXX--------------------------o-----------------------------------------------------------------------------------E---------
-----------XXXXX----X-----------------------XXXXXXXXXXX-------S---------------------------------------------------------QQQ------<>---------
----------XXXXXX-----XX-SSS----------XXXXXXXX?-?SSSSSS-X------So??-----XEE----X----------X--Eo--------------oo-------------------[]---------
-XXXXX---XXXXXXX----<>-X------------XX-SSSSS------------XX----SSS------XSSSSSSX----------X-SSX-------------ooo----------------QQQQQQQQQQ----
XX----X-XXXXXXXX----[]--X----------XX--SSSSSoooooooo---<>-X------------------------------------------------o--------------------------------
XX-----XXXXXXXXX----[]---X----XXX-XX---SSSSS-----------[]--X------XXX-----------------------------------------------------XXXXX-------------
XX-----XXXXXXXXX----[]----XXXXX--XX---------oooooooo---[]---XXXXXXX--XXXXXXXXXXXXXXXXXXXXXXXXXXXXXXXXXXXXXXXXXXXXXXXXXXXXXXB---XXXXXXXXXXXXX
X------XXXXXXXXX--XXXXXXXXXXXXX--XX---XXXXXXXXXXXXXXXXXXXXXXXXXXXXX--XXXXXXXXXXXXXEEXEXXXXXXXXXXEEXEXXXXXXXXXXXXEEXEXXXXXXXX--XXXXXEEXXXXXXX