--------------------------------------------------------------------------------------------------------------------------------------------
--------------------------------------------------------------------------------------------------------------------------------------------
--------------------------------------------------------------------------------------------------------------------------------------------
--------------------------------------------------------------------------------------------------------------------------------------------
--------------------------------------------------------------------------------------------------------------------------------------------
------------------------------------SSSSSQSS-------------------------------------------------------------QQQQ-------------------------------
--------------------------------------------------------------oooo----------oooo------------oooo-------------------------------------XXX----
----------------------------------------------------------------------------------------------------------------------------------XXXX--XX--
E-----------------------------------------------------------------------XXXX------------XXXX-------------------------------------XXXSS-SQ-X-
--XXXX-------------------XXX-----S---E---SSSS---QQ?QQ------XXX---------XX<>-X----------XX<>-X----------QQ?SSQQQ-----------------XXXXX------X
-XX<>-X-----------------XXX-X-----------------------------XXX-X-------XX-[]--X--------XX-[]--X------------------------XXXX-----XXXXXX-------
XX-[]--X--------------EXX-X--X---------------------------XX-X--X-----XX--[]---X------XX--[]---X----------XXX---------XX<>-X---XXXXXXX------S
X--[]---XXXXXXXXXXXXXXXX--X---XXXXXXXXXXXXXXXXXXXXXXXXXXXX--X---XXXXXX---[]----XXXXXXX---[]----XXXXXXXXXXX--XXXXXXXXXX-[]--XXXXXXXXXX--SSSSS
XXXXXXXXXXXXXXXXXXXXXXXX--XXXXXXXXXXXXXXXXXXXXXXXXXXXXXXXXXXXXXXXXXXXXXXXXXXXXXXXXXXXXXXXXXXXXXXXXXXXXXXXX--XXXXXXXXXXXXXXXXXXXXXXXX-------X