--------------------------------------------------------------------------------------------------------------------------------------------
-------------------------------------------------------------------------------------------------------------XX-----------------------------
------------------------------------------------------------------------------------------------------------XX-X----------------------------
-----------------------------------------------------------------------------------------------------------XX---X-----XXXXX-----------------
------------XXXXXXXXXXXXXX----------E-E-------------------------------------------------------------XXXXXXXX-----XXXXXX----X----------------
S----------XX--QQQ?QQQ?QQ-X-------SSSSSSS-SS-XXXXX---------------------XXXX-------XXX--------------XX-SSSSSS-----SSSSSS-----XXXX------------
----------XX---------------X-------------E--XX-<>-X--------------------X<>-X-----XX--X------------XX-------------------------X--X-----XXXX--
---------XX------E---E------X--------------XX--[]--X-------------------X[]--X---XX----X-XXXXXXXXXXX-------------------------<>---X---XX---X-
-------XXX-----SSSSSSSSSS----X-----------XXX---[]---X------------E----XX[]---X-XX------XX----X---<>-------------------------[]----X-XX-----X
S-----XX<>-----------------E--X---------XX<>--QQQ?---X---------------XXS[]-S?-XX-------<>---SS---[]---S------X----S---ES----[]-----XX------<
-----XX-[]-------X---X-----X---X---E---XX-[]------<---X------oo-----XX--[]----<>-------[]--------[]---------XX-------<>---E-[]-----<>------[
----XX--[]-------X---X-----X----X-----XX--[]------[----X-----oo----XX---[]----[]-------[]--------[]--------XXX-------[]--<>-[]-----[]------[
XXXXX---[]----E--X---X-----X-----XXXXXX---[]------[-----XXXXXXXXXXXX----[]----[]-------[]--------[]----E--XXXX-------[]--[]-[]-----[]------[
XXXXXXXXXXXXXXXXXXXXXXXXXXXXXXXXXXXXXXXXXXXX------X---XXXXXXXXXXXXXXXXXXXXXXXXXXXXXXXXXXXXXXXXXXXXXXXXXXXXXXXXXXXXXXXXXXXXXXXXXXXXXXXXXXXXXX