--------------------------------------------------------------------------------------------------------------------------------------------
X-----------------XX----------------------------------------------------------------------------------------------------X-------------------
X-X--------------XX-XX----------------SSSSSSSSSSSSSSSSSSSSSSSSSSSSSSSSSSQ<>SSSSSSSSSSSSSS-------------------------------SX------------------
---XXXX---------XX----X-------------------------[]----[]-----------------[]SSSSSSSSSSSSSS------------------XXXXXXXXXXX----X-----------------
----X--X-------XX------XXX----------------------[]----[]-------E---------[]SSSSSSSSSSSSSS-----------------XX---------------X----------------
----S---X-----XX----E---X-X---------------------[]----[]---QQQQQQ--------[]SSSSSSSSSSSSSS----------------XXX----------------X----------SSSS-
---------X----X----<>XXXX--X--------------------<>----[]-----------------[]SSSSSSSSSSSSSS---------------XXXX-----------------X--------------
----------X---X----[]XXXX---X-------------------------[]-----------------[]SSSSSSSSSSSSSS--------------XXXXX------------------X-------------
-E---------X--S---X[]XXXX----X------------------------[]--XXXXXXXXXXX-----]SSSSSSSSSSSSSS-------------XXXXXX------------S------X-----------X
X>----------X-S--XX[]XXXX-----X-----------------------[]-XXSSSSSSSSS-XXXX<]SSSSSSSSSSSSSS---E--------XXXXXXX------------S-------X---------XX
[]-----------XS-XXX[]XXXX------X----------------------<>XX-SSSSSSSSSSSSSSSSSSSSSSSSSSSSSS--<>----E--XXXXXXXX----<>------S--------X-------XX-
[]-------------XXXX[]XXXX-------XX---------XXX-XXX-----XX--SSSSSSSSSSSSSSSSSSSSSSSSSSSSSS--[]---<>-XXXXXXXXX----[]------S---------X-----XX--
[]-----------X-XXXX[]XXXXX------X-XXXXXXXXXX--XX--XXXXXX---SSSSSSSSSSSSSSSSSSSSSSSSSSSSSS--[]---[]-XXXXXXXXX----[]------S--------X-XXXXXX---
XXXXXXX------XXXXXXXXXXXXXXXXXXXXXXXXXXXXXXX--XX--XXXXXXE--XXXXXXXXXXXXXXXXXXXXXXXXXXXXXX--XXXXXXXXXXXXXXXXXXXXXXXXXXXXXX--------XXXXXXXXXXX