-------------------------------------------------------------------------XXX------------------XXX----------XXX------------------------------
------------------------------------------------------------------------XX--X-------XXX------XX--X--------XX--X-----------------------------
-XX---------------------------------------------------------------------X----X-----XX--X----XX----X------XX----X----------------------------
X>-XX-------------------------------------------------------------------------X---XX----X--XX------X----XX------X----XXX--------------------
-]---X----------------------------XXXX-----------------------------------------X-XX------XXX--------XXXXX--------XXXXX--X-------------------
->----X--------------------------XX---X---------------------------------X-------XX-------XXX--------XXXXX--------XXXEX---XX-----------------
-]-----X------------------------XX-----XXXXXXXXX-----------------------XX-------XX---------------------------------------S-X------------<---
XX------XX-----------------XX--XX-------XXXX----XX-----------XXXX-XXXXXX------------------------oo--------------------------X-----------[---
--------E-X----XX---------XX-XXX--------XXXX----E-X----XX---XX---XX---<>------------------------SS---------------------------X-----------XXX
----E--<>--X--XX-X-XXXXX-XX---<>-------XXXXX---<>--X--XX-X-XX----<>---[]-------S----------------------------------------------XSSS-----XXX-X
---<>--[]---XXX---XX----XX----[]------XXXXXX---[]---XXX---XX-----[]---[]-------------------------------------------------------X------XXX>-X
o--[]--[]----X----<>----<>----[]-----XXXXXXX---[]----X----<>-----[]---[]--------------------------------------------------------X----XX-X]-X
o--[]--[]---<>----[]----[]----[]----XXXXXXX-----]---<>----[]-----[]---[]----------------o---o------------------------------------XXXXX--X]-X
X--[]--[]---[]----[]----[]----XXXXXXXXXXXXX-----]---[]----[]---XXXXXXXXXXXXXX-----------X---X--------------XXXX----------------XXXXXXXXXXXXX