--------------------------------------------------------------------------------------------------------------------------------------------
--------------------------------------------------------------------------------------------------------------------------------------------
SSSSSSSSSSSSSSSSSSSSSSSSSSSSSSSS----------------------------------------------------oo------XXX----------------SSSSSSSSSSSSSSSSSSSS---------
SSSSSSSSSS----------------------------------------------------------------------------XXXXXXX--X--------------------------------------------
SSSSSSSSSS-------------X----------XXX------------------------------------Eooo--------XXXXXXXX---X---------ooo------------------------XXX----
SSSSSSSSSS---E----------XX-----------------------XXX---------------------XXXXX------XX-----------X--------XXXX------------------------------
-------S----->------------X--------------------------------------------------------XX-----------ooX-----------------------------------------
-------S-----]------------------------------E---------------------------------XXXXXX---------------X----------------------------------------
-------So??--Q---------------XXXXX-----SSSSS??------------------------XXXXXXXXX---XXXXX-------------X---------------------------XXXXX-----SS
?------SSS-------XXXX-------XXXXX-XXXX---------------------X---------XXXXXXXXXX----------------------XXXXXXXX-----XXXX---------XXXXX-XXXX---
X---------------XXSS-X-----XXEXXX-XXX-X-------------------XX--------XX-------------------------------XXXX?-<>X---XXSS-X-------XXEXXX-XXX-X--
-X------------XXX-SS--X----XXXXXX------X------XXX--------XX---XXXXXXX-----------o--------------------------[]-X-XX-SS--X-----XXXXXXX------X-
E-XXXXXXXXXXXXXX--SS---XXXXXXXXXX-------XXXXXXX--XXXXXXXXXXXXXX--XXXX----------XXX-------------------------[]-EXX--SS---XXXXXXXXXXXX-------X
XXXXXXXXXXXXXXXX--XX--XXXXXXXXXX-------XXXXXXXX--XXXXXXXXXXXXXX---------------------------------XXXX-----XXXXXXXXX-XX--XXXXXXXXXXXX-------XX