----------XXX-------------------------------------------------------------------------------------------------------------------------------
---------XX--X------------------------------------------------------------------------------------------------------------------------------
--------XX----X-----------------------------------------------------------------------------------------------------------------------------
--XXXXXXX------X-------------XXX------------------------------------------------------------------------------------------------------------
-XX----X--------X---------XXXX--X--------------------------------------------------------------------------------------XXX-------XXX--------
-XX----E---------X-------XX--X---X-----S------------------E---------------------------------------SSSSS---?-------XXX--X--X-----XX--X-------
XX----<>----------X-----XX--------X----S----------E------<>------------------------------------------------------XX--XXX---X---XX----X-----X
X-----[]-----------XXXXXXE---------X---------------------[]-----------------------------------------------------XX-----X----X-XX------X---XX
E-----[]------------X---<>----------X--SSS---------------[]----XXX---------------------------------------------XX-----SS-----XX--------XXXX-
>-----[]------------?---[]-----------X-SSS-----QQQ?QQQ--------XXX-X--------------------XXX-----S---E---------XXX------SS----XXXEXX-----XXXX-
]-----[]----------------[]------------XSSS-------------------XX-X--X------------------XXX-X-------------E---XX<>---------------------E------
Q-----[]----------------[]--------------SSX-----------------XX--X---X-----XXX-------EXX-X--X---------------XX-[]----------------------------
X-----[]------E---------[]------------X-SS-XXXXXXXXXXXXXXXXXX--EX----XXXXXX--XXXXXXXXX--X---XXXXXXXXXXXXXXXX--[]E---------------------------
X-----XXXXXXX<>XXXXXX---XXXXXXX-------XXXXXXXXXXXXXXXXXXXXXXXXXXXXXXXXXXXXX--XXXXXXXXX--XXXXXXXXXXXXXXXXXXXXXXXXXXXXXXXXX-------------------