--------------------------------------------------------------------------------------------------------------------------------------------
XXXXXXXXXXXXXXXXXXXXXXXXXXXXXXXXX-----------------------------------------------------------------------------------------------------------
SSSSSSSSSSSSSSSSSSSSSSSSSSSSSSSS-X-------E-----SSSSSSSSSSSSSSSSSSSSSSS-SSSSSSSSSSSSSSSSSSS?SSSSSSSSSSSSSSSSSSSSSSSSSSSSSS--------------SSS--
SS--------------------------------X-----------------------[]---------------SSSS-------------------------------------------------------------
SS---------------------------------X----------------------[]---------------SSSS-----------------------XXX-----------------------------------
SS----------------------------------X---------------Q-----[]---QQQ-------------E-----------------XXXXXX--X----------------XX---XXXXX--------
-------------------------------------X--------------]-----[]-----------E------------------------XXSSSSS---X--------------XX-XXXX----X-------
--------E-----------------------------X-------------]-----[]-------------------XXX-------------XX-SSSSS-----------------XX--XXXX-----X------
E------<>-------------------E-----------------------]-----[]--XXXXXXXXXXXXXXXXXX?-XXXXXXXXXXXXXX--SSSSS---oXXX------XXXXX-------------X-----
>---E--[]------------------<>------XXX-X-----------<>-----[]-XXSSSSSSSS?SSSSSSS???SSSSSSSSSSSSSS--SSSSS--S?SS-X----XX-XXX--------------XXXXX
]--<>--[]---------------XX-[]--XXX------X-----------------<>XX-SSSSSSSSS---SSS----SSSSSSSSSSSSSS---------SSS---X--XX------------SSS-S--SSSSS
]--[]--[]--------------XXX-[]--XXX-------XXX--------XX-----XX--SSSSSSSSS---SSS----SSSSSSSSSSSSSS---------SS-----XXX-------------SSS-S--SSSSS
]--[]--[]-------XX-E-E-XXX-[]--XXX-------XX-XXXXXXXXX-XXXXXX---SSSSSSSSS------ooooSSSSSSSSSSSSSS-----------E-EE--XX-------------SSS-S--SSSSS
XXXXXXXXX--XXXXXXXXXXXXXX--XX--XX------XXXXXXXXXXXXXX-XXXXXXE--XXXXXXXXXXXXXXXXXXXXXXXXXXXXXXXXXXXXXXXXXXXX-XXXXXXX---------XXXXSSS-S--XXXXX