--------------------------------------------------------------------------------------------------------------------------------------------
--------------------------------------------------------------------------------------------------------------------------------------------
--------------------------------------------------XXXX--------------------------------------------------------------------------------------
---------------------------------------------------[]---------XXXXX-------------------------------------------------------------------------
---------------------------------------------------[]-------XXX----X--------------------------------------oo--------------------------------
-----E---------------------------------------------<>------XX<>-----X-------------------------------------oo-----------------------------E--
----------------------------------------------------------XXX[]------X----------------------------------------------------------------------
----------------------------------------------------E-----XXX[]-------X-----------XXXXXX-----oooo---------XXX-----------XXX--------------XXX
--------------------------------------------------------XXXXX[]--------X--XXX---XXX--X--X----oooo--------XX-<>---------XX--X-----------XXX--
-----------------------------------XXXX-----------XXXX-XX<>XX[]---------XXXS-X-XXXX--X---X-------------EXX--b-X-------XX----X---------XX<>--
X---------------?QQ---------------XX---XX--------XX---XXX[]XX[]----------X----XXXXX--X----XXXXXXXXXXXXXXX------XXXXXXXX----S-X-------XX-[]--
-X-----------------------B-------XX---<>-X------XX---<>XX[]XX[]----------SS-SSXXXXX--X----XXXXXXXXXXXXXXX------XXXXXXXX-------X-----XX--[]--
E-XXX-XXXX--B------------b--XXX-XX----[]--XXXXXXX----[]XX[]XX[]--------X-SS-SSXXXXX--X----X-------------X------XXXXXXXXX-------XXXXXX---[]--
XX---XX---XXXXXXXXXXXXXXXXXXX--XX-----XXXXXXXXXXX----[]XXXXXXXXXXXXXXXXXXXXXX-XXXXX--X----X-------------X------X-------------XXXXXXXXXXXXXXX