--------------------------------------------------------------------------------------------------------------------------------------------
-XXXX----------------------------------------------------------------------------------------------------------------------------------XXXXX
XX---XX---------------------------------------------------------------------SSSSSSSSSSSSSSSSSSSSSSSSSSSSSSSSSSSSSSSSSSSSSSSSSS--------XXSSSS
X---<>-X----------------------------------------------------------------------------------SSSSSSSSSSSSSSSSSSSSSSSSSSS----------------XX-----
X---[]--X--------------------------------------------------XXXXX--------------------------SSSSSSSSSSSSSSSSSSSSSSSSSSS-----------XXX-XX------
X---XX---X------------------------------------------------XXXX--X-------------------------SSSSSSSSSSSSSSSSSSSSSSSSSSS--QQ------XXXX-XSSS----
X---------X----------------------------------------------XXXXX---X------------------------------------------------------------XX---XX-------
X----------X--------------------------------------------XXXXXX----X------------------------------XXX----------------XXX-XXX--XX-----XS------
S-----------X-------oo---------------------------------XXXXXXX-----X----------------------XXXXXXXX?-XXXXXXXXXXXXXXXXX--XX--XXX------S-S-----
X------------X---------XXX----------------------------XXXXXXXX---S--X--------------------XX-SSSSSS??SSSSSSSSSSSSSSSSS--QQ--QQQ---------S----
--------------X-------XXX-X---XXXX-------------------XXXXXXXXX-------X------------------XX--SSSSS---SSSSSSSSSSSSSSSSS-----------------------
------------X--X-----XX-X--X-XX<>-X-----------------XXXXXXXXXX--------XX--------XXX-XXXXX---SSSSS---SSSSSSSSSSSSSSSSS-----------------------
------------X---XXXXXX--X---XX-[]--XXXXXXXXXXXXXXXXXXXXXXXXXXX--------X-XXXXXXXXX--XX--X---------oooSSSSSSSSSSSSSSSSS-----------------------
XX----------XXXXXXXXXXXXXXXXXXXXX--XXXXXXXXXXXXXXXSXXXXXXXXXXXXXXXXXXXXXXXXXXXXXX--XX--X---XXXXXXXXXXXXXXXXXXXXXXXXXXXXXXXXXXX------XXXXXXXX