--------------------------------------------------------------------------------------------------------------------------------------------
--------------------XX--------------------------------------------XX------------------------------------------------------------------------
-------------------XX-X------------------------------------------XX-X-----------------------------------------------------------------------
------------------XX---X-----XXX--------------------------------XX---X---------------------------XXXXXXX--------------XX-------------------X
------------XXXXXXX-----XXXXXX--X-------------------------XXXXXXX-----X--------------------XXXXXXX---X--X------------XX-XXX---------XXXXXXXX
---------XXXX---XXX-----XXXXXXE--X---------------XXXX----XXXXXXXX------XXXX--------XXX----XXXXXXXX---?---X----------XX--XX-X-----XXXX----XXX
--------XXXXX---------------------X-------------E-------XX-------------XXX-X-------------XX---------------X------XXXX-------X---XX--X-------
-------XX--------------------------X-------------------XX-------------------X-----------XX-----------------X-XXXXXXXX--------X-XX-----------
---XXXXX----------------------------X-----------XX-XXXXX---------------o-o---XX--------XX-------------------XXooX-------------XX------------
--XX-XXX--------XXX------------------X---------XX-XX-XXX---------------o-o-XXX-X------XXXX-------XXXEX-----XXXEXX-------------XX---------XXX
-XX-----------------------------------XXXXXX--XX--XX----------------------------X----XX-----------------------------------------------------
XX-------------------------------------X----XXX----------------------------------X--XX---------------------------------------------XX-------
X------------------------------XXXXEXXEX----XXX-----------------------------------XXX-------------------------------------------------------
X------------------------------------------------------------------------------XXEXXXX------------------------------------------------------