------------------------------------------------------------------------------------XXX---------XXX--------XXX-----------------XXX---------X
-----------------------------------------------------------------XX-------XXX------XX--X-------XX--X------XX--X------XXX------XX--X-------XX
------------------------------------E---------------------------XX-X-----XX--X----XX----X-----XX----X----XX----X----XX--X----XX----X-----XX-
---------------------------------------------------------------XX---X---XX----X--XX------X---XX------X--XX------X--XX----X--XX------X---XX--
--------------------------------------------------------------XX-----X-XX------XXX--------XXXX--------XXX--------XXX------XXX--------XXXX---
----------------------------SSSSSSSS?S--------S----S--------XXX-------XX-------XXX--------XXXX--------XXX--------XXX------XXX--------XXXX---
----X----------E-------------[]----------------------------XX-S-------XX--------------------------------------------------------------------
-----QQQ------<>-------------[]---------------------------XX--------------------------oo-----------------------------------------oo---------
--------------[]-------------[]--------------XXXX--------XX---------------------------SS-----------------------------------------SS---------
-----------QQQQQQQQQQ--------[]-------------XX<>-X------XX-------X--------------------------------------------------------------------------
B----------------------------<>------------XX-[]--X----XXE-----------------------------------------------S----------------------------------
b------XXXXX-----------------XXX----------XX--[]---X--XX<>-----------------------------------------------S----------------------------------
XXXXXXXXB---XXXXXXXXXXXXXXXXXXE-XXXXXXXXXXX---[]----XXX-[]-----X--------------o---o----------------------S---------------o---o--------------
XXXXXXXXX--XXXXXEEXXXXXXXXXXXXXXXXXXXXXXXXXXXXXXXXXXXXXXXXXXXXXX--------------X---X--------------XXX-----S---------------X---X--------------