--------------------------------------------------------------------------------------------------------------------------------------------
-----------XXXX-----------------------------------------------------------------------------------------------------------------------------
S--<>SSSSSSSSSS-----------------------------------------------------------------------------------------------------------------------------
---[]SSSSSSSSSS-----------------------------------------------------------------------------------------------------------------------------
---[]SSSSSSSSSS------------------------------------------------------------------------------------------------XXXXX------------------------
---[]SSSSSSSSSS-----------------------------------------------------------E---------------------------------E-XXXXX-X-----------------------
---[]SSSSSSSSSS------------X--EX-----------------------------------------<>----------------------------------XXXXXX--X---------------------X
---[]SSSSSSSSSS------------X---X-----------------------------------------[]------XXXXX----XXXXX-------------XXXXXXX---X-------------------XX
----?SSSSSSSSSS-------X--X-X---X---------X-EE----X-------------ooo-------[]----XXX----X-XXX----X----------XXXXXXXXX----X-----------------XXX
XXX-ESSSSSSSSSS-------XSSX-XSS?X---------XSSSSSSSX-------------ooo-------[]---XX<>-----XX<>-----XX-------XX<>XXXXXX-----X----------------XXX
SSSSSSSSSSSSSSS--------------------------------------------------------------XX-[]----E<>[]----<>-X-----XX-[]XXXXXX------X------------------
SSSSSSSSSSSSSSS----------------------XXX------------------------------------XX--[]---<>[][]----[]--X---XX-X[]XXXXXX-------XXX--------XXX-XXX
SSSSSSSSSSSSSSSXXXXXXXXXXXXXXXXXXXXXXX--XXXXXXXXXXXXXXXXXXXXXXXXXXXXXXXXXXXXX---[]---[][][]----[]---XXXX-XX[]XXXXXX-------XX-XXXXXXXXX--XX--
XXXXXXXXXXXXXXXXXXXXXXXXXXXXXXXXXXXXXX--XXXXXXXXXXXXEEXEXXXXXXXXXXXXEEXEXXXXXXXXXXXXXXXXXXXXXXXXXXXXXXXXXXXXXXXXXXXXXXXXXXXXXXXXXXXXXX--XX--