--------------------------------------------------------------------------------------------------------------------------------------------
--------------------------------------------------------------------------------------------------------XX----------------------------------
-------------------------------------------------------------------------------------------------------XX-X---------------------------------
------------------------------------------------------------------------------------------------------XX---X----XXXXX-----------------------
---------------------------------------------XXXXX---------------------------------------------------XX-----XXXXX----X----------------------
------------------------------------------E-XXXXX-X-----------------------------SSSSS---?-------XXX--XS-----SSSSS-----XXXX------------------
-------------------------------------------XXXXXX--X-------------------------------------------XX--X-X-----------------X--X-----XXXX--------
--B------------XXXXX----XXXXX-------------XXXXXXX---X-----------------------------------------XX----XX----------------<>---X---XX---X-------
-XXX---------XXX----X-XXX----X----------XXXXXXXXX----X---------------------------------------XX------X----------------[]----X-XX-----XXX----
XX--X-------XX<>-----XX<>-----XX-------XX<>XXXXXX-----X--------------XXX-----S---E---------XXX-------SS---------ES----[]-----XX------<>-X---
<>---X-----XX-[]----E<>[]----<>-X-----XX-[]XXXXXX------X------------XXX-X-------------E---XX<>------------E----<>---E-[]-----<>------[]--XX-
[]----X---XX--[]---<>[][]----[]--X---XX-X[]XXXXXX-------XXX-------EXX-X--X---------------XX-[]-----------<>----[]--<>-[]-----[]------[]-<>-X
[]-----XXXX---[]---[][][]----[]---XXXX-XX[]XXXXXX-------XX-XXXXXXXXX--X---XXXXXXXXXXXXXXXX--[]-E---------[]----[]--[]-[]-----[]------[]-[]--
XXXXXXXXXXXXXXXXXXXXXXXXXXXXXXXXXXXXXXXXXXXXXXXXXXXXXXXXXXXXXXXXXXXX--XXXXXXXXXXXXXXXXXXXXXXXXXXXXXXXXXXXXXXXXXXXXXXXXXXXXXXXXXXXXXXXXXXXXXX