--------------------------------------------------------------------------------------------------------------------------------------------
--------------------------------------------------------------------------------------------------------------------------------------------
-------------------------------------------------------?------------------------------------------------------------------------------------
---------------------------XXX-------------------------------------------------------------------------------------XXX----------------------
-----------------XXXX----XXX--X--------------------------------------------------------------------------XXXX----XXX--X---------------------
----------------XX---X--XXXS---X----------------------------------XXX---------------XXXX----------------XX---X--XXXS---X--------------------
XX-------------XX-----XXXEX-----X----------------------------------------------------------------------XX-----XXXEX-----X-------------------
X-X-----------XX-------XXXX------X---------------------------------------------------XXXX-------------XX-------XXXX------X------------------
---X--------XXX--------XXXXS------X------------------SS--------------------------XXXXX---X----------XXX--------XXXXS------X-----------------
----X------XX<>-------XXXXX--------X---------B------------XXX-------------------XXXXXX----X--------XX<>-------XXXXX--------X--------B-------
-----X----XX-[]------XXXXXX---------X--------b--?-B-------XXX------------------XX----------X------XX-[]------XXXXXX---------X-------b--?-B--
------X--XX--[]-----XXXXXXX----------X-------B----b----XXXXXX--XXX--------X-XXXX------------X----XX--[]-----XXXXXXX----------X------B----b--
-------XXX---[]----XXXXXXXX---------X-XXXXXXXXXXXXXXXXXX--XXXXXX--XXXXXXXXXX-XXX-------------XXXXX---[]----XXXXXXXX---------X-XXXXXXXXXXXXXX
XXXXXXXXXXXXXXXXXXXXXXXXXXXXXXXXXXX-XXXXXXXXXXXXXXXXXXXX--XXXXXX--XXXXXXXXX------------------XXXXXXXXXXXXXXXXXXXXXXXXXXXXXX-XXXXXXXXXXXXXXXX