-------------------------------------------------------------------XXX----------------------------------------------------------------------
------------------------------------------------------------------XX--X---------------------------------------------------------------------
----------------------------------------------XXXX------XXXX-----XX----X--ooo----------XXXX--?----------------------------------------------
-----------------E---------------------------XX<>-X----XX--XXX--XX------X-oooXXX------XX---X---XXX------XX----------------------------------
--------------------------------------------XX-[]--X--XX------XXX--------XXXXX--X----XX-----XXXX--X----XX-X--------XXX----------------------
-----------XXXXXEXXXXX---------------------XXXX[]X--XXX-------XXX--------XXXXX---X--XX------XXXX--oX--XX---X------XX--X-------XX------------
------------------------------------------XX---------X----------------------------XXX-------------o-XXX-----X----XX----X-----XX-X------XXXX-
------------XXXXX------------------------XX--------XXX----------------------------XXX---------------XXX------X--XX------X---XX---X----XX---X
-------XXXXXX----XXXXXXXX-------------XXXX--------------------------------------------------------------------XXX--------XXXX-----X--XX-----
------XXXXXXXEXEEXXXXXXX-X-----------XXXEXXX------------------------------------------------------------------XXXEXX-----XXXX------XXX------
----XXX-------------------X---------XX-----------------------------E-----E---------------------------------------------E-----------XXX-----E
X--XXXXX-------------------X----XXXXX-----------------------------<>----<>----------------------XXX---------------------------------------<>
-XXX------------------------XXXXX--X--------------------XXX-------[]----[]----------------------------------------------------------------[]
XXXXXXXX---------------XXXXXXXXXXEEXEXX--------------------------X[]X--X[]XXXXXX-------XXEX--------------XXXXX----------------------------[]