--------------------------------------------------------------------------------------------------------------------------------------------
--------------------------------------------------------------------------------------------------------------------------------------------
--------------------------------------------------------------------------------------------------------------------------------------------
----------------------------------------------------------------------------XXX-------------------------------------------------------------
-----------------------XXXX---------------------------------------XXXX----XXX--X---------------------------------------------------XXXXX----
E---------------------XXXX-X-----------------------------E-------XX---X--XXXS---X-------------------------------------------------XXXXX-X---
b--------------------XXXXX--X----------------------------o------XX-----XXXEX-----X-----------------------------------------------XX-XXX--X--
X-----XX------------XXXXXX---X---------------------------------XX-------XXXX------X---------------------------------------------XX--XXX---X-
----XXXX-----------XXXXXXX----X--------------------------X---XXX--------XXXXS------X------------------B----------E-------------XXXX-XXX----X
---XX<>-X---------XXXXXXXX-----X-------------------------b--XX<>-------XXXXX--------X---------B-------b---------<>------------XXXXX-XXX-----
--XX-[]--X------XXX-XXXXXX------X------------------------B-XX-[]------XXXXXX---------X--------b--?-B------?QQ----------------XXXXXX-XXX-----
-XX--[]---X----XX<>-XXXXXX-------XX----------------------bXX--[]-----XXXXXXX----------X-------B----b------------------XXXXX-XXXXXXX-XXX-----
XX---[]----XXXXX-[]XXXXXXX-------X-XXXXXXXXXXXXXXXXXXXXXXXX---[]----XXXXXXXX---------X-XXXXXXXXXXXXXXXXXXXXXXXXXXXXXXXX----XXXXXXXX-XXX-----
XXXXXXXXXXXXXXXXXXXXXXXXXXXXXXXXXXXXXXXXXXXXXXXXXXXXXXXXXXXXXXXXXXXXXXXXXXXXXXXXXXXX-XXXXXXXXXXXXXXXXXXXXXXXXXXXXXXXXXX---XXXXXXXX--XXXXXXXX