--------------------------------------------------------------------------------------------------------------------------------------------
-------------------------------------------------------------------------XXX----------------------------------------------------------------
---------------------------------------------E--------------------------XX--X------------------SSSSSSSSSSSSSSSSSSSSSSSSSSSSSSSSSSSSSSSSSSSSS
-----------------------------------------------------------------------XX----XX------------------[]-----------------------------------------
----------------------------------------------------------------------XX-----E-XXXXXX------------[]-------------E---------------XXX---------
-------------------------------------SSSSSSSS?S-------S----S--------XXX---------X----X-----------[]---------QQQQQQ-------XXXXXXXX--X--------
------------------------E-------------[]---------------------------XX-S--------<>-----X----------<>---------------------XXSSSSSSS---XXXX----
---E-------------------<>-------------[]--------------------------XX-----------[]------X-------------------------------XX-SSSSSSS--SSSS-X---
-----------------------[]-------------[]-------------XXXX--------XX------------[]-------X------------------XXXXXXXXXXXXX--SSSSSSS--SSSS--XXX
--------------------QQQQQQQQQQ--------[]------------XX<>-X------XX-------X-----XX--------X----------------XXSSSSSSSSSSSS--SSSSSSS--SSSS?SS?S
--------------------------------------<>-----------XX-[]--X----XXE------------------S-----X--------------XX-SSSSSSSSSSSS------------------SS
X----XXX--X------XXXX-----------------XXX---------XX--[]---X--XX<>-------------------------X----XXX-----XX--SSSSSSSSSSSS---------<>-------SS
-XXXXXX-XX-XXXXXXXEE-XXXXXXXXXXXXXXXXXXE-XXXXXXXXXX---[]----XXX-[]-----X------------------X-XXXXX--XXXXXX---SSSSSSSSSSSS---------[]---------
XXXXXXXXXXXXXXXXXXXXXXXXXEEXXXXXXXXXXXXXXXXXXXXXXXXXXXXXXXXXXXXXXXXXXXXX-------------XXXXXXXXXXXX--XXXXXX---XXXXXXXXXXXXXXXXXXXXXXXXXXXXXXXX