--------------------------------------------------------------------------------------------------------------------------------------------
-----------------------------------------------------------------------------------------------------------------------------------XXXXXXXXX
--------------------------------------------------SSSSSSSSSSSSSSSSSSS--------------------SSSSSSSSSSSSSSSSSSSSSSSSSSSSSSSS---------XXSSSSSSSS
--------------------------------------------------------------------------------------------------------------------SSSSS--------XX---------
-------------------------------------XXXX---------------------------------------------------------------------------SSSSS---XXX-XX----------
-----XXXXX--------------------------XXXX-X-------------------------E------------------------------------------------SSSSS--XXXX-XSSS--------
--E-XX-<>-X------------------------XXXXX--X-----------------------<>------------------------------------------------------XX---XX-----------
---XX--[]--X----------------------XXXXXX---X----------------------[]-----XXX--------------XXXXX--------------------------XX-----XS----------
-XXX---[]---X--------------------XXXXXXX----X---------------------XXX---XXXX-----------XXXX-<>-X--------------------XXXXXX------S-S---------
XX<>--QQQ?---X------------------XXXXXXXX-----X------------XXXX---------XXXX-----------XXQQ?-[]--X------------------XX-XXXX---------S--XX----
X-[]----------X-------XXXX-----XXXXXXXXX------X----------XXSS-X-------XXXXX-X--------XX-----[]---X----------------XX------------------------
--[]-----------X-----XX<>-X---XXXXXXXXXX-------X-------EXX-SS--X-----XXXXXX--X------XX------[]----X---------XXXXXXX-------------------------
--[]------E-----XXXXXX-[]--XXXXXXXXXXXXX--------XXXXXXXXX--SS---XXXXXXXXXXX---XXXXXXX--X----[]-----XXXXXXXXXX----X--------------------------
XXXX------X---XXXXXXXXXXXXXXXXXXXXXXXXXXXXXXXXXXXXXXXXXXX--XX--XXXXXXXXXXXXXXXXXXXXXXXXXXXXXXXXXXXXXXXXXXXXXX---XX--------------XXXXXXXX----