--------------------------------------------------------------------------------------------------------------------------------------------
------------------------------------------------------------------------------------------------XXX-----------------------------------------
------------------------------XXX-----XXXX-----------------------------------------------------XX--X----------------------------------------
-----------------------------XX--X---XX---X---------------------------------------------------XX----XX--------------------------------------
----------------------XXX---XX----X-XX-----XXXXXX--------------------------------------------XX-----E-X-------------------------------------
---------------------XX--X-XX------XX-------X----X-----------------------------------------XX<>--------X------------------------------------
--------------------XX-E--XX-------XX------XX-----X---------------------------------------XX-[]---------X---XX--------------ES---S----------
-------------------XX-----XX-----------------------X-------------------------------------XX--[]----------X-XB-X------S----------------QQ----
-------------XXXXXXX--------------------------------XXXXX-----------------------------XXXX---[]-----------XXb-------------------------------
------------XX-XXXXX-------o-------------------------XXX-X---------------------------XXXXX---[]-----------XXXX-XS--------------------------Q
XXX--------XX--------------o--XX---------------------XXX--X-------------------------XX-------[]-----------XXXX--X-----XXX-------------------
XX-X------XX----------------------------------------XXXX---X---------------XXXXX---XXXX------[]-----------XXXX---X---XXB-X-------------XXXXX
-X--XXXXXXX----------------------------------------XXXXX----XXXXXXXXXXXXXXXXE---X-XX---------[]-----------XXXX----XXXX-b--XXXXXXXXXXXXXXB---
XXXXXXXXXXX----------------------------------------XXXXXXXXXXXXXXXXXXXXXXXX<>----XX-XXX------XXXXXX-------XXXXXXXXXXXXXXXXXXXXXXXXXXXXXXX--X