--------------------------------------------------------------------------------------------------------------------------------------------
XXXX--XXXXXXXXXXXXXXXXXXX-------------------------------------------------------------------------------------------------------------------
SSSSXXSSSSSSSSSSSSSSSSSSS---------------------------------------------------------------------------SSSSSSSSSSSSSSSS-----SSSSSSSSSSSSSSSSSSS
SSSSSSSS-------------[]------------------------------------------------------------------------------------SSS----[]------------------------
SSSSSSSS-------------[]------------------------------------------------------------------------------------SSS----[]---------E--------------
SSSSSSSS--E----------[]----------------------------------------------------------------------XXXX----------SSS----[]-----QQQQQQ-------XXXXXX
S---------o----------[]----------X--EX-------------------------------------------------------X<>-X---------SSS----[]-----------------XXSSSSS
S---------b----------<>----------X---X-------------------------------------------------------X[]--X--------SSS----[]----------------XX-SSSSS
----------B----------------X---X-X---X--------X-EE----X-------------ooo----------------E----XX[]---X-------SSS----[]---XXXXXXXXXXXXXX--SSSSS
------?--<B----------------XSSSX-XSS?X--------XSSSSSSSX-------------ooo--------------------XXS[]----XXXXXXXSSS----[]--XX-SSSSSSSSSSSS--SSSSS
---------[]---<>----S-S-S----------------------------------------------------------oo-----XX--[]----SSSSSS-X------<>-XX--SSSSSSSSSSSS-------
ooooo----[]---[]----S-S-S-----------------XXX--------------------------------------oo----XX---[]----SSSS<>--X-------XX---SSSSSSSSSSSS-------
ooooo----[]---[]----S-S-SXXXXXXXXXXXXXXXXXX--XXXXXXXXXXXXXXXXXXXXXXXXXXXXXXXXXXXXXXXXXXXXX----[]--------[]---XXXXXXXX----SSSSSSSSSSSS-------
XXXXX----[]---[]----S-S-SXXXXXXXXXXXXXXXXXX--XXXXXXXXXXXXEEXEXXXXXXXXXXXXEEXEXXXXXXXXXXXXXXXXXXXXXXXXXX-XXXXXXXXXXXXX----XXXXXXXXXXXXXXXXXXX