-----------------------------------------------------------------------------------------------------------------------------------XXXXXX---
-------------------------------------------------------------------------------------------------------------------------------XXXXX----XXXX
SSSSSSSSSSSSSSSSSSSSSSSSSSSSSSSSSSSSSSSSSSSSSSSSSSSSSSSSSSSSSSSSSSSSSSSSSSSSSSSSSSS?SSSSSSSSSSSSSSSSSSSSSSSSS-----SSSSSSSSSS--XX--X-------SS
Q------------------------------------------------SSSSSSSSSSSSSSSSSSSSSSSSSSSS-------SSSSSSSSSSSSSSSS-------[]----------------XX---X---------
E-------E----------------XXX---------------------SSSSSSSSSSSSSSSSSSSSSSSSSSSS-------SSSSSSSSSSSSSSSS-------[]---------------XX--------------
o---QQQQQQ--------XXXXXXXX--X--------------------SSSSSSSSSSSSSSSSSSSSSSSSSSSS-------SSSSSSSSSSSSSSSS-------[]------XXXXXXXXXX---------------
?----------------XXSSSSSSS---XXXXXX---------------------------------------------XXXXXX---------------------[]------XSSSSSSSSS-X--------X----
S---------------XX-SSSSSSS--SSSSSS-X---------------------------XXXXX-------XXXXXX-----X--------------------[]------XSSSSSSSS----------------
?--XXXXXXXXXXXXXX--SSSSSSS--SSSSSS--XXXXXXXXXXXXXXXXXXXXXXXXXXXX----XXXXXXXXE--<>------X------XXXXXXX------[]---XXXXSSSSSSS-----------------
b-XXSSSSSSSSSSSSS--SSSSSSS--SSSSSS?SS?SSSSS??????SSSSSSSSSSSSSS?----SSSSSSSSS--[]-------X--XXXX-<><>-X-----[]--XX--?SSSSS-------------------
EXX-SSSSSSSSSSSSS--------------------SSSSSSSSSSSS------------------------------[]--------XXXXXX-[][]--X----<>-XX----------------------------
XX--SSSSSSSSSSSSS---------<>---------SSSSSSSSSSSS----------------<>------------[]--------EEXXXX-[][]---X-----XX-------------------X-------oo
X---SSSSSSSSSSSSS---------[]-------------------------------------[]------------[]-------E-XXXXX-[][]----XXXXXX----------------------------oo
XE--XXXXXXXXXXXXXXXXXXXXXXXXXXXXXXXXXXX-XX-XXXXXXXXXXXXXXXXXXXXXXXXXXXXXXXXXXXXXXXXX-XXXEXXXXXX-XXXXXXEXXXXXXX----XXXXXXXXXX--------------XX