X-------------------------------------------------------------------------------------------------------------------------------------------
--------------------------------------------------------------------------------------------------------------------------------------------
SSSSSSSSSSSSSSSSSSSSSSSSSS?SSSSSSSSSSSSSSSSSSSSSSSSSSSSSSSSSSSSSSSSSSSSSSSS-----------------------------------------------------------------
SSSSSSSSSSS--SSSS------------------------------------------------------------------------------------------------XX---E---------------------
SSSSSSSSSSS--SSSS------------------------------------------------------------XXX--------------------------------XXX-------------------------
SSSSSSSSSSSS---------oooooo-----------------------------------------------------------------XXX-----------------XXXXXEXXXXX-----------------
---S----S-S--------------------------------XX-----------------------------------------------------------------------------------------------
---S----S-S----------SSSSSS---------------XX-X-XXX---------------------------------------------------------------XXXXX----------------------
---So??-SoS---E------SSSSSS--------------XX---XX--X---------------------XXXXX-----SSSSS??--------------------XXXXX----XXXXXXXX-------------X
X--SSS--SSS--SSSS----------------------XXX----<>---X------XXXX---------XXXXX-XXXX---------------------------XXXXXXEXEEXXXXXXX-X-----------XX
S-----------EE------------------------XX<>----[]----XXX--XXSS-X-------XXEXXX-XXX-X-------------------------XX------------------X---------XX-
S---------------XXXXX----------------XX-[]----[]----<>-XXX-SS--X-----XXXXXXX------X------XXX---------XXXXXXX--------------------X----XXXXX--
-XXXXXXXXXXXXXXXX----XXXXXXXXXXXXXXXXX--[]----[]--E-[]--X--SS---XXXXXXXXXXXX-------XXXXXXX--XXXXXXXXXX--XXXX---------------------XXXXX--X---
XXXXXXXXXXXXXXXXX---XXXXXXXXXXXXXXXXXXXXXXXXXXXXXXXXXXXXX--XX--XXXXXXXXXXXX-------XXXXXXXX--XXXXXXXXXX----------------------XXXXXXXXXXEEXEXX