--------------------------------------------------------------------------------------------------------------------------------------------
--------------------------------------------------------------------------------------------------------------------------------------------
SSSSSSSSSSSSSSSSSSSSSSSSSSSSSSSSSSSSSSSSSSSSS?SSSSSSSSSSSSSSSSSSSSSSSSS---SSSSSSSSSSSSSSSSSSSSSSSSSSSSSSSSSSSSSSSSSSSSSSSSSSSSSSSSSSSSSSSSSS
-------------SSSSSSSSSSSSSSSSSSSSSSSSSSS------SSSSSSSSSSSSSSSS-------[]---SSSSSSSSSSSSSSSSSSSSSSSSSSSSSSSS--------------------------------SS
-------------SSSSSSSSSSSSSSSSSSSSSSSSSSS------SSSSSSSSSSSSSSSS-------[]---SSSSSSSSSSSSSSSSSSSSSSSSSSSSSSSS------XXX-----------------------SS
-------------SSSSSSSSSSSSSSSSSSSSSSSSSSS------SSSSSSSSSSSSSSSS-------[]---SSSSSSSSSSSSSSSSSSSSSSSSSSSSSSSS-XXXXXX--X----------------------SS
-------------SS----------------------------XXXXX---------------------[]-----------------------------------XXSSSSS---XXXXX-------------------
------------------------XXXXX---------XXXXXX----X--------------------[]----------XXX---------------XXX---XX-SSSSS--SSSSS-X------------------
XXXXXXXXXXXXXXXXXXXXXXXXX----XXXXXXXXXXE--<>-----X------XXXXXXX------[]---XXXXXXXX?-XXXXXXXXXXXXXXXX--XXXX--SSSSS--SSSSS--XXXXXXXXXXXXXXXXXX
SSSSSS??????QSSSSSSSSSSS?----SSSSSSSSSSS--[]------X--XXXX-<><>-X-----[]--XX-SSSSSS??SSSSSSSSSSSSSSSS--SSSSSSSSSSS--SSSSS?SS?SSSSS?????????SS
S--SSSSSSSSSS-----------------------------[]-------XXXXXX-[][]--X----<>-XX?-SSSSS---SSSSSSSSSSSSSSSS-----------------------SSSSSSSSSSSSSSS--
S--SSSSSSSSSS-------------<>--------------[]-------EEXXXX-[][]---X-----XX---SSSSS---SSSSSSSSSSSSSSSS-------------<>--------SSSSSSSSSSSSSSS--
E-------------------------[]--------------[]------E-XXXXX-[][]----XXXXXX---------oooSSSSSSSSSSSSSSSS-------------[]-------------------------
XXXXX-XXXXXXXXXXXXXXXXXXXXXXXXXXXXXXXXXXXXXXXX-XXXEXXXXXX-XXXXXXEXXXXXXX---XXXXXXXXXXXXXXXXXXXXXXXXXXXXXXXXXXXXXXXXXXXXXXXXXX-XX-XXXXXXXXXXX