--------------------------------------------------------------------------------------------------------------------------------------------
--------------------------------------------------------------------------------------------------------------------------------------------
--SSSSSSSSSSSSSSSS-------------SSS-<>SSSSSSSSSSSSSSSS---------------------------------------------------------------------------------------
--SSSS-----------------------------[]SSSSSSSSSSSSSSSS-----------------------------------XX--------------------------------------------------
X-SSSS-----------------------------[]SSSSSSSSSSSSSSSS----------------------------------XX-X-------------------------------------------------
-XSSSS-------------XX--XXXXX-------[]SSSSSSSSSSSSSSSS---------------------------------XX---X------------------------------------------------
--X---------------XX-XXX----X------[]SSSSSSSSSSSSSSSS----------------XX--------------XX-----X-----------------------------------------------
---X-------------XX--XXX-----X-----[]SSSSSSSSSSSSSSSS---------------XXX-------------XXXX-----X----------------------------------------------
---oXXX------XXXXX------------X-----QSSSSSSSSSSSSSSSS--------------XXXX------------XX--X------X------------------B--------------------------
--S?SS-X----XX-XXX-------------XXXX-ESSSSSSSSSSSSSSSS--------E----XXXXX-----------XX--XX-------X---------B-------b--------------------------
--SSS---X--XX-----------SSS-S--SSSSSSSSSSSSSSSSSSSSSS-------<>---XXXXXX-----------X--XXX--------X--------b--?-B------?QQ--------------------
--SS-----XXX------------SSS-S--SSSSSSSSSSSSSSSSSSSSSS--<>---[]--XXXXXXX----------XXXXXXX---------X-------B----b---------------------XXX-----
----E-EE--XX------------SSS-S--SSSSSSSSSSSSSSSSSSSSSS--[]---[]-XXXXXXXX--------XXX--------------X-XXXXXXXXXXXXXXXXXXXXXXXXXXXXXXXXXXX--XXXXX
XXXX-XXXXXXX---------XXXSSS-S--XXXXXXXXXXXXXXXXXXXXXX--XX---XXXXXXXXXXX-------XXXXXXXXXXXXXXXXX-XXXXXXXXXXXXXXXXXXXXXXXXXXXXXXXXXXXXX--XXXXX