----------------------------------------XXX------------------XXX---------XXX----------------------------------------------------------------
---------------------------------------XX--X-------XXX------XX--X-------XX--X------XXX------------------------------------------------------
--------------------------------------XX----X-----XX--X----XX----X-----XX----X----XX--X-------------------------------------------SSSSSSSSSS
---XXX-------------------------------XX------X---XX----X--XX------X---XX------X--XX----XXXXX-----------------------------------------------B
--XX--X----------------------------XXXE-------X-XX------XXX--------XXXX--------XXX-----E-X--X--------------------XXXXX---------------------Q
--XX---X--------------------------XX-<>--------XX-------XXX--------XXXX--------XXX-------X---X------------------XXXX--X--------------------X
-XX-----X------E-----------------XX--[]--------XX---------------------------------------------X----------------XXXXX---X-------------------?
XX-------X-XXXXXX------------XXXXX---[]------------------------oo------------------------------X--------------XXXXXX----X-------------------
X---------XX-----X--------XXXX--XE---[]------------------------SS-------------------------------X------------XXXXXXX-----X------------------
----------XX------X------XXXXX--<>---[]----------------------------------------------------------X----------XXXXXXXX---S--X-----------------
-------------------XE---XX------[]---[]-----------------------------------------------------------X--------XXXXXXXXX-------X----------------
--------------------X--XX-------[]---[]------------------------------------------------------------X------XXXXXXXXXX--------XX--------XXX-XX
---------------------XXX--------[]---[]----------------o---o--------------------------------------X-XXXXXXXXXXXXXXXX--------X-XXXXXXXXX--XX-
XXXXXXX-------------XXXXXXX-----[]---XX-XXX------------X---X--------------XXX---------------------XXXXXXXXXXXXXXXXXXXXXXXXXXXXXXXXXXXXX--XX-