--------------------------------------------------------------------------------------------------------------------------------------------
--------------------------------------------------------------------------------------------------------------------------------------------
-------SS--------------------XXXX-----------------------------------------------------------------------------------------------------------
-------[]---------------------[]-------------------------------------------------------------------------------------------------------XXXXX
-------[]---------------------[]----------------------------------XXXXXXXXXXX---------------------------------------------------------XX----
-------<>---------------------[]---------------------------------XX---X---XX-X-----------SSSS----------------------------------------XXX---X
------------------------------[]--------------------------------XX-E--E---[]--X-----------[]------------------XXXX------------------XX------
--------E---------------------[]------------------------------XXX---------[]---X----------[]-----------------XX---X--------XXXX----XX----ooo
-----XXXX---------------------[]------XXXX-------------------XX-E---------[]----X---------[]----------------XX-----X------XX--oXXXXX-----ooo
----XX<>-X-QQQQQQ?QQQQQQQQ?Q--<>-----XXX--X-----------------XX------------[]-----XX-------[]----------XXXXXXX-------X----XX---XXXXXX--------
---XX-[]--X-------------------------XX-X---X---------------XX-------------<>-----B-X------<>---------XXE--XXX--------X--XX------------------
--XX--[]---X-----------------------XX--X----X-------------XX---------------------b--X-----XXX-------XX<>-XXXX---------XXX----------------E--
XXX---[]----XXXXXXXXXXXXXXXXXXXXXXXX--EX-----XXXXXXXXXXXXXXX---------------E-----B---XXXXXXE-XXXXXXXX-[]-XXXX--------XXXX---------------<>--
XXXXXXXXXXXXXXXXXEEXXXXXXEXEXXXXXXXXXXXX-----XXEXXXXXXXXXXXX-------------XXXXXXXXXXXXXXXXXXXXXXXEXXXXXXXXXXXX--------XX-----------------[]--