--------------------------------------------------------------------------------------------------------------------------------------------
----------------------------------------------------------------------------------------------------------XX--------------------------------
SSSSSSSSSSSSS-------------SSS--<>SSSSSSSSSSSSSSSS--------------------------------S-----------------------XX-X-------------------------------
S------------------------------[]SSSSSSSSSSSSSSSS-------------------XXXXXXXXXXX--S----------------------XX---X-----XXX----------------------
S------------------------------[]SSSSSSSSSSSSSSSS------------------XX------------S----------------XXXXXXX-----XXXXXX--X---------------------
S-------------XX--XXXXX--------[]SSSSSSSSSSSSSSSS-----------------XXX------------S-------------XXXX---XXX-----XXXXXXE--X--------------------
-------------XX-XXX----X-------[]SSSSSSSSSSSSSSSS----------------XXXX------------S------------XXXXX---------------------X-------------E-----
------------XX--XXX-----X------[]SSSSSSSSSSSSSSSS---------------XXXXX------------S-----------XX--------------------------X------------------
XX------XXXXX------------X------oSSSSSSSSSSSSSSSS-----------<>-XXXXXX------------S-------XXXXX----------------------------X-----------XX-XXX
S-X----XX-XXX-------------XXXXX-BSSSSSSSSSSSSSSSS--------E----XXXXXXX------------S------XX-XXX--------XXX------------------X---------XX-XX--
S--X--XX-----------SSS-S--SSSSSSSSSSSSSSSSSSSSSSS---E---<>---XXXXXXXX----<>------S-----XX-----------------------------------XXXXXX--XX--XX--
S---XXX------------SSS-S--SSSSSSSSSSSSSSSSSSSSSSS--<>---[]--XXXXXXXXX----[]------S----XX-------------------------------------X----XXX-------
-EE--XX------------SSS-S--SSSSSSSSSSSSSSSSSSSSSSS--[]---[]-XXXXXXXXXX----[]------SXXXXX------------------------------XXXXEXXEX----XXX-------
XXXXXXX---------XXXSSS-S--XXXXXXXXXXXXXXXXXXXXXXX--XX---XXXXXXXXXXXXXXXXXXXXXXXXXXXXXXX-----------------------------------------------------