--------------------------------------------------------------------------------------------------------------------------------------------
--------------------------------------------------------------------------------------------------------------------------------------------
------------------------------------------------------SSSSSSSSSSSSSSSSSSSSSSSSSSSSSSSSSSSSSSSSSSSSSSSSSSSSSSSSSSSSSSSSSSSSSSSSSSSSSSSSSSSSSS
--------------------------------------------------------------------------------------------------------------------------------------------
--------------------------------------XXXXX-------------------------------------------------------------------------------------------------
-------------------------------------XXXX--X-----------------------------------------------------------------------oooo---------------------
------------------------------------XXXXX---X--------------------------------o--------------------------o-----------------------------------
-----------------------------------XXXXXX----X---------------------------XXXXX--------XXX-----------XXXXX--------S-SSSS-S-------------------
----------------------------------XXXXXXX-----X----------------------XXXXX--S-X------XX--X------XXXXX--S-X-------SoS--SoS-------XXXX--------
--SSQS--------X--SSQS----------XXXXXXXXXX------X----------QQQQ-----XXXXXXX-----XX---XX----X---XXXXXXX-----XX-----SSS--SSS------XX<>-X-------
------------XXX--------------XXX--XXXXXXX-------X----------------XXXXXXXXXXX--XX-XXXX------X-XXXXXXXXXX--XX-XX----------------XX-[]--X------
X----------XX<>-------------XX<>-XXXXXXXX--------XX------------XXXXXXXXXXXXX--XXXXXXX-------XXXXXXXXXXX--XXXX-X--------------XX--[]---X-----
oXXXXXXXXXXX-[]XXXXXXXXXXXXXX-[]XXXXXXXXX--------X-XXXXXXXXXXXXXXXXXXXXXXXXXE-XXXX---------XXXXXXXXXXXXE-XXXX--XXXXXXXXXXXXXXX---[]----XXXXX
XXXXXXXXXXXXXXXXXXXXXXXXXXXXXXXXXXXXXXXXXXXXXXXXXXXXXXXXXXXXXXXXXXXXXXXXXXXXXXXXXX---------XXXXXXXXXXXXXXXXXXXXXXXXXXXXXXXXXXXXXXXXXXXXXXXXX