--------------------------------------------------------------------------------------------------------------------------------------------
--------------------------------------------------------------------------------------------------------------------------------------------
-------------------------------------------------------------------SSSSSSSSSSSSSSSSSSSSSSSSSSSSSSSSSSSSSSSSSSSSSSSSSSSSSSSSSSSSSSS----------
----------------------------------------------------------------------------------SSSSSSSSSSSSSSSSSSSSSSSSS---------------------------------
---------------------------------------------------XXXXX--------------------------SSSSSSSSSSSSSSSSSSSSSSSSS---------------------------------
--------------------------------------------------XXXX--X-------------------------SSSSSSSSSSSSSSSSSSSSSSSSS--QQ--------------------XX--XXXXX
X------------------------------------------------XXXXX---X------------------------------------------------------------------------XX-XXX----
-X----------------------------------------------XXXXXX----X-----------------------------XXX---------------XXX-XXX--XX------------XX--XXX----
--X--------------------------------------------XXXXXXX-----X----------------------XXXXXXX?-XXXXXXXXXXXXXXXX--XX--XXooXX------XXXXX----------
?--X----------------------XXX-----------------XXXXXXXX---S--X--------------------XX-SSSSS??SSSSSSSSSSSSSSSS--QQ--QQ?SS-X----XX-XXX----------
----X--------------------XXX-X---------------XXXXXXXXX-------X------------------XX--SSSS---SSSSSSSSSSSSSSSS-------------X--XX-----------SSS-
B----X----XXXXX-XXX-----XX-X--X-------------XXXXXXXXXX--------XX--------XXX-XXXXX---SSSS---SSSSSSSSSSSSSSSS--------------XXX------------SSS-
b-----XXXXX----XX--XXXXXX--X---XXXXXXXXXXXXXXXXXXXXXXX--------X-XXXXXXXXX--XX--X--------oooSSSSSSSSSSSSSSSS-----------EE--XX------------SSS-
XXXXXXXXXXX---XXX--XXXXXXXXX--XXXXXXXXXXXXXXXXXXXXXXXXXXXXXXXXXXXXXXXXXXX--XX--X---XXXXXXXXXXXXXXXXXXXXXXXXXXXXXXXXXXXXXXXXX---------XXXSSS-