--------------------------------------------------------------------------------------------------------------------------------------------
--------------------------------------------------------------------------------------------------------------------------------------------
--------------------------------------------------------------------------------------------------------------------------------------------
XXXX---------------------------o-------------------------XXX--------------------------------------------------------------------------------
X---X--------------------------------------------------XXX--X-------------------------------------------------------------------------------
S----X-----------------------SSS-------E--------------XXXX---X--------------------Q-------------------Q------------------------------------Q
------X-------------------------------<>-------------XXXXX----X-----------------------------------------------------------------------------
X------X------------------XXXXXXXXX---[]------------XXXXXX-----X----------------------------------------------------------------------------
--------X---------------XXX---X----XX-XXX----------XXXXXXX------X------------------------------------------------------oo-------------------
---E-----X-------SSS---XX<>---S---<>-X------------XXXXXXXX-------X----------Q---S?SQS------------XXXX-?---------------o--o-----------------Q
--<>------X-----------XX-[]-------[]--X-XXXXXX---XX-XXXXXX--------X--------------------XXXX-----XX<>-X--------------------------------------
--[]-------XXX-------XX--[]-------[]---XX<><>-X-XX--XXXXXX---------X------------------XX<>-X---XX-[]--X-----XXX-----------------------------
--[]-------XX-XXXXXXXX---[]----E--[]----X[][]--XX---XXXXXX--------X-XXXXXXXXXXXXXXXXXXX-[]--XXXX--[]---XXXXXX--XXXXXXXXXXXXXXXXXXXXXXXXXXXXX
XXXXXXXXXXXXXXXXXXXXXXXXXXXXXXXXXXXXXXXXXXXXXXXXXXXXXXXXXXXXXXXXXXXXXXXXXXXXXXXXXXXXXXXXXXXXXXXXXXXXXXXXXXXXX--XXXXXXXXXXXXXXXXXXXXXXXXXXXXX