--------------------------------------------------------------------------------------------------------------------------------------------
--------------------------------------------------------------------------------------------------------------------------------------------
SSS-----SSSSSSSSSSSSSSSSSSSSSSSSSSSSSSSSSSSSSSSSSSSSSSSSSSSSSSSSSSSSSS?SSSSSSSSSSSSSSSSSSSSSSSS-----SSS-------------SSS--<>SSSSSSSSSSSSSSSS-
-[]-----------------------------------SSSSSSSSSSSSSSSSSSSSSSSSSSS------SSSSSSSSSSSSSSS-------[]--------------------------[]SSSSSSSSSSSSSSSS-
-[]------------XXX--------------------SSSSSSSSSSSSSSSSSSSSSSSSSSS------SSSSSSSSSSSSSSS-------[]--------------------------[]SSSSSSSSSSSSSSSS-
-[]------XXXXXXX--X-------------------SSSSSSSSSSSSSSSSSSSSSSSSSSS------SSSSSSSSSSSSSSS-------[]---------XX--XXXXX--------[]SSSSSSSSSSSSSSSS-
-[]------XSSSSSS---XXXXX--------------------------------------------XXXXX--------------------[]--------XX-XXX----X-------[]SSSSSSSSSSSSSSSS-
-[]------XSSSSSS--SSSSS-X--------------------------XXXXX-------XXXXXX----X-------------------[]-------XX--XXX-----X------[]SSSSSSSSSSSSSSSS-
-[]---XXXXSSSSSS--SSSSS--XXXXXXXXXXXXXXXXXXXXXXXXXXX----XXXXXXXXE--<>-----X-----XXXXXXX------[]---XXXXX------------X-------SSSSSSSSSSSSSSSS-
-[]--XX--?SSSSS---SSSSS?SS?SSSS???????SSSSSSSSSSSSS?----SSSSSSSSS--[]------X--XXX-<><>-X-----[]--XX-XXX-------------XXXXX-BSSSSSSSSSSSSSSSS-
-[]-XX--------------------SSSSSSSSSSSS-----------------------------[]-------XXXXX-[][]--X----<>-XX-----------SSS-S--SSSSSSSSSSSSSSSSSSSSSSS-
-<>XX-----------<>--------SSSSSSSSSSSS---------------<>------------[]-------EEXXX-[][]---X-----XX------------SSS-S--SSSSSSSSSSSSSSSSSSSSSSS-
XXXX------------[]-----------------------------------[]------------[]------E-XXXX-[][]----XXXXXX-------------SSS-S--SSSSSSSSSSSSSSSSSSSSSSS-
XXXX----XXXXXXXXXXXXXXXXXXXXX-XXXXXXXXXXXXXXXXXXXXXXXXXXXXXXXXXXXXXXXXX-XXXEXXXXX-XXXXXXEXXXXXXX----------XXXSSS-S--XXXXXXXXXXXXXXXXXXXXXXX-