--------------------------------------------------------------------------------------------------------------------------------------------
--------------------------------------------------------------------------------------------------------------------------------------------
SSSSSSSSS-------------SSS--<>SSSSSSSSSSSSSSS------------------------------------------------------------------------------------------------
---------------------------[]SSSSSSSSSSSSSSS-------------------XXXXXXXXXXXX-----------------------------------------------------------------
---------------------------[]SSSSSSSSSSSSSSS------------------XX----------------------------------------XXXXXXXXXXX----------E-E------------
----------XX--XXXXX--------[]SSSSSSSSSSSSSSS-----------------XXX-------------------------------------E-XX--QQQ?QQQ-X-------SSSSSSS-SS-XXXX--
---------XX-XXX----X-------[]SSSSSSSSSSSSSSS----------------XXXX--------------------X------XXX--------XX------------X-------------E--XX---X-
--------XX--XXX-----X------[]SSSSSSSSSSSSSSS---------------XXXXX---------------------XXX-------------XX------E-------X--------------XX-----X
----XXXXX------------X------?SSSSSSSSSSSSSSS--------------XXXXXX----------------XXXXXX--X----------XXX-----SSSSSSS----X-----------XXX-------
---XX-XXX-------------XXXXX-oSSSSSSSSSSSSSSS--------E----XXXXXXX---------------XXXXXXX---X--------XX<>--------------E--X---------XX<>-------
--XX-----------SSS-S--SSSSSSSSSSSSSSSSSSSSSS---E---<>---XXXXXXXX-----<>------XXX----------X------XX-[]-------X------X---X---E---XX-[]-------
oXX------------SSS-S--SSSSSSSSSSSSSSSSSSSSSS--<>---[]--XXXXXXXXX-----[]-----XXXXX----------XX---XX--[]-------X------X----X-----XX--[]-------
XX-------------SSS-S--SSSSSSSSSSSSSSSSSSSSSS--[]---[]-XXXXXXXXXX-----[]-----X-------------XX-XXXX---[]----E--X------X-----XXXXXX---[]-------
XX----------XXXSSS-S--XXXXXXXXXXXXXXXXXXXXXX--XX---XXXXXXXXXXXXXXXXXXXXXXXXXXXXXX---------XXXXXXXXXXXXXXXXXXXXXXXXXXXXXXXXXXXXXXXXXXX-------