--------------------------------------------------------------------------------------------------------------------------------------------
----------------------------------------------------------------XXXX------------------------------------------------------------------------
---------------------------------------------------------------XX---X-----------------------------------------------------------------------
--------------------------------------------------------------XX-----X----------------------------------------------------------------------
-------------------------------------------------------------XX-------X-----XXX-----------XXXXX-----------XXXXX-----------------------------
-----------------------------------E------------------XXXXXXXX------E--XXXXXX--XXXXXXXXXXXX----XXXXXXXXXXXX----XXXXXXXXXXXXXX---------E-----
--------------------------------SSSSSSSSSSS----------XX?QQQQQQ---------SSSSSS--SSSSSSSSSSSS----SSSSSSSSSSSS----SSSSSSSSSSSSX-X------------E-
----------------------------------------------------XX---------------------------------------------------------------------X--X---E---------
-X-------------------------------------------------XX----------------------------------------------------------------------X---X------------
XXXXXXXXXXXXXXXXXX-------------------E-------XXXXXXX----------------------------------E---------------E--------------------X--E-X-----------
XXXXXXXXXXXXXXXXXXXXX-----------SSSSSS?SSSS-XX--QQQ?---S-----------------------------<>------S-------<>------S------------?X-<>--X----------
XXX----------------------------------------XX----------------------------------------[]--------------[]----------------E---X-[]---X---------
XXX---------------XX----------------------XX-----------------------------------------[]--------------[]---------------<>---X-[]----X---XXXXX
XX-----------XXXXXX-XXXXXXXXXXXXXXXXXXXXXXX-------------EE---------------------------[]---------------X---------------[]---X-[]-E---XXXX----