--------------------------------------------------------------------------------------------------------------------------------------------
--------------------------------------------------------------------------------------------------------------------------------------------
--------------------------------------------------------------------------------------------------------------------------------------------
--------------------------------------------------------------------------------------------------------------------------------------------
--------------------------------ooo---------------------------------------------------------------------------------------------------------
--------------------------------ooo------------------------------------------------------------------SSSSSSS---------------E------E---------
------------------------------------------------------------------------------------------------------------------------E-------------------
--------XXXXXX-----oooo---------XXXX-------XXX----------------------------------------------------------------------XXXXXXXXXXXXXXX---------
XXX----XX--X--X----oooo--------XX---XXXXXXXX--X-X-----------------------------------------------------E--E---------XXXSSSSSSSSSSSS-X--------
XS-X--XXX--X---X-------------EXX---XXXXXXEXX---X-XX---------------------XXX--------------------------SSSSSSS------XXXX--------------X-------
S-SS-XXXX--X----XXXXXXXXXXXXXXX----X-------X----<>-X-------------------XXX-X-----------------Q?QQ----------------XXXXX----oooooo-----X------
S-SSXXXXX--X----XXXXXXXXXXXXXXX----X-------X---X[]--X---------------B-XX-X--X---------------------------XXX-----XXXXXX----------------XXXX--
S-SSXXXXX--X----XX------------X----X-------X---X[]---XXXXXXXXXXXXXXXXXX--X---XXXXXXXXXXXXXXXXXXXXXXXXXXXX--XXXXXXXXXXX----oooooo-------X--XX
XXXXXXXXX--X----XX------------X----X-------X---X[]---XXXXXXXXXXXXXXXXXX--XXXXXXXXXXXXXXXXXXXXXXXXXXXXXXXX--XXXXXXXXXXXXXXXXXXXXXXX-----X--XX