--------------------------------------------------------------------------------------------------------------------------------------------
------------------------------------------------------------------------XXXX----------------------------------------------------------------
------------------------------------------------------------------------X--SX------------------SSSSSSSSSSSSSSSSSSSSSSSSSSSSSSSSSSSSSSSSSSSSS
-------XXX----------------------------------o----------------------XXXXXX----X----------------------[]----[]--------------------------------
------XX--X-------------------------------------------------------XX---X------XXXXXX----------------[]----[]-------E-----------------XXX----
-----XXX---X------------------------------SSS-------E-------------XX---S-------XXX--X---------------[]----[]---QQQQQQ----------XXXXXXX--X---
----XXXX----X--------------------------------------<>------------XX------------XXX---X--------------<>----[]------------------XXSSSSSS---XXX
---XXXXX-----X-------------------------XXXXXXXXX---[]-----------XX------------XXXX----X-------------------[]---------------X-XX-SSSSSS--SSSS
--XXXXXX------X----------?-----------XXX---X----XX-XXX--------XXX------------XXXXX-----X------------------[]--XXXXXXXXXXXXXXXX--SSSSSS--SSSS
-XXXXXXX-------X--------Q----SSS----XX<>---S---<>-X----------XX<>-----------XXXXXX---S--X-----------------[]-XXSSSSSSSSSSSSSSS--SSSSSS--SSSS
XXXXXXXX--------X------------------XX-[]-------[]--X-XXXX---XX-[]----------XXXXXXX-------X----------------<>XX-SSSSSSSSSSSSSSS--------------
XXXXXXXX---------X-------XXX------XX--[]-------[]---XX<>-X-XX--[]---------XXXXXXXX--------XX-------XXX-----XX--SSSSSSSSSSSSSSS--------<>----
XXXXXXXX--------X-XXXXXXXX--XXXXXXX---[]----E--[]----X[]--XX---[]----E---XXXXXXXXX--------X-XXXXXXXX--XXXXXX---SSSSSSSSSSSSSSS--------[]----
XXXXXXXXXXXXXXXXXXXXXXXXXX--XXXXXXXXXXXXXXXXXXXXXXXXXXXXXXXXXXXXXXXXXXXXXXXXXXXXXXXXXXXXXXXXXXXXXXXX--XXXXXXE--XXXXXXXXXXXXXXXXXXXXXXXXXXXXX