--------------------------------------------------------------------------------------------------------------------------------------------
--------------------------------------------------------------------------------------------------------------------------------------------
XXX-----------------------------------------------------------------------------------------------------------------------------------------
--------------------------------------------------------------------------------------------------------------------------------------------
----------------------------XXXXXXXXXXX---------------------------------------------------------------------XXXXX---------------------------
---------------------------XX---X---XX-X------------SSSS-----------------XX--------------------------------XXXXX-X--------------------------
--------------------------XX-E--E---[]--X------------[]------------------[]-----------------------E-------XXXEXX--X-------------------------
-------------------------XX---------[]---X-----------[]------------------[]------------------------------XXEXXXX---X------------------------
--XXXX------------------XX-E--------[]----X----------[]------------------[]-----------------------------XXEXXXXX----X-----------E--XXX------
-XXX--X-----------------X-----------[]-----XX--------[]----------XXX-----<>SSSSSS----------------------XXXXXXXXX-----X------------XBQ-X-----
XX-X---X---------------XX-----------<>-----B-X-------<>---------XX?-X-----------------------E---------XXXXXXXXXX------X----------XX<>--X----
X--X----X-------------XX-------------------b--X------XXX-------XX<---XX---EXXX-----------------------XXXXXXXXXXX-------X--------XX-[]---X---
--EX-----XXXXXXXXXXXXXXX-------------E-----B---XXXXXXXE-XXXXXXXX-[]-XX-XXXXXE-XXXXXXXXXXXXXXXXXXXXXXXXXXXXXXXXXX-------XXXXXXXXXX--[]----XXX
XXXX-----XXEXXXXXXXXXXXX-----------XXXXXXXXXXXXXXXXXXXXXXXXEXXXXXXXXXXXXXXX<>XXXXXXXXXXXEXXXXXXXXXXXXXXXXXXXXXXXXXXXXXXXXXXXXXXXXXXXXXXXXXXX