--------------------------------------------------------------------------------------------------------------------------------------------
------------------------------------------------------------------------------------XX------------------------------------------------------
-----------------------------------------------------------------------------------XX-XXX------------SSSSSSSSSSSSSSSSSSSSSSSSSSSSSSSSSSSSSSS
-------------------------------------------------------o--------------------------XX--XX-X-------------[]----[]----------------S------------
XXX-------------------XXXXX------------------------------------------------------XX---XX--X------------[]----[]-------E--------S------XXX---
X--X---------------E-XXXXX-X-------------------------SSS-------E-----------------XS---XX---X-----------[]----[]---QQQQQQ-------SXXXXXXX--X--
X---X---------------XXXXXX--X---------------------------------<>-----------------X----XX----X----------<>----[]---------------XXSSSSSSS---XX
S----X-------------XXXXXXX---X--------------------XXXXXXXXX---[]-------------XXXXX----XX-----X---------------[]--------------XX-SSSSSSS--SSS
----E-X----------XXXXXXXXX----X-----------------XXX---X----XX-XXX----------XXX---X----XX------X--------------[]--XXXXXXXXXXXXX--SSSSSSS--SSS
---<>--X--------XX<>XXXXXX-----X--------SSS----XX<>---S---<>-X------------XX<>---SS---XX-------X-------------[]-XXSSSSSSSSSSSS--SSSSSSS--SSS
---[]---X------XX-[]XXXXXX------X-------------XX-[]-------[]--X-XXXXXX---XX-[]--------XX--------X------------<>XX-SSSSSSSSSSSS--------------
---[]----X----XXXX[]XXXXXX-------XXX---------XX--[]-------[]---XX<><>-X-XX--[]--------XX---------X----XXX-----XX--SSSSSSSSSSSS---------<>---
<>-[]-----XXXXX---[]XXXXXX-------XX-XXXXXXXXXX---[]----E--[]----X[][]--XX---[]--------XX--------X-XXXXX--XXXXXX---SSSSSSSSSSSS---------[]---
XXXXXXXXXXXXXXXXXXXXXXXXXXXXXXXXXXXXXXXXXXXXXXXXXXXXXXXXXXXXXXXXXXXXXXXXXXXXXXXXXXXXXXXXXXXXXXXXXXXXXXX--XXXXXXE--XXXXXXXXXXXXXXXXXXXXXXXXXX